what recipe was posted in either 2004 or 2010	( call SW.listValue ( call SW.filter ( call SW.getProperty ( call SW.singleton en.recipe ) ( string ! type ) ) ( string posting_date ) ( string = ) ( call SW.concat ( date 2004 -1 -1 ) ( date 2010 -1 -1 ) ) ) )
find recipes posted after 2004	( call SW.listValue ( call SW.filter ( call SW.getProperty ( call SW.singleton en.recipe ) ( string ! type ) ) ( call SW.ensureNumericProperty ( string posting_date ) ) ( string > ) ( call SW.ensureNumericEntity ( date 2004 -1 -1 ) ) ) )
what is the total time required for preparing the dish	( call SW.listValue ( call SW.aggregate ( string sum ) ( call SW.getProperty ( call SW.getProperty ( call SW.singleton en.recipe ) ( string ! type ) ) ( string preparation_time ) ) ) )
what recipe do you cook for less time than rice pudding	( call SW.listValue ( call SW.filter ( call SW.getProperty ( call SW.singleton en.recipe ) ( string ! type ) ) ( call SW.ensureNumericProperty ( string cooking_time ) ) ( string < ) ( call SW.ensureNumericEntity ( call SW.getProperty en.recipe.rice_pudding ( string cooking_time ) ) ) ) )
show me meals with at least two recipes	( call SW.listValue ( call SW.countComparative ( call SW.getProperty ( call SW.singleton en.meal ) ( string ! type ) ) ( call SW.reverse ( string meal ) ) ( string >= ) ( number 2 ) ( call SW.getProperty ( call SW.singleton en.recipe ) ( string ! type ) ) ) )
meal than has rice pudding or quiche	( call SW.listValue ( call SW.filter ( call SW.getProperty ( call SW.singleton en.meal ) ( string ! type ) ) ( call SW.reverse ( string meal ) ) ( string = ) ( call SW.concat en.recipe.rice_pudding en.recipe.quiche ) ) )
which recipe belongs to less number of cuisines	( call SW.listValue ( call SW.countSuperlative ( call SW.getProperty ( call SW.singleton en.recipe ) ( string ! type ) ) ( string min ) ( string cuisine ) ) )
what recipe was posted the earliest	( call SW.listValue ( call SW.superlative ( call SW.getProperty ( call SW.singleton en.recipe ) ( string ! type ) ) ( string min ) ( call SW.ensureNumericProperty ( string posting_date ) ) ) )
what recipe is cooked in less time than rice pudding	( call SW.listValue ( call SW.filter ( call SW.getProperty ( call SW.singleton en.recipe ) ( string ! type ) ) ( call SW.ensureNumericProperty ( string cooking_time ) ) ( string <= ) ( call SW.ensureNumericEntity ( call SW.getProperty en.recipe.rice_pudding ( string cooking_time ) ) ) ) )
what meal has the least recipes	( call SW.listValue ( call SW.countSuperlative ( call SW.getProperty ( call SW.singleton en.meal ) ( string ! type ) ) ( string min ) ( call SW.reverse ( string meal ) ) ( call SW.getProperty ( call SW.singleton en.recipe ) ( string ! type ) ) ) )
what recipe has a cooking time lower than that of rice pudding	( call SW.listValue ( call SW.filter ( call SW.getProperty ( call SW.singleton en.recipe ) ( string ! type ) ) ( call SW.ensureNumericProperty ( string cooking_time ) ) ( string < ) ( call SW.ensureNumericEntity ( call SW.getProperty en.recipe.rice_pudding ( string cooking_time ) ) ) ) )
list the lunch recipes contains milk	( call SW.listValue ( call SW.filter ( call SW.filter ( call SW.getProperty ( call SW.singleton en.recipe ) ( string ! type ) ) ( string meal ) ( string = ) en.meal.lunch ) ( string requires ) ( string = ) en.ingredient.milk ) )
recipes for least number of meals	( call SW.listValue ( call SW.countSuperlative ( call SW.getProperty ( call SW.singleton en.recipe ) ( string ! type ) ) ( string min ) ( string meal ) ( call SW.getProperty ( call SW.singleton en.meal ) ( string ! type ) ) ) )
what recipes require the same time or than rice pudding	( call SW.listValue ( call SW.filter ( call SW.getProperty ( call SW.singleton en.recipe ) ( string ! type ) ) ( call SW.ensureNumericProperty ( string cooking_time ) ) ( string >= ) ( call SW.ensureNumericEntity ( call SW.getProperty en.recipe.rice_pudding ( string cooking_time ) ) ) ) )
what recipes dont call for milk	( call SW.listValue ( call SW.filter ( call SW.getProperty ( call SW.singleton en.recipe ) ( string ! type ) ) ( string requires ) ( string ! = ) en.ingredient.milk ) )
show me recipes posted before 2004 or before 2010	( call SW.listValue ( call SW.filter ( call SW.getProperty ( call SW.singleton en.recipe ) ( string ! type ) ) ( call SW.ensureNumericProperty ( string posting_date ) ) ( string < ) ( call SW.ensureNumericEntity ( call SW.concat ( date 2004 -1 -1 ) ( date 2010 -1 -1 ) ) ) ) )
what recipes posting date is greater than 2004 or 2010	( call SW.listValue ( call SW.filter ( call SW.getProperty ( call SW.singleton en.recipe ) ( string ! type ) ) ( call SW.ensureNumericProperty ( string posting_date ) ) ( string > ) ( call SW.ensureNumericEntity ( call SW.concat ( date 2004 -1 -1 ) ( date 2010 -1 -1 ) ) ) ) )
show the first recipe posted	( call SW.listValue ( call SW.superlative ( call SW.getProperty ( call SW.singleton en.recipe ) ( string ! type ) ) ( string min ) ( call SW.ensureNumericProperty ( string posting_date ) ) ) )
which recipe was not posted in 2004	( call SW.listValue ( call SW.filter ( call SW.getProperty ( call SW.singleton en.recipe ) ( string ! type ) ) ( string posting_date ) ( string ! = ) ( date 2004 -1 -1 ) ) )
which recipe has the shortest ingredient list	( call SW.listValue ( call SW.countSuperlative ( call SW.getProperty ( call SW.singleton en.recipe ) ( string ! type ) ) ( string min ) ( string requires ) ( call SW.getProperty ( call SW.singleton en.ingredient ) ( string ! type ) ) ) )
show me the ingredients for rice pudding	( call SW.listValue ( call SW.filter ( call SW.getProperty ( call SW.singleton en.ingredient ) ( string ! type ) ) ( call SW.reverse ( string requires ) ) ( string = ) en.recipe.rice_pudding ) )
recipes posted till rice pudding is posted	( call SW.listValue ( call SW.filter ( call SW.getProperty ( call SW.singleton en.recipe ) ( string ! type ) ) ( call SW.ensureNumericProperty ( string posting_date ) ) ( string <= ) ( call SW.ensureNumericEntity ( call SW.getProperty en.recipe.rice_pudding ( string posting_date ) ) ) ) )
show me recipes posted in or before 2004 or in or before 2010	( call SW.listValue ( call SW.filter ( call SW.getProperty ( call SW.singleton en.recipe ) ( string ! type ) ) ( call SW.ensureNumericProperty ( string posting_date ) ) ( string <= ) ( call SW.ensureNumericEntity ( call SW.concat ( date 2004 -1 -1 ) ( date 2010 -1 -1 ) ) ) ) )
what day was rice pudding posted	( call SW.listValue ( call SW.getProperty en.recipe.rice_pudding ( string posting_date ) ) )
which  recipe takes as much time to prepare as rice pudding	( call SW.listValue ( call SW.filter ( call SW.getProperty ( call SW.singleton en.recipe ) ( string ! type ) ) ( string preparation_time ) ( string = ) ( call SW.getProperty en.recipe.rice_pudding ( string preparation_time ) ) ) )
what is a recipe with the most ingredients	( call SW.listValue ( call SW.countSuperlative ( call SW.getProperty ( call SW.singleton en.recipe ) ( string ! type ) ) ( string max ) ( string cuisine ) ) )
for what meal are there the fewest number of recipes	( call SW.listValue ( call SW.countSuperlative ( call SW.getProperty ( call SW.singleton en.meal ) ( string ! type ) ) ( string min ) ( call SW.reverse ( string meal ) ) ( call SW.getProperty ( call SW.singleton en.recipe ) ( string ! type ) ) ) )
average cooking time	( call SW.listValue ( call SW.aggregate ( string avg ) ( call SW.getProperty ( call SW.getProperty ( call SW.singleton en.recipe ) ( string ! type ) ) ( string cooking_time ) ) ) )
what recipes take more time to prepare than rice pudding	( call SW.listValue ( call SW.filter ( call SW.getProperty ( call SW.singleton en.recipe ) ( string ! type ) ) ( call SW.ensureNumericProperty ( string cooking_time ) ) ( string > ) ( call SW.ensureNumericEntity ( call SW.getProperty en.recipe.rice_pudding ( string preparation_time ) ) ) ) )
show me recipes posted before 2010	( call SW.listValue ( call SW.filter ( call SW.getProperty ( call SW.singleton en.recipe ) ( string ! type ) ) ( call SW.ensureNumericProperty ( string posting_date ) ) ( string <= ) ( call SW.ensureNumericEntity ( call SW.concat ( date 2004 -1 -1 ) ( date 2010 -1 -1 ) ) ) ) )
show me lunch recipes that need milk	( call SW.listValue ( call SW.filter ( call SW.filter ( call SW.getProperty ( call SW.singleton en.recipe ) ( string ! type ) ) ( string requires ) ( string = ) en.ingredient.milk ) ( string meal ) ( string = ) en.meal.lunch ) )
recipes posted after 2003	( call SW.listValue ( call SW.filter ( call SW.getProperty ( call SW.singleton en.recipe ) ( string ! type ) ) ( call SW.ensureNumericProperty ( string posting_date ) ) ( string >= ) ( call SW.ensureNumericEntity ( call SW.concat ( date 2004 -1 -1 ) ( date 2010 -1 -1 ) ) ) ) )
which recipe falls under the least kinds of cuisine	( call SW.listValue ( call SW.countSuperlative ( call SW.getProperty ( call SW.singleton en.recipe ) ( string ! type ) ) ( string min ) ( string cuisine ) ) )
show the recipe that takes the longest time to cook	( call SW.listValue ( call SW.superlative ( call SW.getProperty ( call SW.singleton en.recipe ) ( string ! type ) ) ( string max ) ( call SW.ensureNumericProperty ( string cooking_time ) ) ) )
what recipe is cooked faster than rice pudding	( call SW.listValue ( call SW.filter ( call SW.getProperty ( call SW.singleton en.recipe ) ( string ! type ) ) ( call SW.ensureNumericProperty ( string cooking_time ) ) ( string < ) ( call SW.ensureNumericEntity ( call SW.getProperty en.recipe.rice_pudding ( string cooking_time ) ) ) ) )
which recipe was posted most recently	( call SW.listValue ( call SW.superlative ( call SW.getProperty ( call SW.singleton en.recipe ) ( string ! type ) ) ( string max ) ( call SW.ensureNumericProperty ( string posting_date ) ) ) )
show me ingredients required for the most recipes	( call SW.listValue ( call SW.countSuperlative ( call SW.getProperty ( call SW.singleton en.ingredient ) ( string ! type ) ) ( string max ) ( call SW.reverse ( string requires ) ) ( call SW.getProperty ( call SW.singleton en.recipe ) ( string ! type ) ) ) )
which ingredient is needed in more than one recipes	( call SW.listValue ( call SW.countComparative ( call SW.getProperty ( call SW.singleton en.ingredient ) ( string ! type ) ) ( call SW.reverse ( string requires ) ) ( string >= ) ( number 2 ) ( call SW.getProperty ( call SW.singleton en.recipe ) ( string ! type ) ) ) )
recipe of cuisine of rice pudding	( call SW.listValue ( call SW.filter ( call SW.getProperty ( call SW.singleton en.recipe ) ( string ! type ) ) ( string cuisine ) ( string = ) ( call SW.getProperty en.recipe.rice_pudding ( string cuisine ) ) ) )
what recipe needs milk and is for lunch	( call SW.listValue ( call SW.filter ( call SW.filter ( call SW.getProperty ( call SW.singleton en.recipe ) ( string ! type ) ) ( string requires ) ( string = ) en.ingredient.milk ) ( string meal ) ( string = ) en.meal.lunch ) )
what is the recipe that needs the minimum number of ingredients	( call SW.listValue ( call SW.countSuperlative ( call SW.getProperty ( call SW.singleton en.recipe ) ( string ! type ) ) ( string min ) ( string requires ) ( call SW.getProperty ( call SW.singleton en.ingredient ) ( string ! type ) ) ) )
which recipe uses milk as an ingredient	( call SW.listValue ( call SW.filter ( call SW.getProperty ( call SW.singleton en.recipe ) ( string ! type ) ) ( string requires ) ( string = ) en.ingredient.milk ) )
which recipes have less than two cuisines	( call SW.listValue ( call SW.countComparative ( call SW.getProperty ( call SW.singleton en.recipe ) ( string ! type ) ) ( string cuisine ) ( string < ) ( number 2 ) ) )
how many ingredients are needed	( call SW.listValue ( call .size ( call SW.getProperty ( call SW.singleton en.ingredient ) ( string ! type ) ) ) )
what recipes share at least two ingredients	( call SW.listValue ( call SW.countComparative ( call SW.getProperty ( call SW.singleton en.ingredient ) ( string ! type ) ) ( call SW.reverse ( string requires ) ) ( string >= ) ( number 2 ) ( call SW.getProperty ( call SW.singleton en.recipe ) ( string ! type ) ) ) )
show me recipes posted 2004 and earlier	( call SW.listValue ( call SW.filter ( call SW.getProperty ( call SW.singleton en.recipe ) ( string ! type ) ) ( call SW.ensureNumericProperty ( string posting_date ) ) ( string <= ) ( call SW.ensureNumericEntity ( date 2004 -1 -1 ) ) ) )
what recipe can you prep in the same or more time as it takes to cook rice pudding	( call SW.listValue ( call SW.filter ( call SW.getProperty ( call SW.singleton en.recipe ) ( string ! type ) ) ( call SW.ensureNumericProperty ( string preparation_time ) ) ( string >= ) ( call SW.ensureNumericEntity ( call SW.getProperty en.recipe.rice_pudding ( string cooking_time ) ) ) ) )
what are the ingredients of rice pudding or quiche	( call SW.listValue ( call SW.filter ( call SW.getProperty ( call SW.singleton en.ingredient ) ( string ! type ) ) ( call SW.reverse ( string requires ) ) ( string = ) ( call SW.concat en.recipe.rice_pudding en.recipe.quiche ) ) )
what recipe has one cuisine	( call SW.listValue ( call SW.countComparative ( call SW.getProperty ( call SW.singleton en.recipe ) ( string ! type ) ) ( string cuisine ) ( string < ) ( number 2 ) ) )
show me recipes posted before any posting for rice pudding	( call SW.listValue ( call SW.filter ( call SW.getProperty ( call SW.singleton en.recipe ) ( string ! type ) ) ( call SW.ensureNumericProperty ( string posting_date ) ) ( string < ) ( call SW.ensureNumericEntity ( call SW.getProperty en.recipe.rice_pudding ( string posting_date ) ) ) ) )
show me recipes that whose preparation time is shorter than rice puddings cooking time	( call SW.listValue ( call SW.filter ( call SW.getProperty ( call SW.singleton en.recipe ) ( string ! type ) ) ( call SW.ensureNumericProperty ( string preparation_time ) ) ( string < ) ( call SW.ensureNumericEntity ( call SW.getProperty en.recipe.rice_pudding ( string cooking_time ) ) ) ) )
recipes cooking time	( call SW.listValue ( call SW.aggregate ( string sum ) ( call SW.getProperty ( call SW.getProperty ( call SW.singleton en.recipe ) ( string ! type ) ) ( string cooking_time ) ) ) )
recipe whose posting date is at least rice puddings posting date	( call SW.listValue ( call SW.filter ( call SW.getProperty ( call SW.singleton en.recipe ) ( string ! type ) ) ( call SW.ensureNumericProperty ( string posting_date ) ) ( string >= ) ( call SW.ensureNumericEntity ( call SW.getProperty en.recipe.rice_pudding ( string posting_date ) ) ) ) )
what recipe requires fewer than two ingredients	( call SW.listValue ( call SW.countComparative ( call SW.getProperty ( call SW.singleton en.recipe ) ( string ! type ) ) ( string requires ) ( string < ) ( number 2 ) ( call SW.getProperty ( call SW.singleton en.ingredient ) ( string ! type ) ) ) )
find a lunch recipe that was posted in 2004	( call SW.listValue ( call SW.filter ( call SW.filter ( call SW.getProperty ( call SW.singleton en.recipe ) ( string ! type ) ) ( string meal ) ( string = ) en.meal.lunch ) ( string posting_date ) ( string = ) ( date 2004 -1 -1 ) ) )
what meal can you find at least two recipes for	( call SW.listValue ( call SW.countComparative ( call SW.getProperty ( call SW.singleton en.meal ) ( string ! type ) ) ( call SW.reverse ( string meal ) ) ( string >= ) ( number 2 ) ( call SW.getProperty ( call SW.singleton en.recipe ) ( string ! type ) ) ) )
show me recipes for the most cuisines	( call SW.listValue ( call SW.countSuperlative ( call SW.getProperty ( call SW.singleton en.recipe ) ( string ! type ) ) ( string max ) ( string cuisine ) ) )
how long does it take to prepare rice pudding	( call SW.listValue ( call SW.getProperty en.recipe.rice_pudding ( string preparation_time ) ) )
which recipe has a cooking time as that of rice pudding	( call SW.listValue ( call SW.filter ( call SW.getProperty ( call SW.singleton en.recipe ) ( string ! type ) ) ( call SW.ensureNumericProperty ( string cooking_time ) ) ( string >= ) ( call SW.ensureNumericEntity ( call SW.getProperty en.recipe.rice_pudding ( string preparation_time ) ) ) ) )
find a recipe that takes the same time to cook as rice pudding	( call SW.listValue ( call SW.filter ( call SW.getProperty ( call SW.singleton en.recipe ) ( string ! type ) ) ( string preparation_time ) ( string = ) ( call SW.getProperty en.recipe.rice_pudding ( string preparation_time ) ) ) )
what recipe was posted last	( call SW.listValue ( call SW.superlative ( call SW.getProperty ( call SW.singleton en.recipe ) ( string ! type ) ) ( string max ) ( call SW.ensureNumericProperty ( string posting_date ) ) ) )
for what meal is rice pudding	( call SW.listValue ( call SW.filter ( call SW.filter ( call SW.getProperty ( call SW.singleton en.meal ) ( string ! type ) ) ( call SW.reverse ( string meal ) ) ( string = ) en.recipe.rice_pudding ) ( call SW.reverse ( string meal ) ) ( string = ) en.recipe.rice_pudding ) )
show me recipes posted in 2004	( call SW.listValue ( call SW.filter ( call SW.getProperty ( call SW.singleton en.recipe ) ( string ! type ) ) ( string posting_date ) ( string = ) ( date 2004 -1 -1 ) ) )
show me recipes for lunch posted in 2004	( call SW.listValue ( call SW.filter ( call SW.filter ( call SW.getProperty ( call SW.singleton en.recipe ) ( string ! type ) ) ( string meal ) ( string = ) en.meal.lunch ) ( string posting_date ) ( string = ) ( date 2004 -1 -1 ) ) )
what is the average preparation time of that recipe	( call SW.listValue ( call SW.aggregate ( string avg ) ( call SW.getProperty ( call SW.getProperty ( call SW.singleton en.recipe ) ( string ! type ) ) ( string preparation_time ) ) ) )
show me the recipe that has the most number of requirements	( call SW.listValue ( call SW.countSuperlative ( call SW.getProperty ( call SW.singleton en.recipe ) ( string ! type ) ) ( string max ) ( string requires ) ( call SW.getProperty ( call SW.singleton en.ingredient ) ( string ! type ) ) ) )
show recipes posted on dates between 2004 and 2010	( call SW.listValue ( call SW.filter ( call SW.getProperty ( call SW.singleton en.recipe ) ( string ! type ) ) ( call SW.ensureNumericProperty ( string posting_date ) ) ( string < ) ( call SW.ensureNumericEntity ( call SW.concat ( date 2004 -1 -1 ) ( date 2010 -1 -1 ) ) ) ) )
which recipe has less cooking time like rice pudding	( call SW.listValue ( call SW.filter ( call SW.getProperty ( call SW.singleton en.recipe ) ( string ! type ) ) ( call SW.ensureNumericProperty ( string cooking_time ) ) ( string >= ) ( call SW.ensureNumericEntity ( call SW.getProperty en.recipe.rice_pudding ( string cooking_time ) ) ) ) )
which recipe has the shortest preparation time	( call SW.listValue ( call SW.superlative ( call SW.getProperty ( call SW.singleton en.recipe ) ( string ! type ) ) ( string min ) ( call SW.ensureNumericProperty ( string preparation_time ) ) ) )
for which meal is that recipe that has milk as one of its ingredients	( call SW.listValue ( call SW.filter ( call SW.getProperty ( call SW.singleton en.meal ) ( string ! type ) ) ( call SW.reverse ( string meal ) ) ( string = ) ( call SW.filter ( call SW.getProperty ( call SW.singleton en.recipe ) ( string ! type ) ) ( string requires ) ( string = ) en.ingredient.milk ) ) )
list recipes that require milk	( call SW.listValue ( call SW.filter ( call SW.getProperty ( call SW.singleton en.ingredient ) ( string ! type ) ) ( call SW.reverse ( string requires ) ) ( string = ) ( call SW.filter ( call SW.getProperty ( call SW.singleton en.recipe ) ( string ! type ) ) ( string requires ) ( string = ) en.ingredient.milk ) ) )
recipes without milk	( call SW.listValue ( call SW.filter ( call SW.getProperty ( call SW.singleton en.recipe ) ( string ! type ) ) ( string requires ) ( string ! = ) en.ingredient.milk ) )
what recipe posted in 2004 requires milk as an ingredient	( call SW.listValue ( call SW.filter ( call SW.filter ( call SW.getProperty ( call SW.singleton en.recipe ) ( string ! type ) ) ( string posting_date ) ( string = ) ( date 2004 -1 -1 ) ) ( string requires ) ( string = ) en.ingredient.milk ) )
what recipes cooking time is at lowest that of rice pudding	( call SW.listValue ( call SW.filter ( call SW.getProperty ( call SW.singleton en.recipe ) ( string ! type ) ) ( call SW.ensureNumericProperty ( string cooking_time ) ) ( string >= ) ( call SW.ensureNumericEntity ( call SW.getProperty en.recipe.rice_pudding ( string cooking_time ) ) ) ) )
show recipes whose posted date is on or before 2004	( call SW.listValue ( call SW.filter ( call SW.getProperty ( call SW.singleton en.recipe ) ( string ! type ) ) ( call SW.ensureNumericProperty ( string posting_date ) ) ( string <= ) ( call SW.ensureNumericEntity ( date 2004 -1 -1 ) ) ) )
meal with milk recipe	( call SW.listValue ( call SW.filter ( call SW.getProperty ( call SW.singleton en.meal ) ( string ! type ) ) ( call SW.reverse ( string meal ) ) ( string = ) ( call SW.filter ( call SW.getProperty ( call SW.singleton en.recipe ) ( string ! type ) ) ( string requires ) ( string = ) en.ingredient.milk ) ) )
show me recipes that require lesser cooking time than rice pudding	( call SW.listValue ( call SW.filter ( call SW.getProperty ( call SW.singleton en.recipe ) ( string ! type ) ) ( call SW.ensureNumericProperty ( string cooking_time ) ) ( string < ) ( call SW.ensureNumericEntity ( call SW.getProperty en.recipe.rice_pudding ( string preparation_time ) ) ) ) )
how many meals are there	( call SW.listValue ( call .size ( call SW.getProperty ( call SW.singleton en.meal ) ( string ! type ) ) ) )
show me recipes that take the same time to prepare as rice pudding	( call SW.listValue ( call SW.filter ( call SW.getProperty ( call SW.singleton en.recipe ) ( string ! type ) ) ( string preparation_time ) ( string = ) ( call SW.getProperty en.recipe.rice_pudding ( string preparation_time ) ) ) )
what is an ingredient used in more than two recipes	( call SW.listValue ( call SW.countComparative ( call SW.getProperty ( call SW.singleton en.ingredient ) ( string ! type ) ) ( call SW.reverse ( string requires ) ) ( string > ) ( number 2 ) ( call SW.getProperty ( call SW.singleton en.recipe ) ( string ! type ) ) ) )
what recipe requires the ingredients of rice pudding	( call SW.listValue ( call SW.filter ( call SW.getProperty ( call SW.singleton en.recipe ) ( string ! type ) ) ( string requires ) ( string = ) ( call SW.filter ( call SW.getProperty ( call SW.singleton en.ingredient ) ( string ! type ) ) ( call SW.reverse ( string requires ) ) ( string = ) en.recipe.rice_pudding ) ) )
show recipes that does not have milk as one of its ingredients	( call SW.listValue ( call SW.filter ( call SW.getProperty ( call SW.singleton en.recipe ) ( string ! type ) ) ( string requires ) ( string ! = ) en.ingredient.milk ) )
find the lunch recipes posted in 2004	( call SW.listValue ( call SW.filter ( call SW.filter ( call SW.getProperty ( call SW.singleton en.recipe ) ( string ! type ) ) ( string posting_date ) ( string = ) ( date 2004 -1 -1 ) ) ( string meal ) ( string = ) en.meal.lunch ) )
what ingredient is not required to make rice pudding	( call SW.listValue ( call SW.filter ( call SW.getProperty ( call SW.singleton en.ingredient ) ( string ! type ) ) ( call SW.reverse ( string requires ) ) ( string ! = ) en.recipe.rice_pudding ) )
what is an ingredient found in a lunch recipe	( call SW.listValue ( call SW.filter ( call SW.getProperty ( call SW.singleton en.ingredient ) ( string ! type ) ) ( call SW.reverse ( string requires ) ) ( string = ) ( call SW.filter ( call SW.getProperty ( call SW.singleton en.recipe ) ( string ! type ) ) ( string meal ) ( string = ) en.meal.lunch ) ) )
find recipe that needs the maximum number of food items	( call SW.listValue ( call SW.countSuperlative ( call SW.getProperty ( call SW.singleton en.recipe ) ( string ! type ) ) ( string max ) ( string requires ) ( call SW.getProperty ( call SW.singleton en.ingredient ) ( string ! type ) ) ) )
how many ingredients are used	( call SW.listValue ( call .size ( call SW.getProperty ( call SW.singleton en.ingredient ) ( string ! type ) ) ) )
which recipes were posted before 2004	( call SW.listValue ( call SW.filter ( call SW.getProperty ( call SW.singleton en.recipe ) ( string ! type ) ) ( call SW.ensureNumericProperty ( string posting_date ) ) ( string < ) ( call SW.ensureNumericEntity ( date 2004 -1 -1 ) ) ) )
recipe cooked in preparation time of rice pudding or more	( call SW.listValue ( call SW.filter ( call SW.getProperty ( call SW.singleton en.recipe ) ( string ! type ) ) ( call SW.ensureNumericProperty ( string cooking_time ) ) ( string >= ) ( call SW.ensureNumericEntity ( call SW.getProperty en.recipe.rice_pudding ( string preparation_time ) ) ) ) )
show me recipes that need milk and were posted in 2004	( call SW.listValue ( call SW.filter ( call SW.filter ( call SW.getProperty ( call SW.singleton en.recipe ) ( string ! type ) ) ( string requires ) ( string = ) en.ingredient.milk ) ( string posting_date ) ( string = ) ( date 2004 -1 -1 ) ) )
what is a recipe from the same cuisine as rice pudding	( call SW.listValue ( call SW.filter ( call SW.getProperty ( call SW.singleton en.recipe ) ( string ! type ) ) ( string cuisine ) ( string = ) ( call SW.getProperty en.recipe.rice_pudding ( string cuisine ) ) ) )
how long does it take to  make rice pudding	( call SW.listValue ( call SW.getProperty en.recipe.rice_pudding ( string cooking_time ) ) )
recipe in least cuisines	( call SW.listValue ( call SW.countSuperlative ( call SW.getProperty ( call SW.singleton en.recipe ) ( string ! type ) ) ( string min ) ( string cuisine ) ) )
what time can be prepped in the same time as rice pudding	( call SW.listValue ( call SW.filter ( call SW.getProperty ( call SW.singleton en.recipe ) ( string ! type ) ) ( string preparation_time ) ( string = ) ( call SW.getProperty en.recipe.rice_pudding ( string preparation_time ) ) ) )
which recipes are not for lunch	( call SW.listValue ( call SW.filter ( call SW.getProperty ( call SW.singleton en.recipe ) ( string ! type ) ) ( string meal ) ( string ! = ) en.meal.lunch ) )
show me recipes not for lunch	( call SW.listValue ( call SW.filter ( call SW.getProperty ( call SW.singleton en.recipe ) ( string ! type ) ) ( string meal ) ( string ! = ) en.meal.lunch ) )
find a recipe for lunch	( call SW.listValue ( call SW.filter ( call SW.filter ( call SW.getProperty ( call SW.singleton en.recipe ) ( string ! type ) ) ( string meal ) ( string = ) en.meal.lunch ) ( string meal ) ( string = ) en.meal.lunch ) )
which recipes are for lunch or dinner	( call SW.listValue ( call SW.filter ( call SW.getProperty ( call SW.singleton en.recipe ) ( string ! type ) ) ( string meal ) ( string = ) ( call SW.concat en.meal.lunch en.meal.dinner ) ) )
show me recipes with fewer than two ingredients	( call SW.listValue ( call SW.countComparative ( call SW.getProperty ( call SW.singleton en.recipe ) ( string ! type ) ) ( string requires ) ( string < ) ( number 2 ) ( call SW.getProperty ( call SW.singleton en.ingredient ) ( string ! type ) ) ) )
which recipe is intended for the least number of meals	( call SW.listValue ( call SW.countSuperlative ( call SW.getProperty ( call SW.singleton en.recipe ) ( string ! type ) ) ( string min ) ( string meal ) ( call SW.getProperty ( call SW.singleton en.meal ) ( string ! type ) ) ) )
how many total ingredients are used in all the recipes	( call SW.listValue ( call .size ( call SW.getProperty ( call SW.singleton en.ingredient ) ( string ! type ) ) ) )
what recipe posted in 2004 makes a lunch meal	( call SW.listValue ( call SW.filter ( call SW.filter ( call SW.getProperty ( call SW.singleton en.recipe ) ( string ! type ) ) ( string posting_date ) ( string = ) ( date 2004 -1 -1 ) ) ( string meal ) ( string = ) en.meal.lunch ) )
what ingredients are used least in recipes	( call SW.listValue ( call SW.countSuperlative ( call SW.getProperty ( call SW.singleton en.ingredient ) ( string ! type ) ) ( string min ) ( call SW.reverse ( string requires ) ) ( call SW.getProperty ( call SW.singleton en.recipe ) ( string ! type ) ) ) )
what recipe posted in 2004 can make a lunch meal	( call SW.listValue ( call SW.filter ( call SW.filter ( call SW.getProperty ( call SW.singleton en.recipe ) ( string ! type ) ) ( string meal ) ( string = ) en.meal.lunch ) ( string posting_date ) ( string = ) ( date 2004 -1 -1 ) ) )
tell recipes with milk for lunch	( call SW.listValue ( call SW.filter ( call SW.filter ( call SW.getProperty ( call SW.singleton en.recipe ) ( string ! type ) ) ( string meal ) ( string = ) en.meal.lunch ) ( string requires ) ( string = ) en.ingredient.milk ) )
which recipe is used for the most meals	( call SW.listValue ( call SW.countSuperlative ( call SW.getProperty ( call SW.singleton en.recipe ) ( string ! type ) ) ( string max ) ( string meal ) ( call SW.getProperty ( call SW.singleton en.meal ) ( string ! type ) ) ) )
the lunch recipe  posting date is 2004	( call SW.listValue ( call SW.filter ( call SW.filter ( call SW.getProperty ( call SW.singleton en.recipe ) ( string ! type ) ) ( string posting_date ) ( string = ) ( date 2004 -1 -1 ) ) ( string meal ) ( string = ) en.meal.lunch ) )
what recipes can be prepared faster than rice pudding	( call SW.listValue ( call SW.filter ( call SW.getProperty ( call SW.singleton en.recipe ) ( string ! type ) ) ( call SW.ensureNumericProperty ( string preparation_time ) ) ( string < ) ( call SW.ensureNumericEntity ( call SW.getProperty en.recipe.rice_pudding ( string cooking_time ) ) ) ) )
what recipes posting date is at least the same as rice pudding	( call SW.listValue ( call SW.filter ( call SW.getProperty ( call SW.singleton en.recipe ) ( string ! type ) ) ( call SW.ensureNumericProperty ( string posting_date ) ) ( string >= ) ( call SW.ensureNumericEntity ( call SW.getProperty en.recipe.rice_pudding ( string posting_date ) ) ) ) )
for what meal can maximum recipes be found	( call SW.listValue ( call SW.countSuperlative ( call SW.getProperty ( call SW.singleton en.meal ) ( string ! type ) ) ( string max ) ( call SW.reverse ( string meal ) ) ( call SW.getProperty ( call SW.singleton en.recipe ) ( string ! type ) ) ) )
name the recipe with a cooking time with at least the cooking time of rice pudding	( call SW.listValue ( call SW.filter ( call SW.getProperty ( call SW.singleton en.recipe ) ( string ! type ) ) ( call SW.ensureNumericProperty ( string cooking_time ) ) ( string >= ) ( call SW.ensureNumericEntity ( call SW.getProperty en.recipe.rice_pudding ( string cooking_time ) ) ) ) )
what recipe can you prepare in the same or less time than it takes to cook rice pudding	( call SW.listValue ( call SW.filter ( call SW.getProperty ( call SW.singleton en.recipe ) ( string ! type ) ) ( call SW.ensureNumericProperty ( string preparation_time ) ) ( string <= ) ( call SW.ensureNumericEntity ( call SW.getProperty en.recipe.rice_pudding ( string cooking_time ) ) ) ) )
how many recipes	( call SW.listValue ( call .size ( call SW.getProperty ( call SW.singleton en.recipe ) ( string ! type ) ) ) )
which recipe has the least amount of prep time	( call SW.listValue ( call SW.superlative ( call SW.getProperty ( call SW.singleton en.recipe ) ( string ! type ) ) ( string min ) ( call SW.ensureNumericProperty ( string preparation_time ) ) ) )
what ingredient is most used	( call SW.listValue ( call SW.countSuperlative ( call SW.getProperty ( call SW.singleton en.ingredient ) ( string ! type ) ) ( string max ) ( call SW.reverse ( string requires ) ) ( call SW.getProperty ( call SW.singleton en.recipe ) ( string ! type ) ) ) )
what is the posting date for rice pudding	( call SW.listValue ( call SW.getProperty en.recipe.rice_pudding ( string posting_date ) ) )
show me recipes with cooking times greater than cooking time of rice pudding	( call SW.listValue ( call SW.filter ( call SW.getProperty ( call SW.singleton en.recipe ) ( string ! type ) ) ( call SW.ensureNumericProperty ( string cooking_time ) ) ( string > ) ( call SW.ensureNumericEntity ( call SW.getProperty en.recipe.rice_pudding ( string cooking_time ) ) ) ) )
show recipes that has milk as its ingredient	( call SW.listValue ( call SW.filter ( call SW.filter ( call SW.getProperty ( call SW.singleton en.recipe ) ( string ! type ) ) ( string requires ) ( string = ) en.ingredient.milk ) ( string requires ) ( string = ) en.ingredient.milk ) )
what is the average cooking time for that recipe	( call SW.listValue ( call SW.aggregate ( string avg ) ( call SW.getProperty ( call SW.getProperty ( call SW.singleton en.recipe ) ( string ! type ) ) ( string cooking_time ) ) ) )
which recipes were posted at the same time as rice pudding	( call SW.listValue ( call SW.filter ( call SW.getProperty ( call SW.singleton en.recipe ) ( string ! type ) ) ( string posting_date ) ( string = ) ( call SW.getProperty en.recipe.rice_pudding ( string posting_date ) ) ) )
whats the average preparation time of a recipe	( call SW.listValue ( call SW.aggregate ( string avg ) ( call SW.getProperty ( call SW.getProperty ( call SW.singleton en.recipe ) ( string ! type ) ) ( string preparation_time ) ) ) )
what ingredients does rice pudding need	( call SW.listValue ( call SW.filter ( call SW.filter ( call SW.getProperty ( call SW.singleton en.ingredient ) ( string ! type ) ) ( call SW.reverse ( string requires ) ) ( string = ) en.recipe.rice_pudding ) ( call SW.reverse ( string requires ) ) ( string = ) en.recipe.rice_pudding ) )
recipes posted before rice pudding	( call SW.listValue ( call SW.filter ( call SW.getProperty ( call SW.singleton en.recipe ) ( string ! type ) ) ( call SW.ensureNumericProperty ( string posting_date ) ) ( string < ) ( call SW.ensureNumericEntity ( call SW.getProperty en.recipe.rice_pudding ( string posting_date ) ) ) ) )
a recipe which posted before 2004	( call SW.listValue ( call SW.filter ( call SW.getProperty ( call SW.singleton en.recipe ) ( string ! type ) ) ( call SW.ensureNumericProperty ( string posting_date ) ) ( string < ) ( call SW.ensureNumericEntity ( date 2004 -1 -1 ) ) ) )
which recipes were posted when rice pudding was posted	( call SW.listValue ( call SW.filter ( call SW.getProperty ( call SW.singleton en.recipe ) ( string ! type ) ) ( call SW.ensureNumericProperty ( string posting_date ) ) ( string >= ) ( call SW.ensureNumericEntity ( call SW.getProperty en.recipe.rice_pudding ( string posting_date ) ) ) ) )
show me meals requiring milk	( call SW.listValue ( call SW.filter ( call SW.getProperty ( call SW.singleton en.meal ) ( string ! type ) ) ( call SW.reverse ( string meal ) ) ( string = ) ( call SW.filter ( call SW.getProperty ( call SW.singleton en.recipe ) ( string ! type ) ) ( string requires ) ( string = ) en.ingredient.milk ) ) )
show me recipes with posting dates from 2004 or later	( call SW.listValue ( call SW.filter ( call SW.getProperty ( call SW.singleton en.recipe ) ( string ! type ) ) ( call SW.ensureNumericProperty ( string posting_date ) ) ( string >= ) ( call SW.ensureNumericEntity ( call SW.concat ( date 2004 -1 -1 ) ( date 2010 -1 -1 ) ) ) ) )
which food item is needed in  two recipes or more	( call SW.listValue ( call SW.countComparative ( call SW.getProperty ( call SW.singleton en.ingredient ) ( string ! type ) ) ( call SW.reverse ( string requires ) ) ( string > ) ( number 2 ) ( call SW.getProperty ( call SW.singleton en.recipe ) ( string ! type ) ) ) )
what ingredient is found in rice pudding	( call SW.listValue ( call SW.filter ( call SW.getProperty ( call SW.singleton en.recipe ) ( string ! type ) ) ( string requires ) ( string = ) ( call SW.filter ( call SW.getProperty ( call SW.singleton en.ingredient ) ( string ! type ) ) ( call SW.reverse ( string requires ) ) ( string = ) en.recipe.rice_pudding ) ) )
show me recipes not posted in 2004	( call SW.listValue ( call SW.filter ( call SW.getProperty ( call SW.singleton en.recipe ) ( string ! type ) ) ( string posting_date ) ( string ! = ) ( date 2004 -1 -1 ) ) )
what recipes need milk	( call SW.listValue ( call SW.filter ( call SW.getProperty ( call SW.singleton en.recipe ) ( string ! type ) ) ( string requires ) ( string = ) en.ingredient.milk ) )
recipe cooked in less time than rice pudding preparation	( call SW.listValue ( call SW.filter ( call SW.getProperty ( call SW.singleton en.recipe ) ( string ! type ) ) ( call SW.ensureNumericProperty ( string cooking_time ) ) ( string < ) ( call SW.ensureNumericEntity ( call SW.getProperty en.recipe.rice_pudding ( string preparation_time ) ) ) ) )
either lunch or dinner	( call SW.listValue ( call SW.concat en.meal.lunch en.meal.dinner ) )
show me recipes that require the cooking time of rice pudding	( call SW.listValue ( call SW.filter ( call SW.getProperty ( call SW.singleton en.recipe ) ( string ! type ) ) ( string cooking_time ) ( string = ) ( call SW.getProperty en.recipe.rice_pudding ( string cooking_time ) ) ) )
recipes posted after 2004	( call SW.listValue ( call SW.filter ( call SW.getProperty ( call SW.singleton en.recipe ) ( string ! type ) ) ( call SW.ensureNumericProperty ( string posting_date ) ) ( string > ) ( call SW.ensureNumericEntity ( date 2004 -1 -1 ) ) ) )
which recipe was posted in 2004	( call SW.listValue ( call SW.filter ( call SW.filter ( call SW.getProperty ( call SW.singleton en.recipe ) ( string ! type ) ) ( string posting_date ) ( string = ) ( date 2004 -1 -1 ) ) ( string posting_date ) ( string = ) ( date 2004 -1 -1 ) ) )
which recipes were posted after 2004 or 2010	( call SW.listValue ( call SW.filter ( call SW.getProperty ( call SW.singleton en.recipe ) ( string ! type ) ) ( call SW.ensureNumericProperty ( string posting_date ) ) ( string > ) ( call SW.ensureNumericEntity ( call SW.concat ( date 2004 -1 -1 ) ( date 2010 -1 -1 ) ) ) ) )
what recipe has a cook time equal to the prep time of rice pudding	( call SW.listValue ( call SW.filter ( call SW.getProperty ( call SW.singleton en.recipe ) ( string ! type ) ) ( string cooking_time ) ( string = ) ( call SW.getProperty en.recipe.rice_pudding ( string preparation_time ) ) ) )
what are ingredients in rice pudding	( call SW.listValue ( call SW.filter ( call SW.filter ( call SW.getProperty ( call SW.singleton en.ingredient ) ( string ! type ) ) ( call SW.reverse ( string requires ) ) ( string = ) en.recipe.rice_pudding ) ( call SW.reverse ( string requires ) ) ( string = ) en.recipe.rice_pudding ) )
when is rice pudding recipe posted	( call SW.listValue ( call SW.getProperty en.recipe.rice_pudding ( string posting_date ) ) )
show me recipes with fewer than two cuisines	( call SW.listValue ( call SW.countComparative ( call SW.getProperty ( call SW.singleton en.recipe ) ( string ! type ) ) ( string cuisine ) ( string < ) ( number 2 ) ) )
recipe for the most number of meal	( call SW.listValue ( call SW.countSuperlative ( call SW.getProperty ( call SW.singleton en.recipe ) ( string ! type ) ) ( string max ) ( string meal ) ( call SW.getProperty ( call SW.singleton en.meal ) ( string ! type ) ) ) )
what recipe has the fewest amount of ingredients	( call SW.listValue ( call SW.countSuperlative ( call SW.getProperty ( call SW.singleton en.recipe ) ( string ! type ) ) ( string min ) ( string requires ) ( call SW.getProperty ( call SW.singleton en.ingredient ) ( string ! type ) ) ) )
find a meal without rice pudding	( call SW.listValue ( call SW.filter ( call SW.getProperty ( call SW.singleton en.meal ) ( string ! type ) ) ( call SW.reverse ( string meal ) ) ( string ! = ) en.recipe.rice_pudding ) )
what is the cooking time of rice pudding	( call SW.listValue ( call SW.getProperty en.recipe.rice_pudding ( string cooking_time ) ) )
recipe prepared in more time than cooking time of rice pudding	( call SW.listValue ( call SW.filter ( call SW.getProperty ( call SW.singleton en.recipe ) ( string ! type ) ) ( call SW.ensureNumericProperty ( string preparation_time ) ) ( string > ) ( call SW.ensureNumericEntity ( call SW.getProperty en.recipe.rice_pudding ( string cooking_time ) ) ) ) )
show me ingredients not required for rice pudding	( call SW.listValue ( call SW.filter ( call SW.getProperty ( call SW.singleton en.ingredient ) ( string ! type ) ) ( call SW.reverse ( string requires ) ) ( string ! = ) en.recipe.rice_pudding ) )
show me recipes for fewer than two meals	( call SW.listValue ( call SW.countComparative ( call SW.getProperty ( call SW.singleton en.recipe ) ( string ! type ) ) ( string meal ) ( string < ) ( number 2 ) ( call SW.getProperty ( call SW.singleton en.meal ) ( string ! type ) ) ) )
recipe with only one ingredient	( call SW.listValue ( call SW.countComparative ( call SW.getProperty ( call SW.singleton en.recipe ) ( string ! type ) ) ( string requires ) ( string < ) ( number 2 ) ( call SW.getProperty ( call SW.singleton en.ingredient ) ( string ! type ) ) ) )
what recipe calls for two or less ingredients	( call SW.listValue ( call SW.countComparative ( call SW.getProperty ( call SW.singleton en.recipe ) ( string ! type ) ) ( string requires ) ( string <= ) ( number 2 ) ( call SW.getProperty ( call SW.singleton en.ingredient ) ( string ! type ) ) ) )
show me ingredients required by at least two recipes	( call SW.listValue ( call SW.countComparative ( call SW.getProperty ( call SW.singleton en.ingredient ) ( string ! type ) ) ( call SW.reverse ( string requires ) ) ( string >= ) ( number 2 ) ( call SW.getProperty ( call SW.singleton en.recipe ) ( string ! type ) ) ) )
what is a recipe with a prep time less than the cooking time of rice pudding	( call SW.listValue ( call SW.filter ( call SW.getProperty ( call SW.singleton en.recipe ) ( string ! type ) ) ( call SW.ensureNumericProperty ( string preparation_time ) ) ( string < ) ( call SW.ensureNumericEntity ( call SW.getProperty en.recipe.rice_pudding ( string cooking_time ) ) ) ) )
what recipes were posted before 2004	( call SW.listValue ( call SW.filter ( call SW.getProperty ( call SW.singleton en.recipe ) ( string ! type ) ) ( call SW.ensureNumericProperty ( string posting_date ) ) ( string < ) ( call SW.ensureNumericEntity ( date 2004 -1 -1 ) ) ) )
what recipe requiring milk makes a lunch meal	( call SW.listValue ( call SW.filter ( call SW.filter ( call SW.getProperty ( call SW.singleton en.recipe ) ( string ! type ) ) ( string meal ) ( string = ) en.meal.lunch ) ( string requires ) ( string = ) en.ingredient.milk ) )
a recipe which posted no sooner than 2004 or 2010	( call SW.listValue ( call SW.filter ( call SW.getProperty ( call SW.singleton en.recipe ) ( string ! type ) ) ( call SW.ensureNumericProperty ( string posting_date ) ) ( string >= ) ( call SW.ensureNumericEntity ( call SW.concat ( date 2004 -1 -1 ) ( date 2010 -1 -1 ) ) ) ) )
show recipes for the meal as the same for rice pudding	( call SW.listValue ( call SW.filter ( call SW.getProperty ( call SW.singleton en.recipe ) ( string ! type ) ) ( string meal ) ( string = ) ( call SW.filter ( call SW.getProperty ( call SW.singleton en.meal ) ( string ! type ) ) ( call SW.reverse ( string meal ) ) ( string = ) en.recipe.rice_pudding ) ) )
recipes for less than three meals	( call SW.listValue ( call SW.countComparative ( call SW.getProperty ( call SW.singleton en.recipe ) ( string ! type ) ) ( string meal ) ( string <= ) ( number 2 ) ( call SW.getProperty ( call SW.singleton en.meal ) ( string ! type ) ) ) )
what is the mean cooking time for the recipe	( call SW.listValue ( call SW.aggregate ( string avg ) ( call SW.getProperty ( call SW.getProperty ( call SW.singleton en.recipe ) ( string ! type ) ) ( string cooking_time ) ) ) )
show recipes posted on the same date or later than rice pudding	( call SW.listValue ( call SW.filter ( call SW.getProperty ( call SW.singleton en.recipe ) ( string ! type ) ) ( call SW.ensureNumericProperty ( string posting_date ) ) ( string >= ) ( call SW.ensureNumericEntity ( call SW.getProperty en.recipe.rice_pudding ( string posting_date ) ) ) ) )
show me milkfree recipes	( call SW.listValue ( call SW.filter ( call SW.getProperty ( call SW.singleton en.recipe ) ( string ! type ) ) ( string requires ) ( string ! = ) en.ingredient.milk ) )
what recipes cooking time is the same as rice pudding	( call SW.listValue ( call SW.filter ( call SW.getProperty ( call SW.singleton en.recipe ) ( string ! type ) ) ( string cooking_time ) ( string = ) ( call SW.getProperty en.recipe.rice_pudding ( string cooking_time ) ) ) )
show recipes posted before rice pudding	( call SW.listValue ( call SW.filter ( call SW.getProperty ( call SW.singleton en.recipe ) ( string ! type ) ) ( call SW.ensureNumericProperty ( string posting_date ) ) ( string < ) ( call SW.ensureNumericEntity ( call SW.getProperty en.recipe.rice_pudding ( string posting_date ) ) ) ) )
show me recipes with posting date before 2010	( call SW.listValue ( call SW.filter ( call SW.getProperty ( call SW.singleton en.recipe ) ( string ! type ) ) ( call SW.ensureNumericProperty ( string posting_date ) ) ( string < ) ( call SW.ensureNumericEntity ( call SW.concat ( date 2004 -1 -1 ) ( date 2010 -1 -1 ) ) ) ) )
what is the average preparation time for a recipe	( call SW.listValue ( call SW.aggregate ( string avg ) ( call SW.getProperty ( call SW.getProperty ( call SW.singleton en.recipe ) ( string ! type ) ) ( string preparation_time ) ) ) )
what meal doesnt call for rice pudding	( call SW.listValue ( call SW.filter ( call SW.getProperty ( call SW.singleton en.meal ) ( string ! type ) ) ( call SW.reverse ( string meal ) ) ( string ! = ) en.recipe.rice_pudding ) )
spinach or milk	( call SW.listValue ( call SW.concat en.ingredient.milk en.ingredient.spinach ) )
what recipe requires the lowest cooking time	( call SW.listValue ( call SW.superlative ( call SW.getProperty ( call SW.singleton en.recipe ) ( string ! type ) ) ( string min ) ( call SW.ensureNumericProperty ( string cooking_time ) ) ) )
what recipes posting date is greater than that of rice pudding	( call SW.listValue ( call SW.filter ( call SW.getProperty ( call SW.singleton en.recipe ) ( string ! type ) ) ( call SW.ensureNumericProperty ( string posting_date ) ) ( string > ) ( call SW.ensureNumericEntity ( call SW.getProperty en.recipe.rice_pudding ( string posting_date ) ) ) ) )
name an ingredient required in more than two recipes	( call SW.listValue ( call SW.countComparative ( call SW.getProperty ( call SW.singleton en.ingredient ) ( string ! type ) ) ( call SW.reverse ( string requires ) ) ( string > ) ( number 2 ) ( call SW.getProperty ( call SW.singleton en.recipe ) ( string ! type ) ) ) )
what recipe posted in 2004 calls for milk	( call SW.listValue ( call SW.filter ( call SW.filter ( call SW.getProperty ( call SW.singleton en.recipe ) ( string ! type ) ) ( string requires ) ( string = ) en.ingredient.milk ) ( string posting_date ) ( string = ) ( date 2004 -1 -1 ) ) )
what recipe is for a meal for two	( call SW.listValue ( call SW.countComparative ( call SW.getProperty ( call SW.singleton en.meal ) ( string ! type ) ) ( call SW.reverse ( string meal ) ) ( string >= ) ( number 2 ) ( call SW.getProperty ( call SW.singleton en.recipe ) ( string ! type ) ) ) )
show me recipes posted the same day as rice pudding or after	( call SW.listValue ( call SW.filter ( call SW.getProperty ( call SW.singleton en.recipe ) ( string ! type ) ) ( call SW.ensureNumericProperty ( string posting_date ) ) ( string >= ) ( call SW.ensureNumericEntity ( call SW.getProperty en.recipe.rice_pudding ( string posting_date ) ) ) ) )
what recipe takes no longer to prepare than rice pudding	( call SW.listValue ( call SW.filter ( call SW.getProperty ( call SW.singleton en.recipe ) ( string ! type ) ) ( call SW.ensureNumericProperty ( string preparation_time ) ) ( string <= ) ( call SW.ensureNumericEntity ( call SW.getProperty en.recipe.rice_pudding ( string preparation_time ) ) ) ) )
find a lunch recipe from 2004	( call SW.listValue ( call SW.filter ( call SW.filter ( call SW.getProperty ( call SW.singleton en.recipe ) ( string ! type ) ) ( string posting_date ) ( string = ) ( date 2004 -1 -1 ) ) ( string meal ) ( string = ) en.meal.lunch ) )
what lunch recipe requires milk	( call SW.listValue ( call SW.filter ( call SW.filter ( call SW.getProperty ( call SW.singleton en.recipe ) ( string ! type ) ) ( string requires ) ( string = ) en.ingredient.milk ) ( string meal ) ( string = ) en.meal.lunch ) )
how many meals does this make	( call SW.listValue ( call .size ( call SW.getProperty ( call SW.singleton en.meal ) ( string ! type ) ) ) )
show me recipes for lunch or supper	( call SW.listValue ( call SW.filter ( call SW.getProperty ( call SW.singleton en.recipe ) ( string ! type ) ) ( string meal ) ( string = ) ( call SW.concat en.meal.lunch en.meal.dinner ) ) )
what lunch recipe uses milk as an ingredient	( call SW.listValue ( call SW.filter ( call SW.filter ( call SW.getProperty ( call SW.singleton en.recipe ) ( string ! type ) ) ( string meal ) ( string = ) en.meal.lunch ) ( string requires ) ( string = ) en.ingredient.milk ) )
show me recipes requiring the ingredient milk	( call SW.listValue ( call SW.filter ( call SW.getProperty ( call SW.singleton en.ingredient ) ( string ! type ) ) ( call SW.reverse ( string requires ) ) ( string = ) ( call SW.filter ( call SW.getProperty ( call SW.singleton en.recipe ) ( string ! type ) ) ( string requires ) ( string = ) en.ingredient.milk ) ) )
which recipe is posted after the posting date of rice pudding	( call SW.listValue ( call SW.filter ( call SW.getProperty ( call SW.singleton en.recipe ) ( string ! type ) ) ( call SW.ensureNumericProperty ( string posting_date ) ) ( string > ) ( call SW.ensureNumericEntity ( call SW.getProperty en.recipe.rice_pudding ( string posting_date ) ) ) ) )
recipe for only one meal	( call SW.listValue ( call SW.countComparative ( call SW.getProperty ( call SW.singleton en.recipe ) ( string ! type ) ) ( string meal ) ( string < ) ( number 2 ) ( call SW.getProperty ( call SW.singleton en.meal ) ( string ! type ) ) ) )
show me meals with more than two recipes	( call SW.listValue ( call SW.countComparative ( call SW.getProperty ( call SW.singleton en.meal ) ( string ! type ) ) ( call SW.reverse ( string meal ) ) ( string > ) ( number 2 ) ( call SW.getProperty ( call SW.singleton en.recipe ) ( string ! type ) ) ) )
recipe with posting date not after posting date of rice pudding	( call SW.listValue ( call SW.filter ( call SW.getProperty ( call SW.singleton en.recipe ) ( string ! type ) ) ( call SW.ensureNumericProperty ( string posting_date ) ) ( string <= ) ( call SW.ensureNumericEntity ( call SW.getProperty en.recipe.rice_pudding ( string posting_date ) ) ) ) )
how much time is needed to cook this dish	( call SW.listValue ( call SW.aggregate ( string sum ) ( call SW.getProperty ( call SW.getProperty ( call SW.singleton en.recipe ) ( string ! type ) ) ( string cooking_time ) ) ) )
what recipe was posted during or before 2004	( call SW.listValue ( call SW.filter ( call SW.getProperty ( call SW.singleton en.recipe ) ( string ! type ) ) ( call SW.ensureNumericProperty ( string posting_date ) ) ( string <= ) ( call SW.ensureNumericEntity ( date 2004 -1 -1 ) ) ) )
quiche or rice pudding	( call SW.listValue ( call SW.concat en.recipe.rice_pudding en.recipe.quiche ) )
list  the ingredients of rice pudding	( call SW.listValue ( call SW.filter ( call SW.getProperty ( call SW.singleton en.ingredient ) ( string ! type ) ) ( call SW.reverse ( string requires ) ) ( string = ) en.recipe.rice_pudding ) )
which recipe requires the most ingredients	( call SW.listValue ( call SW.countSuperlative ( call SW.getProperty ( call SW.singleton en.recipe ) ( string ! type ) ) ( string max ) ( string requires ) ( call SW.getProperty ( call SW.singleton en.ingredient ) ( string ! type ) ) ) )
what ingredients are needed for lunch recipes	( call SW.listValue ( call SW.filter ( call SW.getProperty ( call SW.singleton en.ingredient ) ( string ! type ) ) ( call SW.reverse ( string requires ) ) ( string = ) ( call SW.filter ( call SW.getProperty ( call SW.singleton en.recipe ) ( string ! type ) ) ( string meal ) ( string = ) en.meal.lunch ) ) )
which recipes are for two meals at most	( call SW.listValue ( call SW.countComparative ( call SW.getProperty ( call SW.singleton en.recipe ) ( string ! type ) ) ( string meal ) ( string <= ) ( number 2 ) ( call SW.getProperty ( call SW.singleton en.meal ) ( string ! type ) ) ) )
what recipe is prepared in preparation time of rice pudding or earlier	( call SW.listValue ( call SW.filter ( call SW.getProperty ( call SW.singleton en.recipe ) ( string ! type ) ) ( call SW.ensureNumericProperty ( string preparation_time ) ) ( string >= ) ( call SW.ensureNumericEntity ( call SW.getProperty en.recipe.rice_pudding ( string preparation_time ) ) ) ) )
show me recipes posted in 2004 requiring milk	( call SW.listValue ( call SW.filter ( call SW.filter ( call SW.getProperty ( call SW.singleton en.recipe ) ( string ! type ) ) ( string posting_date ) ( string = ) ( date 2004 -1 -1 ) ) ( string requires ) ( string = ) en.ingredient.milk ) )
what ingredients are not in the rice pudding recipe	( call SW.listValue ( call SW.filter ( call SW.getProperty ( call SW.singleton en.ingredient ) ( string ! type ) ) ( call SW.reverse ( string requires ) ) ( string ! = ) en.recipe.rice_pudding ) )
what is the average cooking time of recipe	( call SW.listValue ( call SW.aggregate ( string avg ) ( call SW.getProperty ( call SW.getProperty ( call SW.singleton en.recipe ) ( string ! type ) ) ( string cooking_time ) ) ) )
what meals does rice pudding not go with	( call SW.listValue ( call SW.filter ( call SW.getProperty ( call SW.singleton en.meal ) ( string ! type ) ) ( call SW.reverse ( string meal ) ) ( string ! = ) en.recipe.rice_pudding ) )
what recipes have the same or longer preparation time as rice pudding	( call SW.listValue ( call SW.filter ( call SW.getProperty ( call SW.singleton en.recipe ) ( string ! type ) ) ( call SW.ensureNumericProperty ( string preparation_time ) ) ( string >= ) ( call SW.ensureNumericEntity ( call SW.getProperty en.recipe.rice_pudding ( string preparation_time ) ) ) ) )
what recipes cooking time is greater than that of rice pudding	( call SW.listValue ( call SW.filter ( call SW.getProperty ( call SW.singleton en.recipe ) ( string ! type ) ) ( call SW.ensureNumericProperty ( string cooking_time ) ) ( string > ) ( call SW.ensureNumericEntity ( call SW.getProperty en.recipe.rice_pudding ( string cooking_time ) ) ) ) )
what recipes require the same ingredients as rice pudding	( call SW.listValue ( call SW.filter ( call SW.getProperty ( call SW.singleton en.recipe ) ( string ! type ) ) ( string requires ) ( string = ) ( call SW.filter ( call SW.getProperty ( call SW.singleton en.ingredient ) ( string ! type ) ) ( call SW.reverse ( string requires ) ) ( string = ) en.recipe.rice_pudding ) ) )
show me a recipe that has a posting date of at least 2004	( call SW.listValue ( call SW.filter ( call SW.getProperty ( call SW.singleton en.recipe ) ( string ! type ) ) ( call SW.ensureNumericProperty ( string posting_date ) ) ( string >= ) ( call SW.ensureNumericEntity ( date 2004 -1 -1 ) ) ) )
show me recipes for lunch or dinner	( call SW.listValue ( call SW.concat en.meal.lunch en.meal.dinner ) )
what recipes are for less than two meals	( call SW.listValue ( call SW.countComparative ( call SW.getProperty ( call SW.singleton en.recipe ) ( string ! type ) ) ( string meal ) ( string < ) ( number 2 ) ( call SW.getProperty ( call SW.singleton en.meal ) ( string ! type ) ) ) )
what are the recipe that at most use two ingredients	( call SW.listValue ( call SW.countComparative ( call SW.getProperty ( call SW.singleton en.recipe ) ( string ! type ) ) ( string requires ) ( string <= ) ( number 2 ) ( call SW.getProperty ( call SW.singleton en.ingredient ) ( string ! type ) ) ) )
show me the oldest recipe	( call SW.listValue ( call SW.superlative ( call SW.getProperty ( call SW.singleton en.recipe ) ( string ! type ) ) ( string min ) ( call SW.ensureNumericProperty ( string posting_date ) ) ) )
which recipes require two or more ingredients	( call SW.listValue ( call SW.countComparative ( call SW.getProperty ( call SW.singleton en.ingredient ) ( string ! type ) ) ( call SW.reverse ( string requires ) ) ( string >= ) ( number 2 ) ( call SW.getProperty ( call SW.singleton en.recipe ) ( string ! type ) ) ) )
what is an ingredient found in a recipe for rice pudding or quiche	( call SW.listValue ( call SW.filter ( call SW.getProperty ( call SW.singleton en.ingredient ) ( string ! type ) ) ( call SW.reverse ( string requires ) ) ( string = ) ( call SW.concat en.recipe.rice_pudding en.recipe.quiche ) ) )
show me the average cooking time for all recipes	( call SW.listValue ( call SW.aggregate ( string avg ) ( call SW.getProperty ( call SW.getProperty ( call SW.singleton en.recipe ) ( string ! type ) ) ( string cooking_time ) ) ) )
what recipe requires milk or spinach	( call SW.listValue ( call SW.filter ( call SW.getProperty ( call SW.singleton en.recipe ) ( string ! type ) ) ( string requires ) ( string = ) ( call SW.concat en.ingredient.milk en.ingredient.spinach ) ) )
what recipes have the same or less preparation time as rice pudding	( call SW.listValue ( call SW.filter ( call SW.getProperty ( call SW.singleton en.recipe ) ( string ! type ) ) ( call SW.ensureNumericProperty ( string preparation_time ) ) ( string <= ) ( call SW.ensureNumericEntity ( call SW.getProperty en.recipe.rice_pudding ( string preparation_time ) ) ) ) )
what is the cuisine of rice pudding	( call SW.listValue ( call SW.getProperty en.recipe.rice_pudding ( string cuisine ) ) )
what lunch recipe was posted in 2004	( call SW.listValue ( call SW.filter ( call SW.filter ( call SW.getProperty ( call SW.singleton en.recipe ) ( string ! type ) ) ( string posting_date ) ( string = ) ( date 2004 -1 -1 ) ) ( string meal ) ( string = ) en.meal.lunch ) )
what recipe can be prepped in less time than rice pudding can be cooked	( call SW.listValue ( call SW.filter ( call SW.getProperty ( call SW.singleton en.recipe ) ( string ! type ) ) ( call SW.ensureNumericProperty ( string preparation_time ) ) ( string < ) ( call SW.ensureNumericEntity ( call SW.getProperty en.recipe.rice_pudding ( string cooking_time ) ) ) ) )
show me recipes posted in or after 2004 or in or after 2010	( call SW.listValue ( call SW.filter ( call SW.getProperty ( call SW.singleton en.recipe ) ( string ! type ) ) ( call SW.ensureNumericProperty ( string posting_date ) ) ( string >= ) ( call SW.ensureNumericEntity ( call SW.concat ( date 2004 -1 -1 ) ( date 2010 -1 -1 ) ) ) ) )
find recipes that need two ingredients	( call SW.listValue ( call SW.countComparative ( call SW.getProperty ( call SW.singleton en.recipe ) ( string ! type ) ) ( string requires ) ( string <= ) ( number 2 ) ( call SW.getProperty ( call SW.singleton en.ingredient ) ( string ! type ) ) ) )
what recipe has the least prep time	( call SW.listValue ( call SW.superlative ( call SW.getProperty ( call SW.singleton en.recipe ) ( string ! type ) ) ( string min ) ( call SW.ensureNumericProperty ( string preparation_time ) ) ) )
a lunch recipe posted in 2004	( call SW.listValue ( call SW.filter ( call SW.filter ( call SW.getProperty ( call SW.singleton en.recipe ) ( string ! type ) ) ( string meal ) ( string = ) en.meal.lunch ) ( string posting_date ) ( string = ) ( date 2004 -1 -1 ) ) )
what recipe was posted after rice puddings recipe	( call SW.listValue ( call SW.filter ( call SW.getProperty ( call SW.singleton en.recipe ) ( string ! type ) ) ( call SW.ensureNumericProperty ( string posting_date ) ) ( string > ) ( call SW.ensureNumericEntity ( call SW.getProperty en.recipe.rice_pudding ( string posting_date ) ) ) ) )
what recipes require no more than two ingredients	( call SW.listValue ( call SW.countComparative ( call SW.getProperty ( call SW.singleton en.recipe ) ( string ! type ) ) ( string requires ) ( string <= ) ( number 2 ) ( call SW.getProperty ( call SW.singleton en.ingredient ) ( string ! type ) ) ) )
what recipe was posted no later than 2004 or 2010	( call SW.listValue ( call SW.filter ( call SW.getProperty ( call SW.singleton en.recipe ) ( string ! type ) ) ( call SW.ensureNumericProperty ( string posting_date ) ) ( string <= ) ( call SW.ensureNumericEntity ( call SW.concat ( date 2004 -1 -1 ) ( date 2010 -1 -1 ) ) ) ) )
which recipes have at most two cuisines	( call SW.listValue ( call SW.countComparative ( call SW.getProperty ( call SW.singleton en.recipe ) ( string ! type ) ) ( string cuisine ) ( string <= ) ( number 2 ) ) )
which recipe has a larger cooking time than the preparation time needed for rice pudding	( call SW.listValue ( call SW.filter ( call SW.getProperty ( call SW.singleton en.recipe ) ( string ! type ) ) ( call SW.ensureNumericProperty ( string cooking_time ) ) ( string > ) ( call SW.ensureNumericEntity ( call SW.getProperty en.recipe.rice_pudding ( string preparation_time ) ) ) ) )
what is the total number of recipes	( call SW.listValue ( call .size ( call SW.getProperty ( call SW.singleton en.recipe ) ( string ! type ) ) ) )
what recipes posting date is at most 2004 or 2010	( call SW.listValue ( call SW.filter ( call SW.getProperty ( call SW.singleton en.recipe ) ( string ! type ) ) ( call SW.ensureNumericProperty ( string posting_date ) ) ( string <= ) ( call SW.ensureNumericEntity ( call SW.concat ( date 2004 -1 -1 ) ( date 2010 -1 -1 ) ) ) ) )
which recipes have the most number of meals	( call SW.listValue ( call SW.countSuperlative ( call SW.getProperty ( call SW.singleton en.recipe ) ( string ! type ) ) ( string max ) ( string meal ) ( call SW.getProperty ( call SW.singleton en.meal ) ( string ! type ) ) ) )
what meals have recipes that use milk	( call SW.listValue ( call SW.filter ( call SW.getProperty ( call SW.singleton en.meal ) ( string ! type ) ) ( call SW.reverse ( string meal ) ) ( string = ) ( call SW.filter ( call SW.getProperty ( call SW.singleton en.recipe ) ( string ! type ) ) ( string requires ) ( string = ) en.ingredient.milk ) ) )
find a recipe that is not suitable for lunch	( call SW.listValue ( call SW.filter ( call SW.getProperty ( call SW.singleton en.recipe ) ( string ! type ) ) ( string meal ) ( string ! = ) en.meal.lunch ) )
what recipes posting date is lesser than that of rice pudding	( call SW.listValue ( call SW.filter ( call SW.getProperty ( call SW.singleton en.recipe ) ( string ! type ) ) ( call SW.ensureNumericProperty ( string posting_date ) ) ( string < ) ( call SW.ensureNumericEntity ( call SW.getProperty en.recipe.rice_pudding ( string posting_date ) ) ) ) )
show me all the recipes posted after 2010	( call SW.listValue ( call SW.filter ( call SW.getProperty ( call SW.singleton en.recipe ) ( string ! type ) ) ( call SW.ensureNumericProperty ( string posting_date ) ) ( string > ) ( call SW.ensureNumericEntity ( call SW.concat ( date 2004 -1 -1 ) ( date 2010 -1 -1 ) ) ) ) )
show me recipes posted after 2004	( call SW.listValue ( call SW.filter ( call SW.getProperty ( call SW.singleton en.recipe ) ( string ! type ) ) ( call SW.ensureNumericProperty ( string posting_date ) ) ( string > ) ( call SW.ensureNumericEntity ( call SW.concat ( date 2004 -1 -1 ) ( date 2010 -1 -1 ) ) ) ) )
what recipe takes same or less time to prepare rice pudding	( call SW.listValue ( call SW.filter ( call SW.getProperty ( call SW.singleton en.recipe ) ( string ! type ) ) ( call SW.ensureNumericProperty ( string preparation_time ) ) ( string <= ) ( call SW.ensureNumericEntity ( call SW.getProperty en.recipe.rice_pudding ( string preparation_time ) ) ) ) )
what recipe makes the fewest types of cuisine	( call SW.listValue ( call SW.countSuperlative ( call SW.getProperty ( call SW.singleton en.recipe ) ( string ! type ) ) ( string min ) ( string cuisine ) ) )
what recipes need milk or spinach	( call SW.listValue ( call SW.concat en.ingredient.milk en.ingredient.spinach ) )
meal with more than two recipes	( call SW.listValue ( call SW.countComparative ( call SW.getProperty ( call SW.singleton en.meal ) ( string ! type ) ) ( call SW.reverse ( string meal ) ) ( string > ) ( number 2 ) ( call SW.getProperty ( call SW.singleton en.recipe ) ( string ! type ) ) ) )
which recipe requires milk or spinach	( call SW.listValue ( call SW.concat en.ingredient.milk en.ingredient.spinach ) )
show me meals including rice pudding	( call SW.listValue ( call SW.filter ( call SW.getProperty ( call SW.singleton en.meal ) ( string ! type ) ) ( call SW.reverse ( string meal ) ) ( string = ) en.recipe.rice_pudding ) )
which recipe was posted the earliest	( call SW.listValue ( call SW.superlative ( call SW.getProperty ( call SW.singleton en.recipe ) ( string ! type ) ) ( string min ) ( call SW.ensureNumericProperty ( string posting_date ) ) ) )
what recipe was posted the same day as rice pudding	( call SW.listValue ( call SW.filter ( call SW.getProperty ( call SW.singleton en.recipe ) ( string ! type ) ) ( string posting_date ) ( string = ) ( call SW.getProperty en.recipe.rice_pudding ( string posting_date ) ) ) )
single ingredient recipe	( call SW.listValue ( call SW.countComparative ( call SW.getProperty ( call SW.singleton en.recipe ) ( string ! type ) ) ( string requires ) ( string < ) ( number 2 ) ( call SW.getProperty ( call SW.singleton en.ingredient ) ( string ! type ) ) ) )
what ingredient is required in either rice pudding or quiche	( call SW.listValue ( call SW.filter ( call SW.getProperty ( call SW.singleton en.ingredient ) ( string ! type ) ) ( call SW.reverse ( string requires ) ) ( string = ) ( call SW.concat en.recipe.rice_pudding en.recipe.quiche ) ) )
show me recipes that cannot be taken for lunch	( call SW.listValue ( call SW.filter ( call SW.getProperty ( call SW.singleton en.recipe ) ( string ! type ) ) ( string meal ) ( string ! = ) en.meal.lunch ) )
meal than rice pudding is not taken	( call SW.listValue ( call SW.filter ( call SW.getProperty ( call SW.singleton en.meal ) ( string ! type ) ) ( call SW.reverse ( string meal ) ) ( string ! = ) en.recipe.rice_pudding ) )
what is a meal with the most number of recipes	( call SW.listValue ( call SW.countSuperlative ( call SW.getProperty ( call SW.singleton en.meal ) ( string ! type ) ) ( string max ) ( call SW.reverse ( string meal ) ) ( call SW.getProperty ( call SW.singleton en.recipe ) ( string ! type ) ) ) )
either 2004 or 2010	( call SW.listValue ( call SW.concat ( date 2004 -1 -1 ) ( date 2010 -1 -1 ) ) )
find a recipe which has a longer cooking time than rice pudding	( call SW.listValue ( call SW.filter ( call SW.getProperty ( call SW.singleton en.recipe ) ( string ! type ) ) ( call SW.ensureNumericProperty ( string cooking_time ) ) ( string > ) ( call SW.ensureNumericEntity ( call SW.getProperty en.recipe.rice_pudding ( string preparation_time ) ) ) ) )
which recipes take less time to prepare than to cook rice pudding	( call SW.listValue ( call SW.filter ( call SW.getProperty ( call SW.singleton en.recipe ) ( string ! type ) ) ( call SW.ensureNumericProperty ( string preparation_time ) ) ( string < ) ( call SW.ensureNumericEntity ( call SW.getProperty en.recipe.rice_pudding ( string cooking_time ) ) ) ) )
what recipe takes at least as long to prepare as rice pudding	( call SW.listValue ( call SW.filter ( call SW.getProperty ( call SW.singleton en.recipe ) ( string ! type ) ) ( call SW.ensureNumericProperty ( string preparation_time ) ) ( string >= ) ( call SW.ensureNumericEntity ( call SW.getProperty en.recipe.rice_pudding ( string preparation_time ) ) ) ) )
show me a meal that has more than two recipes	( call SW.listValue ( call SW.countComparative ( call SW.getProperty ( call SW.singleton en.meal ) ( string ! type ) ) ( call SW.reverse ( string meal ) ) ( string > ) ( number 2 ) ( call SW.getProperty ( call SW.singleton en.recipe ) ( string ! type ) ) ) )
what recipe has the greatest cooking time	( call SW.listValue ( call SW.superlative ( call SW.getProperty ( call SW.singleton en.recipe ) ( string ! type ) ) ( string max ) ( call SW.ensureNumericProperty ( string cooking_time ) ) ) )
show me recipes that take the same amount of time or more to cook as rice pudding	( call SW.listValue ( call SW.filter ( call SW.getProperty ( call SW.singleton en.recipe ) ( string ! type ) ) ( call SW.ensureNumericProperty ( string cooking_time ) ) ( string >= ) ( call SW.ensureNumericEntity ( call SW.getProperty en.recipe.rice_pudding ( string cooking_time ) ) ) ) )
which recipe takes the longest to prepare	( call SW.listValue ( call SW.superlative ( call SW.getProperty ( call SW.singleton en.recipe ) ( string ! type ) ) ( string max ) ( call SW.ensureNumericProperty ( string preparation_time ) ) ) )
how many ingredients are there	( call SW.listValue ( call .size ( call SW.getProperty ( call SW.singleton en.ingredient ) ( string ! type ) ) ) )
show me recipes for two meals at most	( call SW.listValue ( call SW.countComparative ( call SW.getProperty ( call SW.singleton en.recipe ) ( string ! type ) ) ( string meal ) ( string <= ) ( number 2 ) ( call SW.getProperty ( call SW.singleton en.meal ) ( string ! type ) ) ) )
which is the recipe that was posted last	( call SW.listValue ( call SW.superlative ( call SW.getProperty ( call SW.singleton en.recipe ) ( string ! type ) ) ( string max ) ( call SW.ensureNumericProperty ( string posting_date ) ) ) )
show me recipes that require cooking time thats more than rice pudding	( call SW.listValue ( call SW.filter ( call SW.getProperty ( call SW.singleton en.recipe ) ( string ! type ) ) ( call SW.ensureNumericProperty ( string cooking_time ) ) ( string > ) ( call SW.ensureNumericEntity ( call SW.getProperty en.recipe.rice_pudding ( string cooking_time ) ) ) ) )
what recipe was posted in 2004 and needs milk	( call SW.listValue ( call SW.filter ( call SW.filter ( call SW.getProperty ( call SW.singleton en.recipe ) ( string ! type ) ) ( string posting_date ) ( string = ) ( date 2004 -1 -1 ) ) ( string requires ) ( string = ) en.ingredient.milk ) )
how many recipes are there	( call SW.listValue ( call .size ( call SW.getProperty ( call SW.singleton en.recipe ) ( string ! type ) ) ) )
which recipes were posted up to 2004 or 2010	( call SW.listValue ( call SW.filter ( call SW.getProperty ( call SW.singleton en.recipe ) ( string ! type ) ) ( call SW.ensureNumericProperty ( string posting_date ) ) ( string <= ) ( call SW.ensureNumericEntity ( call SW.concat ( date 2004 -1 -1 ) ( date 2010 -1 -1 ) ) ) ) )
what is the usual time required to finish the recipe	( call SW.listValue ( call SW.aggregate ( string avg ) ( call SW.getProperty ( call SW.getProperty ( call SW.singleton en.recipe ) ( string ! type ) ) ( string preparation_time ) ) ) )
ingredient in rice pudding and quiche	( call SW.listValue ( call SW.filter ( call SW.getProperty ( call SW.singleton en.ingredient ) ( string ! type ) ) ( call SW.reverse ( string requires ) ) ( string = ) ( call SW.concat en.recipe.rice_pudding en.recipe.quiche ) ) )
what meals are recipes for lunch for	( call SW.listValue ( call SW.filter ( call SW.getProperty ( call SW.singleton en.meal ) ( string ! type ) ) ( call SW.reverse ( string meal ) ) ( string = ) ( call SW.filter ( call SW.getProperty ( call SW.singleton en.recipe ) ( string ! type ) ) ( string meal ) ( string = ) en.meal.lunch ) ) )
which recipes have a preparation time as long as the cooking time of rice pudding	( call SW.listValue ( call SW.filter ( call SW.getProperty ( call SW.singleton en.recipe ) ( string ! type ) ) ( string preparation_time ) ( string = ) ( call SW.getProperty en.recipe.rice_pudding ( string cooking_time ) ) ) )
which recipes take longer to cook than rice pudding	( call SW.listValue ( call SW.filter ( call SW.getProperty ( call SW.singleton en.recipe ) ( string ! type ) ) ( call SW.ensureNumericProperty ( string preparation_time ) ) ( string > ) ( call SW.ensureNumericEntity ( call SW.getProperty en.recipe.rice_pudding ( string cooking_time ) ) ) ) )
what recipe calling for milk was posted in 2004	( call SW.listValue ( call SW.filter ( call SW.filter ( call SW.getProperty ( call SW.singleton en.recipe ) ( string ! type ) ) ( string posting_date ) ( string = ) ( date 2004 -1 -1 ) ) ( string requires ) ( string = ) en.ingredient.milk ) )
show me recipes that fall under two cuisines or less	( call SW.listValue ( call SW.countComparative ( call SW.getProperty ( call SW.singleton en.recipe ) ( string ! type ) ) ( string cuisine ) ( string <= ) ( number 2 ) ) )
show recipes with one cuisine	( call SW.listValue ( call SW.countSuperlative ( call SW.getProperty ( call SW.singleton en.recipe ) ( string ! type ) ) ( string min ) ( string cuisine ) ) )
when was rice pudding posted	( call SW.listValue ( call SW.getProperty en.recipe.rice_pudding ( string posting_date ) ) )
what is a recipe using milk or spinach as an ingredient	( call SW.listValue ( call SW.concat en.ingredient.milk en.ingredient.spinach ) )
what type of cuisine is rice pudding	( call SW.listValue ( call SW.getProperty en.recipe.rice_pudding ( string cuisine ) ) )
find recipes that were posted before 2004 or 2010	( call SW.listValue ( call SW.filter ( call SW.getProperty ( call SW.singleton en.recipe ) ( string ! type ) ) ( call SW.ensureNumericProperty ( string posting_date ) ) ( string < ) ( call SW.ensureNumericEntity ( call SW.concat ( date 2004 -1 -1 ) ( date 2010 -1 -1 ) ) ) ) )
what recipe makes something for lunch	( call SW.listValue ( call SW.filter ( call SW.filter ( call SW.getProperty ( call SW.singleton en.recipe ) ( string ! type ) ) ( string meal ) ( string = ) en.meal.lunch ) ( string meal ) ( string = ) en.meal.lunch ) )
what is the number of ingredients for that recipe	( call SW.listValue ( call .size ( call SW.getProperty ( call SW.singleton en.ingredient ) ( string ! type ) ) ) )
show me preparation time for rice pudding	( call SW.listValue ( call SW.getProperty en.recipe.rice_pudding ( string preparation_time ) ) )
show recipes whose posting date is not 2004	( call SW.listValue ( call SW.filter ( call SW.getProperty ( call SW.singleton en.recipe ) ( string ! type ) ) ( string posting_date ) ( string ! = ) ( date 2004 -1 -1 ) ) )
for what meal is rice pudding used	( call SW.listValue ( call SW.filter ( call SW.filter ( call SW.getProperty ( call SW.singleton en.meal ) ( string ! type ) ) ( call SW.reverse ( string meal ) ) ( string = ) en.recipe.rice_pudding ) ( call SW.reverse ( string meal ) ) ( string = ) en.recipe.rice_pudding ) )
what recipes take the same amount of time or less to cook as rice pudding	( call SW.listValue ( call SW.filter ( call SW.getProperty ( call SW.singleton en.recipe ) ( string ! type ) ) ( call SW.ensureNumericProperty ( string cooking_time ) ) ( string <= ) ( call SW.ensureNumericEntity ( call SW.getProperty en.recipe.rice_pudding ( string cooking_time ) ) ) ) )
what is the prep time for rice pudding	( call SW.listValue ( call SW.getProperty en.recipe.rice_pudding ( string preparation_time ) ) )
show me recipes posted in 2004 and 2010	( call SW.listValue ( call SW.filter ( call SW.getProperty ( call SW.singleton en.recipe ) ( string ! type ) ) ( string posting_date ) ( string = ) ( call SW.concat ( date 2004 -1 -1 ) ( date 2010 -1 -1 ) ) ) )
which recipe can be prepared at the earliest	( call SW.listValue ( call SW.superlative ( call SW.getProperty ( call SW.singleton en.recipe ) ( string ! type ) ) ( string min ) ( call SW.ensureNumericProperty ( string preparation_time ) ) ) )
how many total meals are there	( call SW.listValue ( call .size ( call SW.getProperty ( call SW.singleton en.meal ) ( string ! type ) ) ) )
show me lunch recipes that require milk	( call SW.listValue ( call SW.filter ( call SW.filter ( call SW.getProperty ( call SW.singleton en.recipe ) ( string ! type ) ) ( string meal ) ( string = ) en.meal.lunch ) ( string requires ) ( string = ) en.ingredient.milk ) )
what are the recipes that are made with milk	( call SW.listValue ( call SW.filter ( call SW.getProperty ( call SW.singleton en.recipe ) ( string ! type ) ) ( string requires ) ( string = ) en.ingredient.milk ) )
what ingredients does quiche or rice pudding require	( call SW.listValue ( call SW.filter ( call SW.getProperty ( call SW.singleton en.ingredient ) ( string ! type ) ) ( call SW.reverse ( string requires ) ) ( string = ) ( call SW.concat en.recipe.rice_pudding en.recipe.quiche ) ) )
what recipe makes a non lunch meal	( call SW.listValue ( call SW.filter ( call SW.getProperty ( call SW.singleton en.recipe ) ( string ! type ) ) ( string meal ) ( string ! = ) en.meal.lunch ) )
what is the used milk or spinach	( call SW.listValue ( call SW.concat en.ingredient.milk en.ingredient.spinach ) )
how long does this recipe take to cook	( call SW.listValue ( call SW.aggregate ( string sum ) ( call SW.getProperty ( call SW.getProperty ( call SW.singleton en.recipe ) ( string ! type ) ) ( string cooking_time ) ) ) )
show ingredients for lunch recipes	( call SW.listValue ( call SW.filter ( call SW.getProperty ( call SW.singleton en.ingredient ) ( string ! type ) ) ( call SW.reverse ( string requires ) ) ( string = ) ( call SW.filter ( call SW.getProperty ( call SW.singleton en.recipe ) ( string ! type ) ) ( string meal ) ( string = ) en.meal.lunch ) ) )
what recipe was posted the same date as the rice pudding recipe	( call SW.listValue ( call SW.filter ( call SW.getProperty ( call SW.singleton en.recipe ) ( string ! type ) ) ( string posting_date ) ( string = ) ( call SW.getProperty en.recipe.rice_pudding ( string posting_date ) ) ) )
which recipe was posted first	( call SW.listValue ( call SW.superlative ( call SW.getProperty ( call SW.singleton en.recipe ) ( string ! type ) ) ( string min ) ( call SW.ensureNumericProperty ( string posting_date ) ) ) )
which recipe requires the same ingredient as rice pudding	( call SW.listValue ( call SW.filter ( call SW.getProperty ( call SW.singleton en.recipe ) ( string ! type ) ) ( string requires ) ( string = ) ( call SW.filter ( call SW.getProperty ( call SW.singleton en.ingredient ) ( string ! type ) ) ( call SW.reverse ( string requires ) ) ( string = ) en.recipe.rice_pudding ) ) )
show me recipes requiring milk or spinach	( call SW.listValue ( call SW.filter ( call SW.getProperty ( call SW.singleton en.recipe ) ( string ! type ) ) ( string requires ) ( string = ) ( call SW.concat en.ingredient.milk en.ingredient.spinach ) ) )
show me recipes that require milk	( call SW.listValue ( call SW.filter ( call SW.getProperty ( call SW.singleton en.recipe ) ( string ! type ) ) ( string requires ) ( string = ) en.ingredient.milk ) )
which recipe is found in only one cuisine	( call SW.listValue ( call SW.countComparative ( call SW.getProperty ( call SW.singleton en.recipe ) ( string ! type ) ) ( string cuisine ) ( string < ) ( number 2 ) ) )
what recipes have the same cooking time as rice pudding	( call SW.listValue ( call SW.filter ( call SW.getProperty ( call SW.singleton en.recipe ) ( string ! type ) ) ( string cooking_time ) ( string = ) ( call SW.getProperty en.recipe.rice_pudding ( string cooking_time ) ) ) )
show me recipes that take less time to prepare than rice pudding	( call SW.listValue ( call SW.filter ( call SW.getProperty ( call SW.singleton en.recipe ) ( string ! type ) ) ( call SW.ensureNumericProperty ( string cooking_time ) ) ( string < ) ( call SW.ensureNumericEntity ( call SW.getProperty en.recipe.rice_pudding ( string preparation_time ) ) ) ) )
what is the most ingredient that this recipe requires	( call SW.listValue ( call SW.countSuperlative ( call SW.getProperty ( call SW.singleton en.ingredient ) ( string ! type ) ) ( string max ) ( call SW.reverse ( string requires ) ) ( call SW.getProperty ( call SW.singleton en.recipe ) ( string ! type ) ) ) )
find the recipes for lunch	( call SW.listValue ( call SW.filter ( call SW.filter ( call SW.getProperty ( call SW.singleton en.recipe ) ( string ! type ) ) ( string meal ) ( string = ) en.meal.lunch ) ( string meal ) ( string = ) en.meal.lunch ) )
what recipe has the smallest preparation time	( call SW.listValue ( call SW.superlative ( call SW.getProperty ( call SW.singleton en.recipe ) ( string ! type ) ) ( string min ) ( call SW.ensureNumericProperty ( string preparation_time ) ) ) )
which recipes were posted in 2004 for lunch	( call SW.listValue ( call SW.filter ( call SW.filter ( call SW.getProperty ( call SW.singleton en.recipe ) ( string ! type ) ) ( string meal ) ( string = ) en.meal.lunch ) ( string posting_date ) ( string = ) ( date 2004 -1 -1 ) ) )
what recipe has at the most no more than two cuisines	( call SW.listValue ( call SW.countComparative ( call SW.getProperty ( call SW.singleton en.recipe ) ( string ! type ) ) ( string cuisine ) ( string <= ) ( number 2 ) ) )
recipe requires less than three ingredients	( call SW.listValue ( call SW.countComparative ( call SW.getProperty ( call SW.singleton en.recipe ) ( string ! type ) ) ( string requires ) ( string <= ) ( number 2 ) ( call SW.getProperty ( call SW.singleton en.ingredient ) ( string ! type ) ) ) )
which recipe has the most number of cuisine	( call SW.listValue ( call SW.countSuperlative ( call SW.getProperty ( call SW.singleton en.recipe ) ( string ! type ) ) ( string max ) ( string cuisine ) ) )
what recipe is fastest cooked	( call SW.listValue ( call SW.superlative ( call SW.getProperty ( call SW.singleton en.recipe ) ( string ! type ) ) ( string min ) ( call SW.ensureNumericProperty ( string cooking_time ) ) ) )
what recipe is not lunch	( call SW.listValue ( call SW.filter ( call SW.getProperty ( call SW.singleton en.recipe ) ( string ! type ) ) ( string meal ) ( string ! = ) en.meal.lunch ) )
what recipes posting date is greater than 2004	( call SW.listValue ( call SW.filter ( call SW.getProperty ( call SW.singleton en.recipe ) ( string ! type ) ) ( call SW.ensureNumericProperty ( string posting_date ) ) ( string > ) ( call SW.ensureNumericEntity ( date 2004 -1 -1 ) ) ) )
what recipes have the most ingredients	( call SW.listValue ( call SW.countSuperlative ( call SW.getProperty ( call SW.singleton en.recipe ) ( string ! type ) ) ( string max ) ( string requires ) ( call SW.getProperty ( call SW.singleton en.ingredient ) ( string ! type ) ) ) )
find recipes posted in 2005	( call SW.listValue ( call SW.filter ( call SW.getProperty ( call SW.singleton en.recipe ) ( string ! type ) ) ( string posting_date ) ( string = ) ( date 2004 -1 -1 ) ) )
what recipe cooks for less time than rice pudding takes to prep	( call SW.listValue ( call SW.filter ( call SW.getProperty ( call SW.singleton en.recipe ) ( string ! type ) ) ( call SW.ensureNumericProperty ( string cooking_time ) ) ( string < ) ( call SW.ensureNumericEntity ( call SW.getProperty en.recipe.rice_pudding ( string preparation_time ) ) ) ) )
what is the total cooking time of the recipe	( call SW.listValue ( call SW.aggregate ( string sum ) ( call SW.getProperty ( call SW.getProperty ( call SW.singleton en.recipe ) ( string ! type ) ) ( string cooking_time ) ) ) )
recipe with posting date 2004	( call SW.listValue ( call SW.filter ( call SW.getProperty ( call SW.singleton en.recipe ) ( string ! type ) ) ( string posting_date ) ( string = ) ( date 2004 -1 -1 ) ) )
what recipe cooks in more or the same time as rice pudding takes to prep	( call SW.listValue ( call SW.filter ( call SW.getProperty ( call SW.singleton en.recipe ) ( string ! type ) ) ( call SW.ensureNumericProperty ( string cooking_time ) ) ( string >= ) ( call SW.ensureNumericEntity ( call SW.getProperty en.recipe.rice_pudding ( string preparation_time ) ) ) ) )
show me recipes that require milk or spinach	( call SW.listValue ( call SW.filter ( call SW.getProperty ( call SW.singleton en.recipe ) ( string ! type ) ) ( string requires ) ( string = ) ( call SW.concat en.ingredient.milk en.ingredient.spinach ) ) )
what ingredients go in rice pudding	( call SW.listValue ( call SW.filter ( call SW.filter ( call SW.getProperty ( call SW.singleton en.ingredient ) ( string ! type ) ) ( call SW.reverse ( string requires ) ) ( string = ) en.recipe.rice_pudding ) ( call SW.reverse ( string requires ) ) ( string = ) en.recipe.rice_pudding ) )
show me recipes whose preparation time is a most the cooking time of rice pudding	( call SW.listValue ( call SW.filter ( call SW.getProperty ( call SW.singleton en.recipe ) ( string ! type ) ) ( call SW.ensureNumericProperty ( string preparation_time ) ) ( string <= ) ( call SW.ensureNumericEntity ( call SW.getProperty en.recipe.rice_pudding ( string cooking_time ) ) ) ) )
show me recipes that were not posted in 2004	( call SW.listValue ( call SW.filter ( call SW.getProperty ( call SW.singleton en.recipe ) ( string ! type ) ) ( string posting_date ) ( string ! = ) ( date 2004 -1 -1 ) ) )
show me recipes with a preparation time equal to the cooking time of rice pudding	( call SW.listValue ( call SW.filter ( call SW.getProperty ( call SW.singleton en.recipe ) ( string ! type ) ) ( string preparation_time ) ( string = ) ( call SW.getProperty en.recipe.rice_pudding ( string cooking_time ) ) ) )
what recipes cooking time is longer than that of rice pudding	( call SW.listValue ( call SW.filter ( call SW.getProperty ( call SW.singleton en.recipe ) ( string ! type ) ) ( call SW.ensureNumericProperty ( string cooking_time ) ) ( string > ) ( call SW.ensureNumericEntity ( call SW.getProperty en.recipe.rice_pudding ( string preparation_time ) ) ) ) )
show me recipes with the cuisine least represented	( call SW.listValue ( call SW.countSuperlative ( call SW.getProperty ( call SW.singleton en.recipe ) ( string ! type ) ) ( string min ) ( string cuisine ) ) )
what recipe has the same cooking time as rice pudding	( call SW.listValue ( call SW.filter ( call SW.getProperty ( call SW.singleton en.recipe ) ( string ! type ) ) ( string cooking_time ) ( string = ) ( call SW.getProperty en.recipe.rice_pudding ( string cooking_time ) ) ) )
what recipe is a recipe for lunch	( call SW.listValue ( call SW.filter ( call SW.getProperty ( call SW.singleton en.meal ) ( string ! type ) ) ( call SW.reverse ( string meal ) ) ( string = ) ( call SW.filter ( call SW.getProperty ( call SW.singleton en.recipe ) ( string ! type ) ) ( string meal ) ( string = ) en.meal.lunch ) ) )
name ingredients that is not required for rice pudding	( call SW.listValue ( call SW.filter ( call SW.getProperty ( call SW.singleton en.ingredient ) ( string ! type ) ) ( call SW.reverse ( string requires ) ) ( string ! = ) en.recipe.rice_pudding ) )
what recipe was posted before 2004	( call SW.listValue ( call SW.filter ( call SW.getProperty ( call SW.singleton en.recipe ) ( string ! type ) ) ( call SW.ensureNumericProperty ( string posting_date ) ) ( string < ) ( call SW.ensureNumericEntity ( date 2004 -1 -1 ) ) ) )
which recipe is prepared using the same amount of time as that of rice pudding	( call SW.listValue ( call SW.filter ( call SW.getProperty ( call SW.singleton en.recipe ) ( string ! type ) ) ( call SW.ensureNumericProperty ( string preparation_time ) ) ( string >= ) ( call SW.ensureNumericEntity ( call SW.getProperty en.recipe.rice_pudding ( string preparation_time ) ) ) ) )
which recipes posted in 2004 require milk	( call SW.listValue ( call SW.filter ( call SW.filter ( call SW.getProperty ( call SW.singleton en.recipe ) ( string ! type ) ) ( string requires ) ( string = ) en.ingredient.milk ) ( string posting_date ) ( string = ) ( date 2004 -1 -1 ) ) )
show me recipes requiring an ingredient from rice pudding	( call SW.listValue ( call SW.filter ( call SW.getProperty ( call SW.singleton en.recipe ) ( string ! type ) ) ( string requires ) ( string = ) ( call SW.filter ( call SW.getProperty ( call SW.singleton en.ingredient ) ( string ! type ) ) ( call SW.reverse ( string requires ) ) ( string = ) en.recipe.rice_pudding ) ) )
what recipe needs least ingredients	( call SW.listValue ( call SW.countSuperlative ( call SW.getProperty ( call SW.singleton en.recipe ) ( string ! type ) ) ( string min ) ( string requires ) ( call SW.getProperty ( call SW.singleton en.ingredient ) ( string ! type ) ) ) )
show me recipes posted during 2004 and 2010	( call SW.listValue ( call SW.filter ( call SW.getProperty ( call SW.singleton en.recipe ) ( string ! type ) ) ( string posting_date ) ( string = ) ( call SW.concat ( date 2004 -1 -1 ) ( date 2010 -1 -1 ) ) ) )
what recipe requires milk	( call SW.listValue ( call SW.filter ( call SW.getProperty ( call SW.singleton en.ingredient ) ( string ! type ) ) ( call SW.reverse ( string requires ) ) ( string = ) ( call SW.filter ( call SW.getProperty ( call SW.singleton en.recipe ) ( string ! type ) ) ( string requires ) ( string = ) en.ingredient.milk ) ) )
what meal has quiche and rice pudding	( call SW.listValue ( call SW.filter ( call SW.getProperty ( call SW.singleton en.meal ) ( string ! type ) ) ( call SW.reverse ( string meal ) ) ( string = ) ( call SW.concat en.recipe.rice_pudding en.recipe.quiche ) ) )
what recipe needs spinach or milk for its preparation	( call SW.listValue ( call SW.filter ( call SW.getProperty ( call SW.singleton en.recipe ) ( string ! type ) ) ( string requires ) ( string = ) ( call SW.concat en.ingredient.milk en.ingredient.spinach ) ) )
which recipes require milk or spinach	( call SW.listValue ( call SW.filter ( call SW.getProperty ( call SW.singleton en.recipe ) ( string ! type ) ) ( string requires ) ( string = ) ( call SW.concat en.ingredient.milk en.ingredient.spinach ) ) )
show me recipes that have the same preparation time as rice pudding	( call SW.listValue ( call SW.filter ( call SW.getProperty ( call SW.singleton en.recipe ) ( string ! type ) ) ( string preparation_time ) ( string = ) ( call SW.getProperty en.recipe.rice_pudding ( string preparation_time ) ) ) )
show me recipes posted after 2004 or after 2010	( call SW.listValue ( call SW.filter ( call SW.getProperty ( call SW.singleton en.recipe ) ( string ! type ) ) ( call SW.ensureNumericProperty ( string posting_date ) ) ( string > ) ( call SW.ensureNumericEntity ( call SW.concat ( date 2004 -1 -1 ) ( date 2010 -1 -1 ) ) ) ) )
what recipe takes the longest time to prep	( call SW.listValue ( call SW.superlative ( call SW.getProperty ( call SW.singleton en.recipe ) ( string ! type ) ) ( string max ) ( call SW.ensureNumericProperty ( string preparation_time ) ) ) )
recipes prepared in rice puddings cooking time	( call SW.listValue ( call SW.filter ( call SW.getProperty ( call SW.singleton en.recipe ) ( string ! type ) ) ( string preparation_time ) ( string = ) ( call SW.getProperty en.recipe.rice_pudding ( string cooking_time ) ) ) )
what is the most commonly used ingredient	( call SW.listValue ( call SW.countSuperlative ( call SW.getProperty ( call SW.singleton en.ingredient ) ( string ! type ) ) ( string max ) ( call SW.reverse ( string requires ) ) ( call SW.getProperty ( call SW.singleton en.recipe ) ( string ! type ) ) ) )
which recipe has the least number of meals	( call SW.listValue ( call SW.countSuperlative ( call SW.getProperty ( call SW.singleton en.recipe ) ( string ! type ) ) ( string min ) ( string meal ) ( call SW.getProperty ( call SW.singleton en.meal ) ( string ! type ) ) ) )
show me recipes posted no earlier than 2004	( call SW.listValue ( call SW.filter ( call SW.getProperty ( call SW.singleton en.recipe ) ( string ! type ) ) ( call SW.ensureNumericProperty ( string posting_date ) ) ( string >= ) ( call SW.ensureNumericEntity ( date 2004 -1 -1 ) ) ) )
what recipes have a cooking time that is at least as long as rice puddings preparation time	( call SW.listValue ( call SW.filter ( call SW.getProperty ( call SW.singleton en.recipe ) ( string ! type ) ) ( call SW.ensureNumericProperty ( string cooking_time ) ) ( string >= ) ( call SW.ensureNumericEntity ( call SW.getProperty en.recipe.rice_pudding ( string preparation_time ) ) ) ) )
show me recipes with preparation times longer than cooking time of rice pudding	( call SW.listValue ( call SW.filter ( call SW.getProperty ( call SW.singleton en.recipe ) ( string ! type ) ) ( call SW.ensureNumericProperty ( string preparation_time ) ) ( string > ) ( call SW.ensureNumericEntity ( call SW.getProperty en.recipe.rice_pudding ( string cooking_time ) ) ) ) )
what meal is the recipe rice pudding for	( call SW.listValue ( call SW.filter ( call SW.getProperty ( call SW.singleton en.recipe ) ( string ! type ) ) ( string meal ) ( string = ) ( call SW.filter ( call SW.getProperty ( call SW.singleton en.meal ) ( string ! type ) ) ( call SW.reverse ( string meal ) ) ( string = ) en.recipe.rice_pudding ) ) )
what lunch recipes contain milk	( call SW.listValue ( call SW.filter ( call SW.filter ( call SW.getProperty ( call SW.singleton en.recipe ) ( string ! type ) ) ( string requires ) ( string = ) en.ingredient.milk ) ( string meal ) ( string = ) en.meal.lunch ) )
which recipes take longer to cook than to prepare rice pudding	( call SW.listValue ( call SW.filter ( call SW.getProperty ( call SW.singleton en.recipe ) ( string ! type ) ) ( call SW.ensureNumericProperty ( string cooking_time ) ) ( string > ) ( call SW.ensureNumericEntity ( call SW.getProperty en.recipe.rice_pudding ( string preparation_time ) ) ) ) )
which recipe was posted at the posting date of rice pudding	( call SW.listValue ( call SW.filter ( call SW.getProperty ( call SW.singleton en.recipe ) ( string ! type ) ) ( call SW.ensureNumericProperty ( string posting_date ) ) ( string <= ) ( call SW.ensureNumericEntity ( call SW.getProperty en.recipe.rice_pudding ( string posting_date ) ) ) ) )
recipes with more preparation time than rice pudding	( call SW.listValue ( call SW.filter ( call SW.getProperty ( call SW.singleton en.recipe ) ( string ! type ) ) ( call SW.ensureNumericProperty ( string preparation_time ) ) ( string > ) ( call SW.ensureNumericEntity ( call SW.getProperty en.recipe.rice_pudding ( string preparation_time ) ) ) ) )
which recipe was posted during 2004	( call SW.listValue ( call SW.filter ( call SW.getProperty ( call SW.singleton en.recipe ) ( string ! type ) ) ( call SW.ensureNumericProperty ( string posting_date ) ) ( string <= ) ( call SW.ensureNumericEntity ( date 2004 -1 -1 ) ) ) )
what ingredient is used for the least amount of recipes	( call SW.listValue ( call SW.countSuperlative ( call SW.getProperty ( call SW.singleton en.ingredient ) ( string ! type ) ) ( string min ) ( call SW.reverse ( string requires ) ) ( call SW.getProperty ( call SW.singleton en.recipe ) ( string ! type ) ) ) )
which recipe has the longest ingredient list	( call SW.listValue ( call SW.countSuperlative ( call SW.getProperty ( call SW.singleton en.recipe ) ( string ! type ) ) ( string max ) ( string requires ) ( call SW.getProperty ( call SW.singleton en.ingredient ) ( string ! type ) ) ) )
show me recipes that have a shorter preparation time than rice pudding	( call SW.listValue ( call SW.filter ( call SW.getProperty ( call SW.singleton en.recipe ) ( string ! type ) ) ( call SW.ensureNumericProperty ( string preparation_time ) ) ( string < ) ( call SW.ensureNumericEntity ( call SW.getProperty en.recipe.rice_pudding ( string preparation_time ) ) ) ) )
find all recipes posted after 2004	( call SW.listValue ( call SW.filter ( call SW.getProperty ( call SW.singleton en.recipe ) ( string ! type ) ) ( call SW.ensureNumericProperty ( string posting_date ) ) ( string > ) ( call SW.ensureNumericEntity ( call SW.concat ( date 2004 -1 -1 ) ( date 2010 -1 -1 ) ) ) ) )
which recipe needs longer preparation time than that of rice pudding	( call SW.listValue ( call SW.filter ( call SW.getProperty ( call SW.singleton en.recipe ) ( string ! type ) ) ( call SW.ensureNumericProperty ( string preparation_time ) ) ( string > ) ( call SW.ensureNumericEntity ( call SW.getProperty en.recipe.rice_pudding ( string cooking_time ) ) ) ) )
what ingredients are used in rice pudding or quiche	( call SW.listValue ( call SW.filter ( call SW.getProperty ( call SW.singleton en.ingredient ) ( string ! type ) ) ( call SW.reverse ( string requires ) ) ( string = ) ( call SW.concat en.recipe.rice_pudding en.recipe.quiche ) ) )
what recipes are for the same meal as rice pudding	( call SW.listValue ( call SW.filter ( call SW.getProperty ( call SW.singleton en.recipe ) ( string ! type ) ) ( string meal ) ( string = ) ( call SW.filter ( call SW.getProperty ( call SW.singleton en.meal ) ( string ! type ) ) ( call SW.reverse ( string meal ) ) ( string = ) en.recipe.rice_pudding ) ) )
show me recipes from the same cuisine as rice pudding	( call SW.listValue ( call SW.filter ( call SW.getProperty ( call SW.singleton en.recipe ) ( string ! type ) ) ( string cuisine ) ( string = ) ( call SW.getProperty en.recipe.rice_pudding ( string cuisine ) ) ) )
what recipe takes most time to cook	( call SW.listValue ( call SW.superlative ( call SW.getProperty ( call SW.singleton en.recipe ) ( string ! type ) ) ( string max ) ( call SW.ensureNumericProperty ( string cooking_time ) ) ) )
a recipe for a meal other than lunch	( call SW.listValue ( call SW.filter ( call SW.getProperty ( call SW.singleton en.recipe ) ( string ! type ) ) ( string meal ) ( string ! = ) en.meal.lunch ) )
to which cuisine does rice pudding belong	( call SW.listValue ( call SW.getProperty en.recipe.rice_pudding ( string cuisine ) ) )
what is the cook time for rice pudding	( call SW.listValue ( call SW.getProperty en.recipe.rice_pudding ( string cooking_time ) ) )
show recipes with milk as an ingredient and is posted in 2004	( call SW.listValue ( call SW.filter ( call SW.filter ( call SW.getProperty ( call SW.singleton en.recipe ) ( string ! type ) ) ( string posting_date ) ( string = ) ( date 2004 -1 -1 ) ) ( string requires ) ( string = ) en.ingredient.milk ) )
what recipes takes more time to prepare than rice pudding	( call SW.listValue ( call SW.filter ( call SW.getProperty ( call SW.singleton en.recipe ) ( string ! type ) ) ( call SW.ensureNumericProperty ( string cooking_time ) ) ( string > ) ( call SW.ensureNumericEntity ( call SW.getProperty en.recipe.rice_pudding ( string cooking_time ) ) ) ) )
show recipes posted on the same date as rice pudding	( call SW.listValue ( call SW.filter ( call SW.getProperty ( call SW.singleton en.recipe ) ( string ! type ) ) ( string posting_date ) ( string = ) ( call SW.getProperty en.recipe.rice_pudding ( string posting_date ) ) ) )
what is a recipe used for fewer than two meals	( call SW.listValue ( call SW.countComparative ( call SW.getProperty ( call SW.singleton en.recipe ) ( string ! type ) ) ( string meal ) ( string < ) ( number 2 ) ( call SW.getProperty ( call SW.singleton en.meal ) ( string ! type ) ) ) )
show me recipes for the most meals	( call SW.listValue ( call SW.countSuperlative ( call SW.getProperty ( call SW.singleton en.recipe ) ( string ! type ) ) ( string max ) ( string meal ) ( call SW.getProperty ( call SW.singleton en.meal ) ( string ! type ) ) ) )
show recipes for lunch or dinner	( call SW.listValue ( call SW.filter ( call SW.getProperty ( call SW.singleton en.recipe ) ( string ! type ) ) ( string meal ) ( string = ) ( call SW.concat en.meal.lunch en.meal.dinner ) ) )
show me meal recipes including rice pudding	( call SW.listValue ( call SW.filter ( call SW.getProperty ( call SW.singleton en.recipe ) ( string ! type ) ) ( string meal ) ( string = ) ( call SW.filter ( call SW.getProperty ( call SW.singleton en.meal ) ( string ! type ) ) ( call SW.reverse ( string meal ) ) ( string = ) en.recipe.rice_pudding ) ) )
which ingredient is needed by rice pudding or quiche	( call SW.listValue ( call SW.filter ( call SW.getProperty ( call SW.singleton en.ingredient ) ( string ! type ) ) ( call SW.reverse ( string requires ) ) ( string = ) ( call SW.concat en.recipe.rice_pudding en.recipe.quiche ) ) )
how many ingredients does that require	( call SW.listValue ( call .size ( call SW.getProperty ( call SW.singleton en.ingredient ) ( string ! type ) ) ) )
which lunch recipe requires milk for its preparation	( call SW.listValue ( call SW.filter ( call SW.filter ( call SW.getProperty ( call SW.singleton en.recipe ) ( string ! type ) ) ( string meal ) ( string = ) en.meal.lunch ) ( string requires ) ( string = ) en.ingredient.milk ) )
what recipe calls for the fewest ingredients	( call SW.listValue ( call SW.countSuperlative ( call SW.getProperty ( call SW.singleton en.recipe ) ( string ! type ) ) ( string min ) ( string requires ) ( call SW.getProperty ( call SW.singleton en.ingredient ) ( string ! type ) ) ) )
what ingredients do lunch recipes call for	( call SW.listValue ( call SW.filter ( call SW.getProperty ( call SW.singleton en.ingredient ) ( string ! type ) ) ( call SW.reverse ( string requires ) ) ( string = ) ( call SW.filter ( call SW.getProperty ( call SW.singleton en.recipe ) ( string ! type ) ) ( string meal ) ( string = ) en.meal.lunch ) ) )
what is the average cooking time for that dish	( call SW.listValue ( call SW.aggregate ( string avg ) ( call SW.getProperty ( call SW.getProperty ( call SW.singleton en.recipe ) ( string ! type ) ) ( string cooking_time ) ) ) )
show me recipes that use less than two ingredients	( call SW.listValue ( call SW.countComparative ( call SW.getProperty ( call SW.singleton en.recipe ) ( string ! type ) ) ( string requires ) ( string < ) ( number 2 ) ( call SW.getProperty ( call SW.singleton en.ingredient ) ( string ! type ) ) ) )
what recipe was posted in 2004	( call SW.listValue ( call SW.filter ( call SW.getProperty ( call SW.singleton en.recipe ) ( string ! type ) ) ( string posting_date ) ( string = ) ( date 2004 -1 -1 ) ) )
when was the rice pudding recipe posted	( call SW.listValue ( call SW.getProperty en.recipe.rice_pudding ( string posting_date ) ) )
show me recipes that follows one or two cuisines	( call SW.listValue ( call SW.countComparative ( call SW.getProperty ( call SW.singleton en.recipe ) ( string ! type ) ) ( string cuisine ) ( string <= ) ( number 2 ) ) )
show me recipes that work for more than one meal	( call SW.listValue ( call SW.countSuperlative ( call SW.getProperty ( call SW.singleton en.recipe ) ( string ! type ) ) ( string min ) ( string meal ) ( call SW.getProperty ( call SW.singleton en.meal ) ( string ! type ) ) ) )
show me ingredients required by recipes that require milk	( call SW.listValue ( call SW.filter ( call SW.getProperty ( call SW.singleton en.ingredient ) ( string ! type ) ) ( call SW.reverse ( string requires ) ) ( string = ) ( call SW.filter ( call SW.getProperty ( call SW.singleton en.recipe ) ( string ! type ) ) ( string requires ) ( string = ) en.ingredient.milk ) ) )
show me recipes posted in or before 2004	( call SW.listValue ( call SW.filter ( call SW.getProperty ( call SW.singleton en.recipe ) ( string ! type ) ) ( call SW.ensureNumericProperty ( string posting_date ) ) ( string <= ) ( call SW.ensureNumericEntity ( date 2004 -1 -1 ) ) ) )
find a recipe that was posted  by 2004	( call SW.listValue ( call SW.filter ( call SW.getProperty ( call SW.singleton en.recipe ) ( string ! type ) ) ( call SW.ensureNumericProperty ( string posting_date ) ) ( string >= ) ( call SW.ensureNumericEntity ( date 2004 -1 -1 ) ) ) )
what recipes cooking time is at least the preparation time of rice pudding	( call SW.listValue ( call SW.filter ( call SW.getProperty ( call SW.singleton en.recipe ) ( string ! type ) ) ( call SW.ensureNumericProperty ( string cooking_time ) ) ( string >= ) ( call SW.ensureNumericEntity ( call SW.getProperty en.recipe.rice_pudding ( string preparation_time ) ) ) ) )
which recipe has the least preparation time	( call SW.listValue ( call SW.superlative ( call SW.getProperty ( call SW.singleton en.recipe ) ( string ! type ) ) ( string min ) ( call SW.ensureNumericProperty ( string preparation_time ) ) ) )
what is a recipe that does not use milk as an ingredient	( call SW.listValue ( call SW.filter ( call SW.getProperty ( call SW.singleton en.recipe ) ( string ! type ) ) ( string requires ) ( string ! = ) en.ingredient.milk ) )
find some lunch recipes	( call SW.listValue ( call SW.filter ( call SW.getProperty ( call SW.singleton en.recipe ) ( string ! type ) ) ( string meal ) ( string = ) en.meal.lunch ) )
what recipes posting date is at the greatest in 2004	( call SW.listValue ( call SW.filter ( call SW.getProperty ( call SW.singleton en.recipe ) ( string ! type ) ) ( call SW.ensureNumericProperty ( string posting_date ) ) ( string <= ) ( call SW.ensureNumericEntity ( date 2004 -1 -1 ) ) ) )
what is the preparation time for that recipe	( call SW.listValue ( call SW.aggregate ( string sum ) ( call SW.getProperty ( call SW.getProperty ( call SW.singleton en.recipe ) ( string ! type ) ) ( string preparation_time ) ) ) )
what recipe cooks in less time than rice pudding	( call SW.listValue ( call SW.filter ( call SW.getProperty ( call SW.singleton en.recipe ) ( string ! type ) ) ( call SW.ensureNumericProperty ( string cooking_time ) ) ( string >= ) ( call SW.ensureNumericEntity ( call SW.getProperty en.recipe.rice_pudding ( string cooking_time ) ) ) ) )
show me a recipe with the same prep time as rice pudding	( call SW.listValue ( call SW.filter ( call SW.getProperty ( call SW.singleton en.recipe ) ( string ! type ) ) ( string preparation_time ) ( string = ) ( call SW.getProperty en.recipe.rice_pudding ( string preparation_time ) ) ) )
which recipe belongs to the cuisine of rice pudding	( call SW.listValue ( call SW.filter ( call SW.getProperty ( call SW.singleton en.recipe ) ( string ! type ) ) ( string cuisine ) ( string = ) ( call SW.getProperty en.recipe.rice_pudding ( string cuisine ) ) ) )
find a lunch recipe that is prepared with milk	( call SW.listValue ( call SW.filter ( call SW.filter ( call SW.getProperty ( call SW.singleton en.recipe ) ( string ! type ) ) ( string requires ) ( string = ) en.ingredient.milk ) ( string meal ) ( string = ) en.meal.lunch ) )
what recipes need milk and is posted in 2004	( call SW.listValue ( call SW.filter ( call SW.filter ( call SW.getProperty ( call SW.singleton en.recipe ) ( string ! type ) ) ( string requires ) ( string = ) en.ingredient.milk ) ( string posting_date ) ( string = ) ( date 2004 -1 -1 ) ) )
what is a recipe that is good for lunch or dinner	( call SW.listValue ( call SW.filter ( call SW.getProperty ( call SW.singleton en.recipe ) ( string ! type ) ) ( string meal ) ( string = ) ( call SW.concat en.meal.lunch en.meal.dinner ) ) )
show me recipes that need milk	( call SW.listValue ( call SW.filter ( call SW.filter ( call SW.getProperty ( call SW.singleton en.recipe ) ( string ! type ) ) ( string requires ) ( string = ) en.ingredient.milk ) ( string requires ) ( string = ) en.ingredient.milk ) )
recipes posted in 2004 and later	( call SW.listValue ( call SW.filter ( call SW.getProperty ( call SW.singleton en.recipe ) ( string ! type ) ) ( call SW.ensureNumericProperty ( string posting_date ) ) ( string >= ) ( call SW.ensureNumericEntity ( date 2004 -1 -1 ) ) ) )
what recipes posting date is in 2004 or 2010	( call SW.listValue ( call SW.filter ( call SW.getProperty ( call SW.singleton en.recipe ) ( string ! type ) ) ( string posting_date ) ( string = ) ( call SW.concat ( date 2004 -1 -1 ) ( date 2010 -1 -1 ) ) ) )
show me recipes that fall under the same cuisine as rice pudding	( call SW.listValue ( call SW.filter ( call SW.getProperty ( call SW.singleton en.recipe ) ( string ! type ) ) ( string cuisine ) ( string = ) ( call SW.getProperty en.recipe.rice_pudding ( string cuisine ) ) ) )
which recipe  s cooking time is equal to that of rice pudding	( call SW.listValue ( call SW.filter ( call SW.getProperty ( call SW.singleton en.recipe ) ( string ! type ) ) ( call SW.ensureNumericProperty ( string preparation_time ) ) ( string <= ) ( call SW.ensureNumericEntity ( call SW.getProperty en.recipe.rice_pudding ( string cooking_time ) ) ) ) )
show me recipes that have shorter cooking times than rice pudding	( call SW.listValue ( call SW.filter ( call SW.getProperty ( call SW.singleton en.recipe ) ( string ! type ) ) ( call SW.ensureNumericProperty ( string cooking_time ) ) ( string < ) ( call SW.ensureNumericEntity ( call SW.getProperty en.recipe.rice_pudding ( string cooking_time ) ) ) ) )
what recipe has the most ingredients	( call SW.listValue ( call SW.countSuperlative ( call SW.getProperty ( call SW.singleton en.recipe ) ( string ! type ) ) ( string max ) ( string requires ) ( call SW.getProperty ( call SW.singleton en.ingredient ) ( string ! type ) ) ) )
show me recipes with a preparation time equal to or greater than the cooking time of rice pudding	( call SW.listValue ( call SW.filter ( call SW.getProperty ( call SW.singleton en.recipe ) ( string ! type ) ) ( call SW.ensureNumericProperty ( string preparation_time ) ) ( string >= ) ( call SW.ensureNumericEntity ( call SW.getProperty en.recipe.rice_pudding ( string cooking_time ) ) ) ) )
what recipe can make the most meals	( call SW.listValue ( call SW.countSuperlative ( call SW.getProperty ( call SW.singleton en.recipe ) ( string ! type ) ) ( string max ) ( string meal ) ( call SW.getProperty ( call SW.singleton en.meal ) ( string ! type ) ) ) )
recipe of at most two cuisine	( call SW.listValue ( call SW.countComparative ( call SW.getProperty ( call SW.singleton en.recipe ) ( string ! type ) ) ( string cuisine ) ( string <= ) ( number 2 ) ) )
what is the average preparation time across all recipes	( call SW.listValue ( call SW.aggregate ( string avg ) ( call SW.getProperty ( call SW.getProperty ( call SW.singleton en.recipe ) ( string ! type ) ) ( string preparation_time ) ) ) )
which recipe takes the least amount of time to prepare	( call SW.listValue ( call SW.superlative ( call SW.getProperty ( call SW.singleton en.recipe ) ( string ! type ) ) ( string min ) ( call SW.ensureNumericProperty ( string preparation_time ) ) ) )
what recipes require milk	( call SW.listValue ( call SW.filter ( call SW.filter ( call SW.getProperty ( call SW.singleton en.recipe ) ( string ! type ) ) ( string requires ) ( string = ) en.ingredient.milk ) ( string requires ) ( string = ) en.ingredient.milk ) )
recipes that require same time to prepare than rice pudding	( call SW.listValue ( call SW.filter ( call SW.getProperty ( call SW.singleton en.recipe ) ( string ! type ) ) ( string preparation_time ) ( string = ) ( call SW.getProperty en.recipe.rice_pudding ( string preparation_time ) ) ) )
for what meals share two or more recipes	( call SW.listValue ( call SW.countComparative ( call SW.getProperty ( call SW.singleton en.meal ) ( string ! type ) ) ( call SW.reverse ( string meal ) ) ( string > ) ( number 2 ) ( call SW.getProperty ( call SW.singleton en.recipe ) ( string ! type ) ) ) )
what recipe was posted after 2004	( call SW.listValue ( call SW.filter ( call SW.getProperty ( call SW.singleton en.recipe ) ( string ! type ) ) ( call SW.ensureNumericProperty ( string posting_date ) ) ( string > ) ( call SW.ensureNumericEntity ( date 2004 -1 -1 ) ) ) )
when was rice pudding recipe posted	( call SW.listValue ( call SW.getProperty en.recipe.rice_pudding ( string posting_date ) ) )
show me recipes posted before rice pudding	( call SW.listValue ( call SW.filter ( call SW.getProperty ( call SW.singleton en.recipe ) ( string ! type ) ) ( call SW.ensureNumericProperty ( string posting_date ) ) ( string < ) ( call SW.ensureNumericEntity ( call SW.getProperty en.recipe.rice_pudding ( string posting_date ) ) ) ) )
find recipes posted in 2004 or 2010	( call SW.listValue ( call SW.filter ( call SW.getProperty ( call SW.singleton en.recipe ) ( string ! type ) ) ( string posting_date ) ( string = ) ( call SW.concat ( date 2004 -1 -1 ) ( date 2010 -1 -1 ) ) ) )
what is a recipe from fewer than two cuisines	( call SW.listValue ( call SW.countComparative ( call SW.getProperty ( call SW.singleton en.recipe ) ( string ! type ) ) ( string cuisine ) ( string < ) ( number 2 ) ) )
is the recipe for lunch or dinner	( call SW.listValue ( call SW.concat en.meal.lunch en.meal.dinner ) )
which recipe has the cooking time of rice pudding	( call SW.listValue ( call SW.filter ( call SW.getProperty ( call SW.singleton en.recipe ) ( string ! type ) ) ( call SW.ensureNumericProperty ( string cooking_time ) ) ( string <= ) ( call SW.ensureNumericEntity ( call SW.getProperty en.recipe.rice_pudding ( string cooking_time ) ) ) ) )
show me meals with the most recipes	( call SW.listValue ( call SW.countSuperlative ( call SW.getProperty ( call SW.singleton en.meal ) ( string ! type ) ) ( string max ) ( call SW.reverse ( string meal ) ) ( call SW.getProperty ( call SW.singleton en.recipe ) ( string ! type ) ) ) )
what is the cooking time for rice pudding	( call SW.listValue ( call SW.getProperty en.recipe.rice_pudding ( string cooking_time ) ) )
how much time it takes to cook rice pudding	( call SW.listValue ( call SW.getProperty en.recipe.rice_pudding ( string cooking_time ) ) )
what is the average time needed for the preparation of the dish	( call SW.listValue ( call SW.aggregate ( string avg ) ( call SW.getProperty ( call SW.getProperty ( call SW.singleton en.recipe ) ( string ! type ) ) ( string cooking_time ) ) ) )
what meal has over two recipes	( call SW.listValue ( call SW.countComparative ( call SW.getProperty ( call SW.singleton en.meal ) ( string ! type ) ) ( call SW.reverse ( string meal ) ) ( string > ) ( number 2 ) ( call SW.getProperty ( call SW.singleton en.recipe ) ( string ! type ) ) ) )
which recipes were posted before 2004 or 2010	( call SW.listValue ( call SW.filter ( call SW.getProperty ( call SW.singleton en.recipe ) ( string ! type ) ) ( call SW.ensureNumericProperty ( string posting_date ) ) ( string < ) ( call SW.ensureNumericEntity ( call SW.concat ( date 2004 -1 -1 ) ( date 2010 -1 -1 ) ) ) ) )
what recipes posting date is 2004	( call SW.listValue ( call SW.filter ( call SW.filter ( call SW.getProperty ( call SW.singleton en.recipe ) ( string ! type ) ) ( string posting_date ) ( string = ) ( date 2004 -1 -1 ) ) ( string posting_date ) ( string = ) ( date 2004 -1 -1 ) ) )
what recipe is for no more than two meals	( call SW.listValue ( call SW.countComparative ( call SW.getProperty ( call SW.singleton en.recipe ) ( string ! type ) ) ( string meal ) ( string <= ) ( number 2 ) ( call SW.getProperty ( call SW.singleton en.meal ) ( string ! type ) ) ) )
show me recipe to do a meal for a single person	( call SW.listValue ( call SW.countSuperlative ( call SW.getProperty ( call SW.singleton en.recipe ) ( string ! type ) ) ( string min ) ( string meal ) ( call SW.getProperty ( call SW.singleton en.meal ) ( string ! type ) ) ) )
which recipe was posted the latest	( call SW.listValue ( call SW.superlative ( call SW.getProperty ( call SW.singleton en.recipe ) ( string ! type ) ) ( string max ) ( call SW.ensureNumericProperty ( string posting_date ) ) ) )
show recipes that take at least the preparation time of rice pudding to be done	( call SW.listValue ( call SW.filter ( call SW.getProperty ( call SW.singleton en.recipe ) ( string ! type ) ) ( call SW.ensureNumericProperty ( string preparation_time ) ) ( string >= ) ( call SW.ensureNumericEntity ( call SW.getProperty en.recipe.rice_pudding ( string preparation_time ) ) ) ) )
what meal is rice pudding or quiche in	( call SW.listValue ( call SW.filter ( call SW.getProperty ( call SW.singleton en.meal ) ( string ! type ) ) ( call SW.reverse ( string meal ) ) ( string = ) ( call SW.concat en.recipe.rice_pudding en.recipe.quiche ) ) )
what recipe prepare in less or same time to cook rice pudding	( call SW.listValue ( call SW.filter ( call SW.getProperty ( call SW.singleton en.recipe ) ( string ! type ) ) ( call SW.ensureNumericProperty ( string preparation_time ) ) ( string >= ) ( call SW.ensureNumericEntity ( call SW.getProperty en.recipe.rice_pudding ( string cooking_time ) ) ) ) )
find a recipe that needs milk for its preparation	( call SW.listValue ( call SW.filter ( call SW.filter ( call SW.getProperty ( call SW.singleton en.recipe ) ( string ! type ) ) ( string requires ) ( string = ) en.ingredient.milk ) ( string requires ) ( string = ) en.ingredient.milk ) )
what recipes share the cuisine of rice pudding	( call SW.listValue ( call SW.filter ( call SW.getProperty ( call SW.singleton en.recipe ) ( string ! type ) ) ( string cuisine ) ( string = ) ( call SW.getProperty en.recipe.rice_pudding ( string cuisine ) ) ) )
cooking time of recipe	( call SW.listValue ( call SW.aggregate ( string sum ) ( call SW.getProperty ( call SW.getProperty ( call SW.singleton en.recipe ) ( string ! type ) ) ( string cooking_time ) ) ) )
which recipe needs less than two food items for its preparation	( call SW.listValue ( call SW.countComparative ( call SW.getProperty ( call SW.singleton en.recipe ) ( string ! type ) ) ( string requires ) ( string < ) ( number 2 ) ( call SW.getProperty ( call SW.singleton en.ingredient ) ( string ! type ) ) ) )
how long does the recipe take to cook	( call SW.listValue ( call SW.aggregate ( string sum ) ( call SW.getProperty ( call SW.getProperty ( call SW.singleton en.recipe ) ( string ! type ) ) ( string cooking_time ) ) ) )
find a recipe that is good for lunch or dinner	( call SW.listValue ( call SW.filter ( call SW.getProperty ( call SW.singleton en.recipe ) ( string ! type ) ) ( string meal ) ( string = ) ( call SW.concat en.meal.lunch en.meal.dinner ) ) )
how long does the recipe take to prepare	( call SW.listValue ( call SW.aggregate ( string sum ) ( call SW.getProperty ( call SW.getProperty ( call SW.singleton en.recipe ) ( string ! type ) ) ( string preparation_time ) ) ) )
which recipe was posted on the same date as that of rice pudding	( call SW.listValue ( call SW.filter ( call SW.getProperty ( call SW.singleton en.recipe ) ( string ! type ) ) ( string posting_date ) ( string = ) ( call SW.getProperty en.recipe.rice_pudding ( string posting_date ) ) ) )
what recipe takes equal or less time to cook than rice pudding takes to prep	( call SW.listValue ( call SW.filter ( call SW.getProperty ( call SW.singleton en.recipe ) ( string ! type ) ) ( call SW.ensureNumericProperty ( string cooking_time ) ) ( string <= ) ( call SW.ensureNumericEntity ( call SW.getProperty en.recipe.rice_pudding ( string preparation_time ) ) ) ) )
list the recipes for lunch or dinner	( call SW.listValue ( call SW.filter ( call SW.getProperty ( call SW.singleton en.recipe ) ( string ! type ) ) ( string meal ) ( string = ) ( call SW.concat en.meal.lunch en.meal.dinner ) ) )
show me recipes that have a preparation time less than the cooking time of rice pudding	( call SW.listValue ( call SW.filter ( call SW.getProperty ( call SW.singleton en.recipe ) ( string ! type ) ) ( call SW.ensureNumericProperty ( string preparation_time ) ) ( string < ) ( call SW.ensureNumericEntity ( call SW.getProperty en.recipe.rice_pudding ( string cooking_time ) ) ) ) )
show me recipe that require longer time to cook than rice pudding	( call SW.listValue ( call SW.filter ( call SW.getProperty ( call SW.singleton en.recipe ) ( string ! type ) ) ( call SW.ensureNumericProperty ( string cooking_time ) ) ( string > ) ( call SW.ensureNumericEntity ( call SW.getProperty en.recipe.rice_pudding ( string cooking_time ) ) ) ) )
show me recipes posted in 2004 that use milk	( call SW.listValue ( call SW.filter ( call SW.filter ( call SW.getProperty ( call SW.singleton en.recipe ) ( string ! type ) ) ( string posting_date ) ( string = ) ( date 2004 -1 -1 ) ) ( string requires ) ( string = ) en.ingredient.milk ) )
are there any recipes which were posted twice in 2004	( call SW.listValue ( call SW.filter ( call SW.filter ( call SW.getProperty ( call SW.singleton en.recipe ) ( string ! type ) ) ( string posting_date ) ( string = ) ( date 2004 -1 -1 ) ) ( string posting_date ) ( string = ) ( date 2004 -1 -1 ) ) )
what ingredient is in than two recipes	( call SW.listValue ( call SW.countComparative ( call SW.getProperty ( call SW.singleton en.ingredient ) ( string ! type ) ) ( call SW.reverse ( string requires ) ) ( string > ) ( number 2 ) ( call SW.getProperty ( call SW.singleton en.recipe ) ( string ! type ) ) ) )
tell me ingredients of rice pudding	( call SW.listValue ( call SW.filter ( call SW.filter ( call SW.getProperty ( call SW.singleton en.ingredient ) ( string ! type ) ) ( call SW.reverse ( string requires ) ) ( string = ) en.recipe.rice_pudding ) ( call SW.reverse ( string requires ) ) ( string = ) en.recipe.rice_pudding ) )
what recipe has the fewest number of cuisine	( call SW.listValue ( call SW.countSuperlative ( call SW.getProperty ( call SW.singleton en.recipe ) ( string ! type ) ) ( string min ) ( string cuisine ) ) )
show me a recipe for the least number of meals	( call SW.listValue ( call SW.countSuperlative ( call SW.getProperty ( call SW.singleton en.recipe ) ( string ! type ) ) ( string min ) ( string meal ) ( call SW.getProperty ( call SW.singleton en.meal ) ( string ! type ) ) ) )
what recipes cooking time is at the greatest the cooking time of rice pudding	( call SW.listValue ( call SW.filter ( call SW.getProperty ( call SW.singleton en.recipe ) ( string ! type ) ) ( call SW.ensureNumericProperty ( string cooking_time ) ) ( string <= ) ( call SW.ensureNumericEntity ( call SW.getProperty en.recipe.rice_pudding ( string cooking_time ) ) ) ) )
recipe of less than two meal	( call SW.listValue ( call SW.countComparative ( call SW.getProperty ( call SW.singleton en.recipe ) ( string ! type ) ) ( string meal ) ( string < ) ( number 2 ) ( call SW.getProperty ( call SW.singleton en.meal ) ( string ! type ) ) ) )
name the ingredient in most recipes	( call SW.listValue ( call SW.countSuperlative ( call SW.getProperty ( call SW.singleton en.ingredient ) ( string ! type ) ) ( string max ) ( call SW.reverse ( string requires ) ) ( call SW.getProperty ( call SW.singleton en.recipe ) ( string ! type ) ) ) )
what recipe takes longer to prep than rice pudding	( call SW.listValue ( call SW.filter ( call SW.getProperty ( call SW.singleton en.recipe ) ( string ! type ) ) ( call SW.ensureNumericProperty ( string preparation_time ) ) ( string > ) ( call SW.ensureNumericEntity ( call SW.getProperty en.recipe.rice_pudding ( string preparation_time ) ) ) ) )
show me recipes that requires the most time to prepare the dish	( call SW.listValue ( call SW.superlative ( call SW.getProperty ( call SW.singleton en.recipe ) ( string ! type ) ) ( string max ) ( call SW.ensureNumericProperty ( string preparation_time ) ) ) )
what ingredients does rice pudding not need	( call SW.listValue ( call SW.filter ( call SW.getProperty ( call SW.singleton en.ingredient ) ( string ! type ) ) ( call SW.reverse ( string requires ) ) ( string ! = ) en.recipe.rice_pudding ) )
what ingredients are in rice pudding	( call SW.listValue ( call SW.filter ( call SW.filter ( call SW.getProperty ( call SW.singleton en.ingredient ) ( string ! type ) ) ( call SW.reverse ( string requires ) ) ( string = ) en.recipe.rice_pudding ) ( call SW.reverse ( string requires ) ) ( string = ) en.recipe.rice_pudding ) )
how many total recipes are listed	( call SW.listValue ( call .size ( call SW.getProperty ( call SW.singleton en.recipe ) ( string ! type ) ) ) )
what recipe can you prep in the same or longer amount of time as rice pudding	( call SW.listValue ( call SW.filter ( call SW.getProperty ( call SW.singleton en.recipe ) ( string ! type ) ) ( call SW.ensureNumericProperty ( string preparation_time ) ) ( string >= ) ( call SW.ensureNumericEntity ( call SW.getProperty en.recipe.rice_pudding ( string preparation_time ) ) ) ) )
show me the recipe that has the largest preperation time	( call SW.listValue ( call SW.superlative ( call SW.getProperty ( call SW.singleton en.recipe ) ( string ! type ) ) ( string max ) ( call SW.ensureNumericProperty ( string preparation_time ) ) ) )
show me the most required ingredient in recipes	( call SW.listValue ( call SW.countSuperlative ( call SW.getProperty ( call SW.singleton en.ingredient ) ( string ! type ) ) ( string max ) ( call SW.reverse ( string requires ) ) ( call SW.getProperty ( call SW.singleton en.recipe ) ( string ! type ) ) ) )
what recipe was posted after or on the same day as rice pudding	( call SW.listValue ( call SW.filter ( call SW.getProperty ( call SW.singleton en.recipe ) ( string ! type ) ) ( call SW.ensureNumericProperty ( string posting_date ) ) ( string >= ) ( call SW.ensureNumericEntity ( call SW.getProperty en.recipe.rice_pudding ( string posting_date ) ) ) ) )
show me recipes posted the same day as rice pudding or before	( call SW.listValue ( call SW.filter ( call SW.getProperty ( call SW.singleton en.recipe ) ( string ! type ) ) ( call SW.ensureNumericProperty ( string posting_date ) ) ( string <= ) ( call SW.ensureNumericEntity ( call SW.getProperty en.recipe.rice_pudding ( string posting_date ) ) ) ) )
how long is the average preparation time for the recipe	( call SW.listValue ( call SW.aggregate ( string avg ) ( call SW.getProperty ( call SW.getProperty ( call SW.singleton en.recipe ) ( string ! type ) ) ( string preparation_time ) ) ) )
what recipe is most recent	( call SW.listValue ( call SW.superlative ( call SW.getProperty ( call SW.singleton en.recipe ) ( string ! type ) ) ( string max ) ( call SW.ensureNumericProperty ( string posting_date ) ) ) )
which food item is not needed in rice pudding	( call SW.listValue ( call SW.filter ( call SW.getProperty ( call SW.singleton en.ingredient ) ( string ! type ) ) ( call SW.reverse ( string requires ) ) ( string ! = ) en.recipe.rice_pudding ) )
what meal has two or more recipes	( call SW.listValue ( call SW.countComparative ( call SW.getProperty ( call SW.singleton en.meal ) ( string ! type ) ) ( call SW.reverse ( string meal ) ) ( string >= ) ( number 2 ) ( call SW.getProperty ( call SW.singleton en.recipe ) ( string ! type ) ) ) )
what is an ingredient not found in rice pudding	( call SW.listValue ( call SW.filter ( call SW.getProperty ( call SW.singleton en.ingredient ) ( string ! type ) ) ( call SW.reverse ( string requires ) ) ( string ! = ) en.recipe.rice_pudding ) )
what recipes were posted after rice pudding	( call SW.listValue ( call SW.filter ( call SW.getProperty ( call SW.singleton en.recipe ) ( string ! type ) ) ( call SW.ensureNumericProperty ( string posting_date ) ) ( string > ) ( call SW.ensureNumericEntity ( call SW.getProperty en.recipe.rice_pudding ( string posting_date ) ) ) ) )
recipe whose cooking time is not more than rice pudding	( call SW.listValue ( call SW.filter ( call SW.getProperty ( call SW.singleton en.recipe ) ( string ! type ) ) ( call SW.ensureNumericProperty ( string cooking_time ) ) ( string <= ) ( call SW.ensureNumericEntity ( call SW.getProperty en.recipe.rice_pudding ( string cooking_time ) ) ) ) )
what ingredient is required in two or more recipes	( call SW.listValue ( call SW.countComparative ( call SW.getProperty ( call SW.singleton en.ingredient ) ( string ! type ) ) ( call SW.reverse ( string requires ) ) ( string >= ) ( number 2 ) ( call SW.getProperty ( call SW.singleton en.recipe ) ( string ! type ) ) ) )
which recipe was posted in 2004 or 2010	( call SW.listValue ( call SW.filter ( call SW.getProperty ( call SW.singleton en.recipe ) ( string ! type ) ) ( call SW.ensureNumericProperty ( string posting_date ) ) ( string <= ) ( call SW.ensureNumericEntity ( call SW.concat ( date 2004 -1 -1 ) ( date 2010 -1 -1 ) ) ) ) )
show me recipes that have the fewest ingredients	( call SW.listValue ( call SW.countSuperlative ( call SW.getProperty ( call SW.singleton en.recipe ) ( string ! type ) ) ( string min ) ( string requires ) ( call SW.getProperty ( call SW.singleton en.ingredient ) ( string ! type ) ) ) )
what recipes are cooked in same time as rice pudding	( call SW.listValue ( call SW.filter ( call SW.getProperty ( call SW.singleton en.recipe ) ( string ! type ) ) ( string cooking_time ) ( string = ) ( call SW.getProperty en.recipe.rice_pudding ( string cooking_time ) ) ) )
what recipe has a cook time less than the cook time of rice pudding	( call SW.listValue ( call SW.filter ( call SW.getProperty ( call SW.singleton en.recipe ) ( string ! type ) ) ( call SW.ensureNumericProperty ( string cooking_time ) ) ( string < ) ( call SW.ensureNumericEntity ( call SW.getProperty en.recipe.rice_pudding ( string cooking_time ) ) ) ) )
what meal is rice pudding or quiche made for	( call SW.listValue ( call SW.filter ( call SW.getProperty ( call SW.singleton en.meal ) ( string ! type ) ) ( call SW.reverse ( string meal ) ) ( string = ) ( call SW.concat en.recipe.rice_pudding en.recipe.quiche ) ) )
what recipes posting date is not in 2004	( call SW.listValue ( call SW.filter ( call SW.getProperty ( call SW.singleton en.recipe ) ( string ! type ) ) ( string posting_date ) ( string ! = ) ( date 2004 -1 -1 ) ) )
what recipes preparation time is the same as rice pudding	( call SW.listValue ( call SW.filter ( call SW.getProperty ( call SW.singleton en.recipe ) ( string ! type ) ) ( string preparation_time ) ( string = ) ( call SW.getProperty en.recipe.rice_pudding ( string preparation_time ) ) ) )
ingredients not required to prepare rice pudding	( call SW.listValue ( call SW.filter ( call SW.getProperty ( call SW.singleton en.ingredient ) ( string ! type ) ) ( call SW.reverse ( string requires ) ) ( string ! = ) en.recipe.rice_pudding ) )
for which meal is rice pudding had	( call SW.listValue ( call SW.filter ( call SW.getProperty ( call SW.singleton en.meal ) ( string ! type ) ) ( call SW.reverse ( string meal ) ) ( string = ) en.recipe.rice_pudding ) )
how long does rice pudding take to prep	( call SW.listValue ( call SW.getProperty en.recipe.rice_pudding ( string preparation_time ) ) )
show me recipes that has milk as one of its ingredients	( call SW.listValue ( call SW.filter ( call SW.getProperty ( call SW.singleton en.recipe ) ( string ! type ) ) ( string requires ) ( string = ) en.ingredient.milk ) )
what recipes posting date is no greater than that of rice pudding	( call SW.listValue ( call SW.filter ( call SW.getProperty ( call SW.singleton en.recipe ) ( string ! type ) ) ( call SW.ensureNumericProperty ( string posting_date ) ) ( string <= ) ( call SW.ensureNumericEntity ( call SW.getProperty en.recipe.rice_pudding ( string posting_date ) ) ) ) )
what recipe has milk as an ingredient	( call SW.listValue ( call SW.filter ( call SW.filter ( call SW.getProperty ( call SW.singleton en.recipe ) ( string ! type ) ) ( string requires ) ( string = ) en.ingredient.milk ) ( string requires ) ( string = ) en.ingredient.milk ) )
show me recipes with cooking time equal to rice pudding	( call SW.listValue ( call SW.filter ( call SW.getProperty ( call SW.singleton en.recipe ) ( string ! type ) ) ( string cooking_time ) ( string = ) ( call SW.getProperty en.recipe.rice_pudding ( string cooking_time ) ) ) )
what recipes preparation time is at least that of rice pudding	( call SW.listValue ( call SW.filter ( call SW.getProperty ( call SW.singleton en.recipe ) ( string ! type ) ) ( call SW.ensureNumericProperty ( string preparation_time ) ) ( string >= ) ( call SW.ensureNumericEntity ( call SW.getProperty en.recipe.rice_pudding ( string preparation_time ) ) ) ) )
what meal most recipes made for	( call SW.listValue ( call SW.countSuperlative ( call SW.getProperty ( call SW.singleton en.meal ) ( string ! type ) ) ( string max ) ( call SW.reverse ( string meal ) ) ( call SW.getProperty ( call SW.singleton en.recipe ) ( string ! type ) ) ) )
what recipe can be prepped in equal or less time than rice pudding	( call SW.listValue ( call SW.filter ( call SW.getProperty ( call SW.singleton en.recipe ) ( string ! type ) ) ( call SW.ensureNumericProperty ( string preparation_time ) ) ( string <= ) ( call SW.ensureNumericEntity ( call SW.getProperty en.recipe.rice_pudding ( string preparation_time ) ) ) ) )
what is a recipe from no more than two different cuisines	( call SW.listValue ( call SW.countComparative ( call SW.getProperty ( call SW.singleton en.recipe ) ( string ! type ) ) ( string cuisine ) ( string <= ) ( number 2 ) ) )
show me the total number of recipes	( call SW.listValue ( call .size ( call SW.getProperty ( call SW.singleton en.recipe ) ( string ! type ) ) ) )
a recipe requiring the fewest ingredients	( call SW.listValue ( call SW.countSuperlative ( call SW.getProperty ( call SW.singleton en.recipe ) ( string ! type ) ) ( string min ) ( string requires ) ( call SW.getProperty ( call SW.singleton en.ingredient ) ( string ! type ) ) ) )
what is the posting date of rice pudding	( call SW.listValue ( call SW.getProperty en.recipe.rice_pudding ( string posting_date ) ) )
which recipe requires the least cooking time	( call SW.listValue ( call SW.superlative ( call SW.getProperty ( call SW.singleton en.recipe ) ( string ! type ) ) ( string min ) ( call SW.ensureNumericProperty ( string cooking_time ) ) ) )
what recipes cooking time is the preparation time of rice pudding	( call SW.listValue ( call SW.filter ( call SW.getProperty ( call SW.singleton en.recipe ) ( string ! type ) ) ( string cooking_time ) ( string = ) ( call SW.getProperty en.recipe.rice_pudding ( string preparation_time ) ) ) )
what is a recipe that was not posted in 2004	( call SW.listValue ( call SW.filter ( call SW.getProperty ( call SW.singleton en.recipe ) ( string ! type ) ) ( string posting_date ) ( string ! = ) ( date 2004 -1 -1 ) ) )
name lunch recipes	( call SW.listValue ( call SW.filter ( call SW.filter ( call SW.getProperty ( call SW.singleton en.recipe ) ( string ! type ) ) ( string meal ) ( string = ) en.meal.lunch ) ( string meal ) ( string = ) en.meal.lunch ) )
find meal recipes for lunch	( call SW.listValue ( call SW.filter ( call SW.getProperty ( call SW.singleton en.meal ) ( string ! type ) ) ( call SW.reverse ( string meal ) ) ( string = ) ( call SW.filter ( call SW.getProperty ( call SW.singleton en.recipe ) ( string ! type ) ) ( string meal ) ( string = ) en.meal.lunch ) ) )
a recipe for the fewest types of meals	( call SW.listValue ( call SW.countSuperlative ( call SW.getProperty ( call SW.singleton en.recipe ) ( string ! type ) ) ( string min ) ( string meal ) ( call SW.getProperty ( call SW.singleton en.meal ) ( string ! type ) ) ) )
what recipe takes the longest to prepare	( call SW.listValue ( call SW.superlative ( call SW.getProperty ( call SW.singleton en.recipe ) ( string ! type ) ) ( string max ) ( call SW.ensureNumericProperty ( string preparation_time ) ) ) )
which recipes were posted before rice pudding	( call SW.listValue ( call SW.filter ( call SW.getProperty ( call SW.singleton en.recipe ) ( string ! type ) ) ( call SW.ensureNumericProperty ( string posting_date ) ) ( string < ) ( call SW.ensureNumericEntity ( call SW.getProperty en.recipe.rice_pudding ( string posting_date ) ) ) ) )
show me all the recipes posted in 2004	( call SW.listValue ( call SW.filter ( call SW.filter ( call SW.getProperty ( call SW.singleton en.recipe ) ( string ! type ) ) ( string posting_date ) ( string = ) ( date 2004 -1 -1 ) ) ( string posting_date ) ( string = ) ( date 2004 -1 -1 ) ) )
what food items are needed to make rice pudding	( call SW.listValue ( call SW.filter ( call SW.getProperty ( call SW.singleton en.ingredient ) ( string ! type ) ) ( call SW.reverse ( string requires ) ) ( string = ) en.recipe.rice_pudding ) )
recipes posted with or after posting rice pudding	( call SW.listValue ( call SW.filter ( call SW.getProperty ( call SW.singleton en.recipe ) ( string ! type ) ) ( call SW.ensureNumericProperty ( string posting_date ) ) ( string >= ) ( call SW.ensureNumericEntity ( call SW.getProperty en.recipe.rice_pudding ( string posting_date ) ) ) ) )
what recipe was posted before 2010	( call SW.listValue ( call SW.filter ( call SW.getProperty ( call SW.singleton en.recipe ) ( string ! type ) ) ( call SW.ensureNumericProperty ( string posting_date ) ) ( string < ) ( call SW.ensureNumericEntity ( call SW.concat ( date 2004 -1 -1 ) ( date 2010 -1 -1 ) ) ) ) )
show me recipes with cooking times equal to cooking time of rice pudding	( call SW.listValue ( call SW.filter ( call SW.getProperty ( call SW.singleton en.recipe ) ( string ! type ) ) ( string cooking_time ) ( string = ) ( call SW.getProperty en.recipe.rice_pudding ( string cooking_time ) ) ) )
what recipe was not posted in 2004	( call SW.listValue ( call SW.filter ( call SW.getProperty ( call SW.singleton en.recipe ) ( string ! type ) ) ( string posting_date ) ( string ! = ) ( date 2004 -1 -1 ) ) )
what is cuisine for rice pudding	( call SW.listValue ( call SW.getProperty en.recipe.rice_pudding ( string cuisine ) ) )
which recipes take as long as prepare rice pudding	( call SW.listValue ( call SW.filter ( call SW.getProperty ( call SW.singleton en.recipe ) ( string ! type ) ) ( call SW.ensureNumericProperty ( string cooking_time ) ) ( string <= ) ( call SW.ensureNumericEntity ( call SW.getProperty en.recipe.rice_pudding ( string preparation_time ) ) ) ) )
what meal has more than two recipes	( call SW.listValue ( call SW.countComparative ( call SW.getProperty ( call SW.singleton en.meal ) ( string ! type ) ) ( call SW.reverse ( string meal ) ) ( string > ) ( number 2 ) ( call SW.getProperty ( call SW.singleton en.recipe ) ( string ! type ) ) ) )
which recipes are intended for lunch or dinner	( call SW.listValue ( call SW.filter ( call SW.getProperty ( call SW.singleton en.recipe ) ( string ! type ) ) ( string meal ) ( string = ) ( call SW.concat en.meal.lunch en.meal.dinner ) ) )
what is a recipe posted later than 2004	( call SW.listValue ( call SW.filter ( call SW.getProperty ( call SW.singleton en.recipe ) ( string ! type ) ) ( call SW.ensureNumericProperty ( string posting_date ) ) ( string > ) ( call SW.ensureNumericEntity ( date 2004 -1 -1 ) ) ) )
what recipe cooks for equal or less time than rice pudding	( call SW.listValue ( call SW.filter ( call SW.getProperty ( call SW.singleton en.recipe ) ( string ! type ) ) ( call SW.ensureNumericProperty ( string cooking_time ) ) ( string <= ) ( call SW.ensureNumericEntity ( call SW.getProperty en.recipe.rice_pudding ( string cooking_time ) ) ) ) )
show me recipes that take the same amount of time to prepare as rice pudding does to cook	( call SW.listValue ( call SW.filter ( call SW.getProperty ( call SW.singleton en.recipe ) ( string ! type ) ) ( string preparation_time ) ( string = ) ( call SW.getProperty en.recipe.rice_pudding ( string cooking_time ) ) ) )
which recipe needs more time than rice pudding preparation	( call SW.listValue ( call SW.filter ( call SW.getProperty ( call SW.singleton en.recipe ) ( string ! type ) ) ( call SW.ensureNumericProperty ( string preparation_time ) ) ( string > ) ( call SW.ensureNumericEntity ( call SW.getProperty en.recipe.rice_pudding ( string preparation_time ) ) ) ) )
what recipe serves at the most three	( call SW.listValue ( call SW.countSuperlative ( call SW.getProperty ( call SW.singleton en.recipe ) ( string ! type ) ) ( string max ) ( string meal ) ( call SW.getProperty ( call SW.singleton en.meal ) ( string ! type ) ) ) )
how many meals do we have everyday	( call SW.listValue ( call .size ( call SW.getProperty ( call SW.singleton en.meal ) ( string ! type ) ) ) )
find recipes that were posted before the recipe for rice pudding	( call SW.listValue ( call SW.filter ( call SW.getProperty ( call SW.singleton en.recipe ) ( string ! type ) ) ( call SW.ensureNumericProperty ( string posting_date ) ) ( string < ) ( call SW.ensureNumericEntity ( call SW.getProperty en.recipe.rice_pudding ( string posting_date ) ) ) ) )
what recipe was posted no later than the rice pudding recipe	( call SW.listValue ( call SW.filter ( call SW.getProperty ( call SW.singleton en.recipe ) ( string ! type ) ) ( call SW.ensureNumericProperty ( string posting_date ) ) ( string <= ) ( call SW.ensureNumericEntity ( call SW.getProperty en.recipe.rice_pudding ( string posting_date ) ) ) ) )
what is a cuisine of rice pudding	( call SW.listValue ( call SW.getProperty en.recipe.rice_pudding ( string cuisine ) ) )
for which meal is the dish rice pudding used	( call SW.listValue ( call SW.filter ( call SW.filter ( call SW.getProperty ( call SW.singleton en.meal ) ( string ! type ) ) ( call SW.reverse ( string meal ) ) ( string = ) en.recipe.rice_pudding ) ( call SW.reverse ( string meal ) ) ( string = ) en.recipe.rice_pudding ) )
for what meal is rice pudding used for	( call SW.listValue ( call SW.filter ( call SW.getProperty ( call SW.singleton en.meal ) ( string ! type ) ) ( call SW.reverse ( string meal ) ) ( string = ) en.recipe.rice_pudding ) )
which recipe takes the maximum preparation time	( call SW.listValue ( call SW.superlative ( call SW.getProperty ( call SW.singleton en.recipe ) ( string ! type ) ) ( string max ) ( call SW.ensureNumericProperty ( string cooking_time ) ) ) )
what recipe has the shortest cooking time	( call SW.listValue ( call SW.superlative ( call SW.getProperty ( call SW.singleton en.recipe ) ( string ! type ) ) ( string min ) ( call SW.ensureNumericProperty ( string cooking_time ) ) ) )
what recipe has the latest date posted	( call SW.listValue ( call SW.superlative ( call SW.getProperty ( call SW.singleton en.recipe ) ( string ! type ) ) ( string max ) ( call SW.ensureNumericProperty ( string posting_date ) ) ) )
recipes posted till 2004	( call SW.listValue ( call SW.filter ( call SW.getProperty ( call SW.singleton en.recipe ) ( string ! type ) ) ( call SW.ensureNumericProperty ( string posting_date ) ) ( string <= ) ( call SW.ensureNumericEntity ( date 2004 -1 -1 ) ) ) )
what kind of cuisine is rice pudding	( call SW.listValue ( call SW.getProperty en.recipe.rice_pudding ( string cuisine ) ) )
which recipe has its posting date as 2004	( call SW.listValue ( call SW.filter ( call SW.getProperty ( call SW.singleton en.recipe ) ( string ! type ) ) ( string posting_date ) ( string = ) ( date 2004 -1 -1 ) ) )
which meal has the least recipes dedicated to it	( call SW.listValue ( call SW.countSuperlative ( call SW.getProperty ( call SW.singleton en.meal ) ( string ! type ) ) ( string min ) ( call SW.reverse ( string meal ) ) ( call SW.getProperty ( call SW.singleton en.recipe ) ( string ! type ) ) ) )
show me recipes that posted no later than the rice pudding recipe	( call SW.listValue ( call SW.filter ( call SW.getProperty ( call SW.singleton en.recipe ) ( string ! type ) ) ( call SW.ensureNumericProperty ( string posting_date ) ) ( string <= ) ( call SW.ensureNumericEntity ( call SW.getProperty en.recipe.rice_pudding ( string posting_date ) ) ) ) )
what are the recipes posted in2004 or 2010	( call SW.listValue ( call SW.filter ( call SW.getProperty ( call SW.singleton en.recipe ) ( string ! type ) ) ( call SW.ensureNumericProperty ( string posting_date ) ) ( string >= ) ( call SW.ensureNumericEntity ( call SW.concat ( date 2004 -1 -1 ) ( date 2010 -1 -1 ) ) ) ) )
show me recipes with a cooking time greater or equal to the preparation time for rice pudding	( call SW.listValue ( call SW.filter ( call SW.getProperty ( call SW.singleton en.recipe ) ( string ! type ) ) ( call SW.ensureNumericProperty ( string cooking_time ) ) ( string >= ) ( call SW.ensureNumericEntity ( call SW.getProperty en.recipe.rice_pudding ( string preparation_time ) ) ) ) )
what recipe requires the least ingredients	( call SW.listValue ( call SW.countSuperlative ( call SW.getProperty ( call SW.singleton en.ingredient ) ( string ! type ) ) ( string min ) ( call SW.reverse ( string requires ) ) ( call SW.getProperty ( call SW.singleton en.recipe ) ( string ! type ) ) ) )
what meal is a recipe that requires milk for	( call SW.listValue ( call SW.filter ( call SW.getProperty ( call SW.singleton en.meal ) ( string ! type ) ) ( call SW.reverse ( string meal ) ) ( string = ) ( call SW.filter ( call SW.getProperty ( call SW.singleton en.recipe ) ( string ! type ) ) ( string requires ) ( string = ) en.ingredient.milk ) ) )
recipe with cooking time not more than that of rice pudding	( call SW.listValue ( call SW.filter ( call SW.getProperty ( call SW.singleton en.recipe ) ( string ! type ) ) ( call SW.ensureNumericProperty ( string cooking_time ) ) ( string <= ) ( call SW.ensureNumericEntity ( call SW.getProperty en.recipe.rice_pudding ( string preparation_time ) ) ) ) )
show me recipes posted on the same day as rice pudding	( call SW.listValue ( call SW.filter ( call SW.getProperty ( call SW.singleton en.recipe ) ( string ! type ) ) ( string posting_date ) ( string = ) ( call SW.getProperty en.recipe.rice_pudding ( string posting_date ) ) ) )
what recipes preparation time is no more than the cooking time of rice pudding	( call SW.listValue ( call SW.filter ( call SW.getProperty ( call SW.singleton en.recipe ) ( string ! type ) ) ( call SW.ensureNumericProperty ( string preparation_time ) ) ( string <= ) ( call SW.ensureNumericEntity ( call SW.getProperty en.recipe.rice_pudding ( string cooking_time ) ) ) ) )
show recipes that requires lesser preparation than rice pudding	( call SW.listValue ( call SW.filter ( call SW.getProperty ( call SW.singleton en.recipe ) ( string ! type ) ) ( call SW.ensureNumericProperty ( string preparation_time ) ) ( string < ) ( call SW.ensureNumericEntity ( call SW.getProperty en.recipe.rice_pudding ( string preparation_time ) ) ) ) )
show me the recipe that has the shortest cooking time	( call SW.listValue ( call SW.superlative ( call SW.getProperty ( call SW.singleton en.recipe ) ( string ! type ) ) ( string min ) ( call SW.ensureNumericProperty ( string cooking_time ) ) ) )
name the recipe used for lunch prepared with milk	( call SW.listValue ( call SW.filter ( call SW.filter ( call SW.getProperty ( call SW.singleton en.recipe ) ( string ! type ) ) ( string meal ) ( string = ) en.meal.lunch ) ( string requires ) ( string = ) en.ingredient.milk ) )
what recipe makes the fewest meals	( call SW.listValue ( call SW.countSuperlative ( call SW.getProperty ( call SW.singleton en.recipe ) ( string ! type ) ) ( string min ) ( string meal ) ( call SW.getProperty ( call SW.singleton en.meal ) ( string ! type ) ) ) )
a recipe for rice pudding	( call SW.listValue ( call SW.getProperty en.recipe.rice_pudding ( string cuisine ) ) )
show me recipes for rice pudding or quiche	( call SW.listValue ( call SW.concat en.recipe.rice_pudding en.recipe.quiche ) )
show recipes that require at the most time as rice pudding preparation	( call SW.listValue ( call SW.filter ( call SW.getProperty ( call SW.singleton en.recipe ) ( string ! type ) ) ( call SW.ensureNumericProperty ( string cooking_time ) ) ( string <= ) ( call SW.ensureNumericEntity ( call SW.getProperty en.recipe.rice_pudding ( string preparation_time ) ) ) ) )
name the ingredient required by at least two recipes	( call SW.listValue ( call SW.countComparative ( call SW.getProperty ( call SW.singleton en.ingredient ) ( string ! type ) ) ( call SW.reverse ( string requires ) ) ( string >= ) ( number 2 ) ( call SW.getProperty ( call SW.singleton en.recipe ) ( string ! type ) ) ) )
which meal had two recipes or more	( call SW.listValue ( call SW.countComparative ( call SW.getProperty ( call SW.singleton en.meal ) ( string ! type ) ) ( call SW.reverse ( string meal ) ) ( string > ) ( number 2 ) ( call SW.getProperty ( call SW.singleton en.recipe ) ( string ! type ) ) ) )
recipes for lunch or dinner menus	( call SW.listValue ( call SW.concat en.meal.lunch en.meal.dinner ) )
what recipe was posted before rice pudding	( call SW.listValue ( call SW.filter ( call SW.getProperty ( call SW.singleton en.recipe ) ( string ! type ) ) ( call SW.ensureNumericProperty ( string posting_date ) ) ( string < ) ( call SW.ensureNumericEntity ( call SW.getProperty en.recipe.rice_pudding ( string posting_date ) ) ) ) )
find me all recipes that require milk	( call SW.listValue ( call SW.filter ( call SW.getProperty ( call SW.singleton en.recipe ) ( string ! type ) ) ( string requires ) ( string = ) en.ingredient.milk ) )
what is a lunch recipe	( call SW.listValue ( call SW.filter ( call SW.filter ( call SW.getProperty ( call SW.singleton en.recipe ) ( string ! type ) ) ( string meal ) ( string = ) en.meal.lunch ) ( string meal ) ( string = ) en.meal.lunch ) )
a recipe requiring fewer than two ingredients	( call SW.listValue ( call SW.countComparative ( call SW.getProperty ( call SW.singleton en.recipe ) ( string ! type ) ) ( string requires ) ( string < ) ( number 2 ) ( call SW.getProperty ( call SW.singleton en.ingredient ) ( string ! type ) ) ) )
show me recipes that have the same or longer preparation time as rice pudding	( call SW.listValue ( call SW.filter ( call SW.getProperty ( call SW.singleton en.recipe ) ( string ! type ) ) ( call SW.ensureNumericProperty ( string preparation_time ) ) ( string >= ) ( call SW.ensureNumericEntity ( call SW.getProperty en.recipe.rice_pudding ( string cooking_time ) ) ) ) )
what recipes posted in 2004 require milk	( call SW.listValue ( call SW.filter ( call SW.filter ( call SW.getProperty ( call SW.singleton en.recipe ) ( string ! type ) ) ( string requires ) ( string = ) en.ingredient.milk ) ( string posting_date ) ( string = ) ( date 2004 -1 -1 ) ) )
what recipe calls for fewer than two ingredients	( call SW.listValue ( call SW.countComparative ( call SW.getProperty ( call SW.singleton en.recipe ) ( string ! type ) ) ( string requires ) ( string < ) ( number 2 ) ( call SW.getProperty ( call SW.singleton en.ingredient ) ( string ! type ) ) ) )
which recipes require milk	( call SW.listValue ( call SW.filter ( call SW.getProperty ( call SW.singleton en.ingredient ) ( string ! type ) ) ( call SW.reverse ( string requires ) ) ( string = ) ( call SW.filter ( call SW.getProperty ( call SW.singleton en.recipe ) ( string ! type ) ) ( string requires ) ( string = ) en.ingredient.milk ) ) )
which recipe needs the longest preparation tome	( call SW.listValue ( call SW.superlative ( call SW.getProperty ( call SW.singleton en.recipe ) ( string ! type ) ) ( string max ) ( call SW.ensureNumericProperty ( string preparation_time ) ) ) )
name a recipe with a prep time no longer than the cook time for rice pudding	( call SW.listValue ( call SW.filter ( call SW.getProperty ( call SW.singleton en.recipe ) ( string ! type ) ) ( call SW.ensureNumericProperty ( string preparation_time ) ) ( string <= ) ( call SW.ensureNumericEntity ( call SW.getProperty en.recipe.rice_pudding ( string cooking_time ) ) ) ) )
what recipe doesnt require milk	( call SW.listValue ( call SW.filter ( call SW.getProperty ( call SW.singleton en.recipe ) ( string ! type ) ) ( string requires ) ( string ! = ) en.ingredient.milk ) )
show me recipes that are not lunch recipes	( call SW.listValue ( call SW.filter ( call SW.getProperty ( call SW.singleton en.recipe ) ( string ! type ) ) ( string meal ) ( string ! = ) en.meal.lunch ) )
what recipe does not need milk	( call SW.listValue ( call SW.filter ( call SW.getProperty ( call SW.singleton en.recipe ) ( string ! type ) ) ( string requires ) ( string ! = ) en.ingredient.milk ) )
what recipe can make fewer than two types of cuisine	( call SW.listValue ( call SW.countComparative ( call SW.getProperty ( call SW.singleton en.recipe ) ( string ! type ) ) ( string cuisine ) ( string < ) ( number 2 ) ) )
what ingredient is there in less recipes	( call SW.listValue ( call SW.countSuperlative ( call SW.getProperty ( call SW.singleton en.ingredient ) ( string ! type ) ) ( string min ) ( call SW.reverse ( string requires ) ) ( call SW.getProperty ( call SW.singleton en.recipe ) ( string ! type ) ) ) )
what recipes preparation time is no more than the preparation time of rice pudding	( call SW.listValue ( call SW.filter ( call SW.getProperty ( call SW.singleton en.recipe ) ( string ! type ) ) ( call SW.ensureNumericProperty ( string preparation_time ) ) ( string <= ) ( call SW.ensureNumericEntity ( call SW.getProperty en.recipe.rice_pudding ( string preparation_time ) ) ) ) )
what recipe is the oldest	( call SW.listValue ( call SW.superlative ( call SW.getProperty ( call SW.singleton en.recipe ) ( string ! type ) ) ( string min ) ( call SW.ensureNumericProperty ( string posting_date ) ) ) )
show me recipes that require longer time to cook than rice pudding	( call SW.listValue ( call SW.filter ( call SW.getProperty ( call SW.singleton en.recipe ) ( string ! type ) ) ( call SW.ensureNumericProperty ( string preparation_time ) ) ( string > ) ( call SW.ensureNumericEntity ( call SW.getProperty en.recipe.rice_pudding ( string cooking_time ) ) ) ) )
how many ingredients	( call SW.listValue ( call .size ( call SW.getProperty ( call SW.singleton en.ingredient ) ( string ! type ) ) ) )
show me ingredients required by lunch recipes	( call SW.listValue ( call SW.filter ( call SW.getProperty ( call SW.singleton en.ingredient ) ( string ! type ) ) ( call SW.reverse ( string requires ) ) ( string = ) ( call SW.filter ( call SW.getProperty ( call SW.singleton en.recipe ) ( string ! type ) ) ( string meal ) ( string = ) en.meal.lunch ) ) )
show me ingredients required by more than two recipes	( call SW.listValue ( call SW.countComparative ( call SW.getProperty ( call SW.singleton en.ingredient ) ( string ! type ) ) ( call SW.reverse ( string requires ) ) ( string > ) ( number 2 ) ( call SW.getProperty ( call SW.singleton en.recipe ) ( string ! type ) ) ) )
what other ingredients do recipes that use milk require	( call SW.listValue ( call SW.filter ( call SW.getProperty ( call SW.singleton en.ingredient ) ( string ! type ) ) ( call SW.reverse ( string requires ) ) ( string = ) ( call SW.filter ( call SW.getProperty ( call SW.singleton en.recipe ) ( string ! type ) ) ( string requires ) ( string = ) en.ingredient.milk ) ) )
what is a meal other than rice pudding	( call SW.listValue ( call SW.filter ( call SW.getProperty ( call SW.singleton en.meal ) ( string ! type ) ) ( call SW.reverse ( string meal ) ) ( string ! = ) en.recipe.rice_pudding ) )
which recipe requires less cooking time than rice pudding preparation	( call SW.listValue ( call SW.filter ( call SW.getProperty ( call SW.singleton en.recipe ) ( string ! type ) ) ( call SW.ensureNumericProperty ( string cooking_time ) ) ( string < ) ( call SW.ensureNumericEntity ( call SW.getProperty en.recipe.rice_pudding ( string preparation_time ) ) ) ) )
for which meal is rice pudding or quiche had	( call SW.listValue ( call SW.filter ( call SW.getProperty ( call SW.singleton en.meal ) ( string ! type ) ) ( call SW.reverse ( string meal ) ) ( string = ) ( call SW.concat en.recipe.rice_pudding en.recipe.quiche ) ) )
how many total recipes are there	( call SW.listValue ( call .size ( call SW.getProperty ( call SW.singleton en.recipe ) ( string ! type ) ) ) )
show me recipes for rice pudding meals	( call SW.listValue ( call SW.filter ( call SW.getProperty ( call SW.singleton en.recipe ) ( string ! type ) ) ( string meal ) ( string = ) ( call SW.filter ( call SW.getProperty ( call SW.singleton en.meal ) ( string ! type ) ) ( call SW.reverse ( string meal ) ) ( string = ) en.recipe.rice_pudding ) ) )
what is the newest recipe	( call SW.listValue ( call SW.superlative ( call SW.getProperty ( call SW.singleton en.recipe ) ( string ! type ) ) ( string max ) ( call SW.ensureNumericProperty ( string posting_date ) ) ) )
what to prefer rice pudding or quiche	( call SW.listValue ( call SW.concat en.recipe.rice_pudding en.recipe.quiche ) )
ingredient required by least number of recipes	( call SW.listValue ( call SW.countSuperlative ( call SW.getProperty ( call SW.singleton en.ingredient ) ( string ! type ) ) ( string min ) ( call SW.reverse ( string requires ) ) ( call SW.getProperty ( call SW.singleton en.recipe ) ( string ! type ) ) ) )
show me recipes posted in 2004 or later	( call SW.listValue ( call SW.filter ( call SW.getProperty ( call SW.singleton en.recipe ) ( string ! type ) ) ( call SW.ensureNumericProperty ( string posting_date ) ) ( string >= ) ( call SW.ensureNumericEntity ( date 2004 -1 -1 ) ) ) )
show me recipes requiring one ingredient	( call SW.listValue ( call SW.countComparative ( call SW.getProperty ( call SW.singleton en.recipe ) ( string ! type ) ) ( string requires ) ( string < ) ( number 2 ) ( call SW.getProperty ( call SW.singleton en.ingredient ) ( string ! type ) ) ) )
how long does rice pudding take to cook	( call SW.listValue ( call SW.getProperty en.recipe.rice_pudding ( string cooking_time ) ) )
show me recipes with the longest cooking time	( call SW.listValue ( call SW.superlative ( call SW.getProperty ( call SW.singleton en.recipe ) ( string ! type ) ) ( string max ) ( call SW.ensureNumericProperty ( string cooking_time ) ) ) )
what recipe can make fewer than two meals	( call SW.listValue ( call SW.countComparative ( call SW.getProperty ( call SW.singleton en.recipe ) ( string ! type ) ) ( string meal ) ( string < ) ( number 2 ) ( call SW.getProperty ( call SW.singleton en.meal ) ( string ! type ) ) ) )
show me recipes that take less time to cook than it takes to prepare rice pudding	( call SW.listValue ( call SW.filter ( call SW.getProperty ( call SW.singleton en.recipe ) ( string ! type ) ) ( call SW.ensureNumericProperty ( string cooking_time ) ) ( string < ) ( call SW.ensureNumericEntity ( call SW.getProperty en.recipe.rice_pudding ( string preparation_time ) ) ) ) )
name the ingredient not required in rice pudding	( call SW.listValue ( call SW.filter ( call SW.getProperty ( call SW.singleton en.ingredient ) ( string ! type ) ) ( call SW.reverse ( string requires ) ) ( string ! = ) en.recipe.rice_pudding ) )
what recipe takes the longest to cook	( call SW.listValue ( call SW.superlative ( call SW.getProperty ( call SW.singleton en.recipe ) ( string ! type ) ) ( string max ) ( call SW.ensureNumericProperty ( string cooking_time ) ) ) )
what is the cooking time of recipe	( call SW.listValue ( call SW.aggregate ( string sum ) ( call SW.getProperty ( call SW.getProperty ( call SW.singleton en.recipe ) ( string ! type ) ) ( string cooking_time ) ) ) )
what is a recipe whose cooking time is the same as rice pudding	( call SW.listValue ( call SW.filter ( call SW.getProperty ( call SW.singleton en.recipe ) ( string ! type ) ) ( string cooking_time ) ( string = ) ( call SW.getProperty en.recipe.rice_pudding ( string cooking_time ) ) ) )
what are the recipes for lunch	( call SW.listValue ( call SW.filter ( call SW.filter ( call SW.getProperty ( call SW.singleton en.recipe ) ( string ! type ) ) ( string meal ) ( string = ) en.meal.lunch ) ( string meal ) ( string = ) en.meal.lunch ) )
show me ingredients needed for rice pudding and quiche	( call SW.listValue ( call SW.filter ( call SW.getProperty ( call SW.singleton en.ingredient ) ( string ! type ) ) ( call SW.reverse ( string requires ) ) ( string = ) ( call SW.concat en.recipe.rice_pudding en.recipe.quiche ) ) )
name a recipe which was posted on or later than the posting date of the rice pudding recipe	( call SW.listValue ( call SW.filter ( call SW.getProperty ( call SW.singleton en.recipe ) ( string ! type ) ) ( call SW.ensureNumericProperty ( string posting_date ) ) ( string >= ) ( call SW.ensureNumericEntity ( call SW.getProperty en.recipe.rice_pudding ( string posting_date ) ) ) ) )
find  lunch recipes posted in 2004	( call SW.listValue ( call SW.filter ( call SW.filter ( call SW.getProperty ( call SW.singleton en.recipe ) ( string ! type ) ) ( string posting_date ) ( string = ) ( date 2004 -1 -1 ) ) ( string meal ) ( string = ) en.meal.lunch ) )
which recipes were posted up to 2004	( call SW.listValue ( call SW.filter ( call SW.getProperty ( call SW.singleton en.recipe ) ( string ! type ) ) ( call SW.ensureNumericProperty ( string posting_date ) ) ( string <= ) ( call SW.ensureNumericEntity ( date 2004 -1 -1 ) ) ) )
what recipe uses milk or spinach as an ingredient	( call SW.listValue ( call SW.filter ( call SW.getProperty ( call SW.singleton en.recipe ) ( string ! type ) ) ( string requires ) ( string = ) ( call SW.concat en.ingredient.milk en.ingredient.spinach ) ) )
which recipes were posted after 2004	( call SW.listValue ( call SW.filter ( call SW.getProperty ( call SW.singleton en.recipe ) ( string ! type ) ) ( call SW.ensureNumericProperty ( string posting_date ) ) ( string > ) ( call SW.ensureNumericEntity ( date 2004 -1 -1 ) ) ) )
what recipes comes under less than three cuisine	( call SW.listValue ( call SW.countComparative ( call SW.getProperty ( call SW.singleton en.recipe ) ( string ! type ) ) ( string cuisine ) ( string <= ) ( number 2 ) ) )
name the recipe that is prepared for lunch	( call SW.listValue ( call SW.filter ( call SW.filter ( call SW.getProperty ( call SW.singleton en.recipe ) ( string ! type ) ) ( string meal ) ( string = ) en.meal.lunch ) ( string meal ) ( string = ) en.meal.lunch ) )
what recipe is for two or fewer meals	( call SW.listValue ( call SW.countComparative ( call SW.getProperty ( call SW.singleton en.recipe ) ( string ! type ) ) ( string meal ) ( string <= ) ( number 2 ) ( call SW.getProperty ( call SW.singleton en.meal ) ( string ! type ) ) ) )
recipes that require lesser time to prepare than rice pudding	( call SW.listValue ( call SW.filter ( call SW.getProperty ( call SW.singleton en.recipe ) ( string ! type ) ) ( call SW.ensureNumericProperty ( string preparation_time ) ) ( string < ) ( call SW.ensureNumericEntity ( call SW.getProperty en.recipe.rice_pudding ( string cooking_time ) ) ) ) )
recipe whose posting date is at least posting date of rice pudding	( call SW.listValue ( call SW.filter ( call SW.getProperty ( call SW.singleton en.recipe ) ( string ! type ) ) ( call SW.ensureNumericProperty ( string posting_date ) ) ( string >= ) ( call SW.ensureNumericEntity ( call SW.getProperty en.recipe.rice_pudding ( string posting_date ) ) ) ) )
recipe that is for the least number of meal	( call SW.listValue ( call SW.countSuperlative ( call SW.getProperty ( call SW.singleton en.recipe ) ( string ! type ) ) ( string min ) ( string meal ) ( call SW.getProperty ( call SW.singleton en.meal ) ( string ! type ) ) ) )
recipe that requires the most number of ingredient	( call SW.listValue ( call SW.countSuperlative ( call SW.getProperty ( call SW.singleton en.recipe ) ( string ! type ) ) ( string max ) ( string requires ) ( call SW.getProperty ( call SW.singleton en.ingredient ) ( string ! type ) ) ) )
recipe whose cooking time is at least preparation time of rice pudding	( call SW.listValue ( call SW.filter ( call SW.getProperty ( call SW.singleton en.recipe ) ( string ! type ) ) ( call SW.ensureNumericProperty ( string cooking_time ) ) ( string >= ) ( call SW.ensureNumericEntity ( call SW.getProperty en.recipe.rice_pudding ( string preparation_time ) ) ) ) )
recipe whose preparation time is preparation time of rice pudding	( call SW.listValue ( call SW.filter ( call SW.getProperty ( call SW.singleton en.recipe ) ( string ! type ) ) ( string preparation_time ) ( string = ) ( call SW.getProperty en.recipe.rice_pudding ( string preparation_time ) ) ) )
cooking time of rice pudding	( call SW.listValue ( call SW.getProperty en.recipe.rice_pudding ( string cooking_time ) ) )
recipe that is for lunch and that is for lunch	( call SW.listValue ( call SW.filter ( call SW.filter ( call SW.getProperty ( call SW.singleton en.recipe ) ( string ! type ) ) ( string meal ) ( string = ) en.meal.lunch ) ( string meal ) ( string = ) en.meal.lunch ) )
recipe whose posting date is 2004 and that is for lunch	( call SW.listValue ( call SW.filter ( call SW.filter ( call SW.getProperty ( call SW.singleton en.recipe ) ( string ! type ) ) ( string posting_date ) ( string = ) ( date 2004 -1 -1 ) ) ( string meal ) ( string = ) en.meal.lunch ) )
meal that the most number of recipe is for	( call SW.listValue ( call SW.countSuperlative ( call SW.getProperty ( call SW.singleton en.meal ) ( string ! type ) ) ( string max ) ( call SW.reverse ( string meal ) ) ( call SW.getProperty ( call SW.singleton en.recipe ) ( string ! type ) ) ) )
recipe that is for the most number of meal	( call SW.listValue ( call SW.countSuperlative ( call SW.getProperty ( call SW.singleton en.recipe ) ( string ! type ) ) ( string max ) ( string meal ) ( call SW.getProperty ( call SW.singleton en.meal ) ( string ! type ) ) ) )
recipe whose preparation time is at least cooking time of rice pudding	( call SW.listValue ( call SW.filter ( call SW.getProperty ( call SW.singleton en.recipe ) ( string ! type ) ) ( call SW.ensureNumericProperty ( string preparation_time ) ) ( string >= ) ( call SW.ensureNumericEntity ( call SW.getProperty en.recipe.rice_pudding ( string cooking_time ) ) ) ) )
recipe whose posting date is not 2004	( call SW.listValue ( call SW.filter ( call SW.getProperty ( call SW.singleton en.recipe ) ( string ! type ) ) ( string posting_date ) ( string ! = ) ( date 2004 -1 -1 ) ) )
ingredient that recipe that is for lunch requires	( call SW.listValue ( call SW.filter ( call SW.getProperty ( call SW.singleton en.ingredient ) ( string ! type ) ) ( call SW.reverse ( string requires ) ) ( string = ) ( call SW.filter ( call SW.getProperty ( call SW.singleton en.recipe ) ( string ! type ) ) ( string meal ) ( string = ) en.meal.lunch ) ) )
meal that rice pudding is for	( call SW.listValue ( call SW.filter ( call SW.getProperty ( call SW.singleton en.meal ) ( string ! type ) ) ( call SW.reverse ( string meal ) ) ( string = ) en.recipe.rice_pudding ) )
ingredient that recipe that requires milk requires	( call SW.listValue ( call SW.filter ( call SW.getProperty ( call SW.singleton en.ingredient ) ( string ! type ) ) ( call SW.reverse ( string requires ) ) ( string = ) ( call SW.filter ( call SW.getProperty ( call SW.singleton en.recipe ) ( string ! type ) ) ( string requires ) ( string = ) en.ingredient.milk ) ) )
recipe whose cooking time is larger than cooking time of rice pudding	( call SW.listValue ( call SW.filter ( call SW.getProperty ( call SW.singleton en.recipe ) ( string ! type ) ) ( call SW.ensureNumericProperty ( string cooking_time ) ) ( string > ) ( call SW.ensureNumericEntity ( call SW.getProperty en.recipe.rice_pudding ( string cooking_time ) ) ) ) )
recipe whose cooking time is at most preparation time of rice pudding	( call SW.listValue ( call SW.filter ( call SW.getProperty ( call SW.singleton en.recipe ) ( string ! type ) ) ( call SW.ensureNumericProperty ( string cooking_time ) ) ( string <= ) ( call SW.ensureNumericEntity ( call SW.getProperty en.recipe.rice_pudding ( string preparation_time ) ) ) ) )
recipe whose posting date is 2004 and whose posting date is 2004	( call SW.listValue ( call SW.filter ( call SW.filter ( call SW.getProperty ( call SW.singleton en.recipe ) ( string ! type ) ) ( string posting_date ) ( string = ) ( date 2004 -1 -1 ) ) ( string posting_date ) ( string = ) ( date 2004 -1 -1 ) ) )
rice pudding or quiche	( call SW.listValue ( call SW.concat en.recipe.rice_pudding en.recipe.quiche ) )
recipe that has the largest preparation time	( call SW.listValue ( call SW.superlative ( call SW.getProperty ( call SW.singleton en.recipe ) ( string ! type ) ) ( string max ) ( call SW.ensureNumericProperty ( string preparation_time ) ) ) )
ingredient that the most number of recipe requires	( call SW.listValue ( call SW.countSuperlative ( call SW.getProperty ( call SW.singleton en.ingredient ) ( string ! type ) ) ( string max ) ( call SW.reverse ( string requires ) ) ( call SW.getProperty ( call SW.singleton en.recipe ) ( string ! type ) ) ) )
recipe whose preparation time is at most preparation time of rice pudding	( call SW.listValue ( call SW.filter ( call SW.getProperty ( call SW.singleton en.recipe ) ( string ! type ) ) ( call SW.ensureNumericProperty ( string preparation_time ) ) ( string <= ) ( call SW.ensureNumericEntity ( call SW.getProperty en.recipe.rice_pudding ( string preparation_time ) ) ) ) )
recipe that requires milk and that requires milk	( call SW.listValue ( call SW.filter ( call SW.filter ( call SW.getProperty ( call SW.singleton en.recipe ) ( string ! type ) ) ( string requires ) ( string = ) en.ingredient.milk ) ( string requires ) ( string = ) en.ingredient.milk ) )
recipe that has the largest cooking time	( call SW.listValue ( call SW.superlative ( call SW.getProperty ( call SW.singleton en.recipe ) ( string ! type ) ) ( string max ) ( call SW.ensureNumericProperty ( string cooking_time ) ) ) )
recipe whose cooking time is at most cooking time of rice pudding	( call SW.listValue ( call SW.filter ( call SW.getProperty ( call SW.singleton en.recipe ) ( string ! type ) ) ( call SW.ensureNumericProperty ( string cooking_time ) ) ( string <= ) ( call SW.ensureNumericEntity ( call SW.getProperty en.recipe.rice_pudding ( string cooking_time ) ) ) ) )
recipe that requires less than two ingredient	( call SW.listValue ( call SW.countComparative ( call SW.getProperty ( call SW.singleton en.recipe ) ( string ! type ) ) ( string requires ) ( string < ) ( number 2 ) ( call SW.getProperty ( call SW.singleton en.ingredient ) ( string ! type ) ) ) )
meal that rice pudding or quiche is for	( call SW.listValue ( call SW.filter ( call SW.getProperty ( call SW.singleton en.meal ) ( string ! type ) ) ( call SW.reverse ( string meal ) ) ( string = ) ( call SW.concat en.recipe.rice_pudding en.recipe.quiche ) ) )
recipe whose posting date is larger than 2004	( call SW.listValue ( call SW.filter ( call SW.getProperty ( call SW.singleton en.recipe ) ( string ! type ) ) ( call SW.ensureNumericProperty ( string posting_date ) ) ( string > ) ( call SW.ensureNumericEntity ( date 2004 -1 -1 ) ) ) )
recipe that requires ingredient that rice pudding requires	( call SW.listValue ( call SW.filter ( call SW.getProperty ( call SW.singleton en.recipe ) ( string ! type ) ) ( string requires ) ( string = ) ( call SW.filter ( call SW.getProperty ( call SW.singleton en.ingredient ) ( string ! type ) ) ( call SW.reverse ( string requires ) ) ( string = ) en.recipe.rice_pudding ) ) )
recipe whose posting date is at most 2004	( call SW.listValue ( call SW.filter ( call SW.getProperty ( call SW.singleton en.recipe ) ( string ! type ) ) ( call SW.ensureNumericProperty ( string posting_date ) ) ( string <= ) ( call SW.ensureNumericEntity ( date 2004 -1 -1 ) ) ) )
recipe whose cooking time is preparation time of rice pudding	( call SW.listValue ( call SW.filter ( call SW.getProperty ( call SW.singleton en.recipe ) ( string ! type ) ) ( string cooking_time ) ( string = ) ( call SW.getProperty en.recipe.rice_pudding ( string preparation_time ) ) ) )
meal that the least number of recipe is for	( call SW.listValue ( call SW.countSuperlative ( call SW.getProperty ( call SW.singleton en.meal ) ( string ! type ) ) ( string min ) ( call SW.reverse ( string meal ) ) ( call SW.getProperty ( call SW.singleton en.recipe ) ( string ! type ) ) ) )
recipe that has at most two cuisine	( call SW.listValue ( call SW.countComparative ( call SW.getProperty ( call SW.singleton en.recipe ) ( string ! type ) ) ( string cuisine ) ( string <= ) ( number 2 ) ) )
total preparation time of recipe	( call SW.listValue ( call SW.aggregate ( string sum ) ( call SW.getProperty ( call SW.getProperty ( call SW.singleton en.recipe ) ( string ! type ) ) ( string preparation_time ) ) ) )
meal that recipe that is for lunch is for	( call SW.listValue ( call SW.filter ( call SW.getProperty ( call SW.singleton en.meal ) ( string ! type ) ) ( call SW.reverse ( string meal ) ) ( string = ) ( call SW.filter ( call SW.getProperty ( call SW.singleton en.recipe ) ( string ! type ) ) ( string meal ) ( string = ) en.meal.lunch ) ) )
recipe whose cuisine is cuisine of rice pudding	( call SW.listValue ( call SW.filter ( call SW.getProperty ( call SW.singleton en.recipe ) ( string ! type ) ) ( string cuisine ) ( string = ) ( call SW.getProperty en.recipe.rice_pudding ( string cuisine ) ) ) )
recipe that is for less than two meal	( call SW.listValue ( call SW.countComparative ( call SW.getProperty ( call SW.singleton en.recipe ) ( string ! type ) ) ( string meal ) ( string < ) ( number 2 ) ( call SW.getProperty ( call SW.singleton en.meal ) ( string ! type ) ) ) )
average cooking time of recipe	( call SW.listValue ( call SW.aggregate ( string avg ) ( call SW.getProperty ( call SW.getProperty ( call SW.singleton en.recipe ) ( string ! type ) ) ( string cooking_time ) ) ) )
recipe that is for lunch or dinner	( call SW.listValue ( call SW.filter ( call SW.getProperty ( call SW.singleton en.recipe ) ( string ! type ) ) ( string meal ) ( string = ) ( call SW.concat en.meal.lunch en.meal.dinner ) ) )
recipe whose posting date is posting date of rice pudding	( call SW.listValue ( call SW.filter ( call SW.getProperty ( call SW.singleton en.recipe ) ( string ! type ) ) ( string posting_date ) ( string = ) ( call SW.getProperty en.recipe.rice_pudding ( string posting_date ) ) ) )
recipe that is for lunch and whose posting date is 2004	( call SW.listValue ( call SW.filter ( call SW.filter ( call SW.getProperty ( call SW.singleton en.recipe ) ( string ! type ) ) ( string meal ) ( string = ) en.meal.lunch ) ( string posting_date ) ( string = ) ( date 2004 -1 -1 ) ) )
posting date of rice pudding	( call SW.listValue ( call SW.getProperty en.recipe.rice_pudding ( string posting_date ) ) )
recipe whose posting date is larger than 2004 or 2010	( call SW.listValue ( call SW.filter ( call SW.getProperty ( call SW.singleton en.recipe ) ( string ! type ) ) ( call SW.ensureNumericProperty ( string posting_date ) ) ( string > ) ( call SW.ensureNumericEntity ( call SW.concat ( date 2004 -1 -1 ) ( date 2010 -1 -1 ) ) ) ) )
recipe that requires at most two ingredient	( call SW.listValue ( call SW.countComparative ( call SW.getProperty ( call SW.singleton en.recipe ) ( string ! type ) ) ( string requires ) ( string <= ) ( number 2 ) ( call SW.getProperty ( call SW.singleton en.ingredient ) ( string ! type ) ) ) )
recipe that has the largest posting date	( call SW.listValue ( call SW.superlative ( call SW.getProperty ( call SW.singleton en.recipe ) ( string ! type ) ) ( string max ) ( call SW.ensureNumericProperty ( string posting_date ) ) ) )
meal that rice pudding not is for	( call SW.listValue ( call SW.filter ( call SW.getProperty ( call SW.singleton en.meal ) ( string ! type ) ) ( call SW.reverse ( string meal ) ) ( string ! = ) en.recipe.rice_pudding ) )
meal that recipe that requires milk is for	( call SW.listValue ( call SW.filter ( call SW.getProperty ( call SW.singleton en.meal ) ( string ! type ) ) ( call SW.reverse ( string meal ) ) ( string = ) ( call SW.filter ( call SW.getProperty ( call SW.singleton en.recipe ) ( string ! type ) ) ( string requires ) ( string = ) en.ingredient.milk ) ) )
recipe whose preparation time is cooking time of rice pudding	( call SW.listValue ( call SW.filter ( call SW.getProperty ( call SW.singleton en.recipe ) ( string ! type ) ) ( string preparation_time ) ( string = ) ( call SW.getProperty en.recipe.rice_pudding ( string cooking_time ) ) ) )
number of ingredient	( call SW.listValue ( call .size ( call SW.getProperty ( call SW.singleton en.ingredient ) ( string ! type ) ) ) )
milk or spinach	( call SW.listValue ( call SW.concat en.ingredient.milk en.ingredient.spinach ) )
recipe that not is for lunch	( call SW.listValue ( call SW.filter ( call SW.getProperty ( call SW.singleton en.recipe ) ( string ! type ) ) ( string meal ) ( string ! = ) en.meal.lunch ) )
recipe whose posting date is at most posting date of rice pudding	( call SW.listValue ( call SW.filter ( call SW.getProperty ( call SW.singleton en.recipe ) ( string ! type ) ) ( call SW.ensureNumericProperty ( string posting_date ) ) ( string <= ) ( call SW.ensureNumericEntity ( call SW.getProperty en.recipe.rice_pudding ( string posting_date ) ) ) ) )
recipe whose posting date is smaller than 2004	( call SW.listValue ( call SW.filter ( call SW.getProperty ( call SW.singleton en.recipe ) ( string ! type ) ) ( call SW.ensureNumericProperty ( string posting_date ) ) ( string < ) ( call SW.ensureNumericEntity ( date 2004 -1 -1 ) ) ) )
ingredient that more than two recipe requires	( call SW.listValue ( call SW.countComparative ( call SW.getProperty ( call SW.singleton en.ingredient ) ( string ! type ) ) ( call SW.reverse ( string requires ) ) ( string > ) ( number 2 ) ( call SW.getProperty ( call SW.singleton en.recipe ) ( string ! type ) ) ) )
recipe that has the smallest posting date	( call SW.listValue ( call SW.superlative ( call SW.getProperty ( call SW.singleton en.recipe ) ( string ! type ) ) ( string min ) ( call SW.ensureNumericProperty ( string posting_date ) ) ) )
recipe whose cooking time is at least cooking time of rice pudding	( call SW.listValue ( call SW.filter ( call SW.getProperty ( call SW.singleton en.recipe ) ( string ! type ) ) ( call SW.ensureNumericProperty ( string cooking_time ) ) ( string >= ) ( call SW.ensureNumericEntity ( call SW.getProperty en.recipe.rice_pudding ( string cooking_time ) ) ) ) )
number of meal	( call SW.listValue ( call .size ( call SW.getProperty ( call SW.singleton en.meal ) ( string ! type ) ) ) )
meal that more than two recipe is for	( call SW.listValue ( call SW.countComparative ( call SW.getProperty ( call SW.singleton en.meal ) ( string ! type ) ) ( call SW.reverse ( string meal ) ) ( string > ) ( number 2 ) ( call SW.getProperty ( call SW.singleton en.recipe ) ( string ! type ) ) ) )
ingredient that rice pudding or quiche requires	( call SW.listValue ( call SW.filter ( call SW.getProperty ( call SW.singleton en.ingredient ) ( string ! type ) ) ( call SW.reverse ( string requires ) ) ( string = ) ( call SW.concat en.recipe.rice_pudding en.recipe.quiche ) ) )
recipe whose preparation time is larger than cooking time of rice pudding	( call SW.listValue ( call SW.filter ( call SW.getProperty ( call SW.singleton en.recipe ) ( string ! type ) ) ( call SW.ensureNumericProperty ( string preparation_time ) ) ( string > ) ( call SW.ensureNumericEntity ( call SW.getProperty en.recipe.rice_pudding ( string cooking_time ) ) ) ) )
recipe whose preparation time is smaller than cooking time of rice pudding	( call SW.listValue ( call SW.filter ( call SW.getProperty ( call SW.singleton en.recipe ) ( string ! type ) ) ( call SW.ensureNumericProperty ( string preparation_time ) ) ( string < ) ( call SW.ensureNumericEntity ( call SW.getProperty en.recipe.rice_pudding ( string cooking_time ) ) ) ) )
meal that rice pudding is for and that rice pudding is for	( call SW.listValue ( call SW.filter ( call SW.filter ( call SW.getProperty ( call SW.singleton en.meal ) ( string ! type ) ) ( call SW.reverse ( string meal ) ) ( string = ) en.recipe.rice_pudding ) ( call SW.reverse ( string meal ) ) ( string = ) en.recipe.rice_pudding ) )
recipe that requires milk and whose posting date is 2004	( call SW.listValue ( call SW.filter ( call SW.filter ( call SW.getProperty ( call SW.singleton en.recipe ) ( string ! type ) ) ( string requires ) ( string = ) en.ingredient.milk ) ( string posting_date ) ( string = ) ( date 2004 -1 -1 ) ) )
recipe that has less than two cuisine	( call SW.listValue ( call SW.countComparative ( call SW.getProperty ( call SW.singleton en.recipe ) ( string ! type ) ) ( string cuisine ) ( string < ) ( number 2 ) ) )
recipe whose posting date is smaller than posting date of rice pudding	( call SW.listValue ( call SW.filter ( call SW.getProperty ( call SW.singleton en.recipe ) ( string ! type ) ) ( call SW.ensureNumericProperty ( string posting_date ) ) ( string < ) ( call SW.ensureNumericEntity ( call SW.getProperty en.recipe.rice_pudding ( string posting_date ) ) ) ) )
recipe whose posting date is at least 2004	( call SW.listValue ( call SW.filter ( call SW.getProperty ( call SW.singleton en.recipe ) ( string ! type ) ) ( call SW.ensureNumericProperty ( string posting_date ) ) ( string >= ) ( call SW.ensureNumericEntity ( date 2004 -1 -1 ) ) ) )
recipe whose cooking time is smaller than preparation time of rice pudding	( call SW.listValue ( call SW.filter ( call SW.getProperty ( call SW.singleton en.recipe ) ( string ! type ) ) ( call SW.ensureNumericProperty ( string cooking_time ) ) ( string < ) ( call SW.ensureNumericEntity ( call SW.getProperty en.recipe.rice_pudding ( string preparation_time ) ) ) ) )
recipe that has the most number of cuisine	( call SW.listValue ( call SW.countSuperlative ( call SW.getProperty ( call SW.singleton en.recipe ) ( string ! type ) ) ( string max ) ( string cuisine ) ) )
ingredient that the least number of recipe requires	( call SW.listValue ( call SW.countSuperlative ( call SW.getProperty ( call SW.singleton en.ingredient ) ( string ! type ) ) ( string min ) ( call SW.reverse ( string requires ) ) ( call SW.getProperty ( call SW.singleton en.recipe ) ( string ! type ) ) ) )
recipe that is for lunch and that requires milk	( call SW.listValue ( call SW.filter ( call SW.filter ( call SW.getProperty ( call SW.singleton en.recipe ) ( string ! type ) ) ( string meal ) ( string = ) en.meal.lunch ) ( string requires ) ( string = ) en.ingredient.milk ) )
number of recipe	( call SW.listValue ( call .size ( call SW.getProperty ( call SW.singleton en.recipe ) ( string ! type ) ) ) )
recipe whose posting date is at least 2004 or 2010	( call SW.listValue ( call SW.filter ( call SW.getProperty ( call SW.singleton en.recipe ) ( string ! type ) ) ( call SW.ensureNumericProperty ( string posting_date ) ) ( string >= ) ( call SW.ensureNumericEntity ( call SW.concat ( date 2004 -1 -1 ) ( date 2010 -1 -1 ) ) ) ) )
recipe that not requires milk	( call SW.listValue ( call SW.filter ( call SW.getProperty ( call SW.singleton en.recipe ) ( string ! type ) ) ( string requires ) ( string ! = ) en.ingredient.milk ) )
cuisine of rice pudding	( call SW.listValue ( call SW.getProperty en.recipe.rice_pudding ( string cuisine ) ) )
recipe whose posting date is 2004 and that requires milk	( call SW.listValue ( call SW.filter ( call SW.filter ( call SW.getProperty ( call SW.singleton en.recipe ) ( string ! type ) ) ( string posting_date ) ( string = ) ( date 2004 -1 -1 ) ) ( string requires ) ( string = ) en.ingredient.milk ) )
recipe that has the smallest preparation time	( call SW.listValue ( call SW.superlative ( call SW.getProperty ( call SW.singleton en.recipe ) ( string ! type ) ) ( string min ) ( call SW.ensureNumericProperty ( string preparation_time ) ) ) )
recipe whose cooking time is cooking time of rice pudding	( call SW.listValue ( call SW.filter ( call SW.getProperty ( call SW.singleton en.recipe ) ( string ! type ) ) ( string cooking_time ) ( string = ) ( call SW.getProperty en.recipe.rice_pudding ( string cooking_time ) ) ) )
recipe that requires milk or spinach	( call SW.listValue ( call SW.filter ( call SW.getProperty ( call SW.singleton en.recipe ) ( string ! type ) ) ( string requires ) ( string = ) ( call SW.concat en.ingredient.milk en.ingredient.spinach ) ) )
ingredient that rice pudding not requires	( call SW.listValue ( call SW.filter ( call SW.getProperty ( call SW.singleton en.ingredient ) ( string ! type ) ) ( call SW.reverse ( string requires ) ) ( string ! = ) en.recipe.rice_pudding ) )
recipe whose posting date is 2004 or 2010	( call SW.listValue ( call SW.filter ( call SW.getProperty ( call SW.singleton en.recipe ) ( string ! type ) ) ( string posting_date ) ( string = ) ( call SW.concat ( date 2004 -1 -1 ) ( date 2010 -1 -1 ) ) ) )
recipe whose posting date is 2004	( call SW.listValue ( call SW.filter ( call SW.getProperty ( call SW.singleton en.recipe ) ( string ! type ) ) ( string posting_date ) ( string = ) ( date 2004 -1 -1 ) ) )
recipe whose preparation time is at least preparation time of rice pudding	( call SW.listValue ( call SW.filter ( call SW.getProperty ( call SW.singleton en.recipe ) ( string ! type ) ) ( call SW.ensureNumericProperty ( string preparation_time ) ) ( string >= ) ( call SW.ensureNumericEntity ( call SW.getProperty en.recipe.rice_pudding ( string preparation_time ) ) ) ) )
recipe that has the smallest cooking time	( call SW.listValue ( call SW.superlative ( call SW.getProperty ( call SW.singleton en.recipe ) ( string ! type ) ) ( string min ) ( call SW.ensureNumericProperty ( string cooking_time ) ) ) )
recipe that is for lunch	( call SW.listValue ( call SW.filter ( call SW.getProperty ( call SW.singleton en.recipe ) ( string ! type ) ) ( string meal ) ( string = ) en.meal.lunch ) )
recipe whose preparation time is larger than preparation time of rice pudding	( call SW.listValue ( call SW.filter ( call SW.getProperty ( call SW.singleton en.recipe ) ( string ! type ) ) ( call SW.ensureNumericProperty ( string preparation_time ) ) ( string > ) ( call SW.ensureNumericEntity ( call SW.getProperty en.recipe.rice_pudding ( string preparation_time ) ) ) ) )
recipe that requires milk	( call SW.listValue ( call SW.filter ( call SW.getProperty ( call SW.singleton en.recipe ) ( string ! type ) ) ( string requires ) ( string = ) en.ingredient.milk ) )
recipe whose preparation time is at most cooking time of rice pudding	( call SW.listValue ( call SW.filter ( call SW.getProperty ( call SW.singleton en.recipe ) ( string ! type ) ) ( call SW.ensureNumericProperty ( string preparation_time ) ) ( string <= ) ( call SW.ensureNumericEntity ( call SW.getProperty en.recipe.rice_pudding ( string cooking_time ) ) ) ) )
recipe whose posting date is larger than posting date of rice pudding	( call SW.listValue ( call SW.filter ( call SW.getProperty ( call SW.singleton en.recipe ) ( string ! type ) ) ( call SW.ensureNumericProperty ( string posting_date ) ) ( string > ) ( call SW.ensureNumericEntity ( call SW.getProperty en.recipe.rice_pudding ( string posting_date ) ) ) ) )
recipe whose preparation time is smaller than preparation time of rice pudding	( call SW.listValue ( call SW.filter ( call SW.getProperty ( call SW.singleton en.recipe ) ( string ! type ) ) ( call SW.ensureNumericProperty ( string preparation_time ) ) ( string < ) ( call SW.ensureNumericEntity ( call SW.getProperty en.recipe.rice_pudding ( string preparation_time ) ) ) ) )
recipe that is for at most two meal	( call SW.listValue ( call SW.countComparative ( call SW.getProperty ( call SW.singleton en.recipe ) ( string ! type ) ) ( string meal ) ( string <= ) ( number 2 ) ( call SW.getProperty ( call SW.singleton en.meal ) ( string ! type ) ) ) )
meal that at least two recipe is for	( call SW.listValue ( call SW.countComparative ( call SW.getProperty ( call SW.singleton en.meal ) ( string ! type ) ) ( call SW.reverse ( string meal ) ) ( string >= ) ( number 2 ) ( call SW.getProperty ( call SW.singleton en.recipe ) ( string ! type ) ) ) )
ingredient that rice pudding requires and that rice pudding requires	( call SW.listValue ( call SW.filter ( call SW.filter ( call SW.getProperty ( call SW.singleton en.ingredient ) ( string ! type ) ) ( call SW.reverse ( string requires ) ) ( string = ) en.recipe.rice_pudding ) ( call SW.reverse ( string requires ) ) ( string = ) en.recipe.rice_pudding ) )
preparation time of rice pudding	( call SW.listValue ( call SW.getProperty en.recipe.rice_pudding ( string preparation_time ) ) )
recipe that requires the least number of ingredient	( call SW.listValue ( call SW.countSuperlative ( call SW.getProperty ( call SW.singleton en.recipe ) ( string ! type ) ) ( string min ) ( string requires ) ( call SW.getProperty ( call SW.singleton en.ingredient ) ( string ! type ) ) ) )
recipe whose posting date is at most 2004 or 2010	( call SW.listValue ( call SW.filter ( call SW.getProperty ( call SW.singleton en.recipe ) ( string ! type ) ) ( call SW.ensureNumericProperty ( string posting_date ) ) ( string <= ) ( call SW.ensureNumericEntity ( call SW.concat ( date 2004 -1 -1 ) ( date 2010 -1 -1 ) ) ) ) )
recipe whose cooking time is larger than preparation time of rice pudding	( call SW.listValue ( call SW.filter ( call SW.getProperty ( call SW.singleton en.recipe ) ( string ! type ) ) ( call SW.ensureNumericProperty ( string cooking_time ) ) ( string > ) ( call SW.ensureNumericEntity ( call SW.getProperty en.recipe.rice_pudding ( string preparation_time ) ) ) ) )
recipe whose posting date is smaller than 2004 or 2010	( call SW.listValue ( call SW.filter ( call SW.getProperty ( call SW.singleton en.recipe ) ( string ! type ) ) ( call SW.ensureNumericProperty ( string posting_date ) ) ( string < ) ( call SW.ensureNumericEntity ( call SW.concat ( date 2004 -1 -1 ) ( date 2010 -1 -1 ) ) ) ) )
lunch or dinner	( call SW.listValue ( call SW.concat en.meal.lunch en.meal.dinner ) )
recipe that requires milk and that is for lunch	( call SW.listValue ( call SW.filter ( call SW.filter ( call SW.getProperty ( call SW.singleton en.recipe ) ( string ! type ) ) ( string requires ) ( string = ) en.ingredient.milk ) ( string meal ) ( string = ) en.meal.lunch ) )
ingredient that at least two recipe requires	( call SW.listValue ( call SW.countComparative ( call SW.getProperty ( call SW.singleton en.ingredient ) ( string ! type ) ) ( call SW.reverse ( string requires ) ) ( string >= ) ( number 2 ) ( call SW.getProperty ( call SW.singleton en.recipe ) ( string ! type ) ) ) )
recipe that is for meal that rice pudding is for	( call SW.listValue ( call SW.filter ( call SW.getProperty ( call SW.singleton en.recipe ) ( string ! type ) ) ( string meal ) ( string = ) ( call SW.filter ( call SW.getProperty ( call SW.singleton en.meal ) ( string ! type ) ) ( call SW.reverse ( string meal ) ) ( string = ) en.recipe.rice_pudding ) ) )
recipe whose cooking time is smaller than cooking time of rice pudding	( call SW.listValue ( call SW.filter ( call SW.getProperty ( call SW.singleton en.recipe ) ( string ! type ) ) ( call SW.ensureNumericProperty ( string cooking_time ) ) ( string < ) ( call SW.ensureNumericEntity ( call SW.getProperty en.recipe.rice_pudding ( string cooking_time ) ) ) ) )
recipe that has the least number of cuisine	( call SW.listValue ( call SW.countSuperlative ( call SW.getProperty ( call SW.singleton en.recipe ) ( string ! type ) ) ( string min ) ( string cuisine ) ) )
ingredient that rice pudding requires	( call SW.listValue ( call SW.filter ( call SW.getProperty ( call SW.singleton en.ingredient ) ( string ! type ) ) ( call SW.reverse ( string requires ) ) ( string = ) en.recipe.rice_pudding ) )
2004 or 2010	( call SW.listValue ( call SW.concat ( date 2004 -1 -1 ) ( date 2010 -1 -1 ) ) )
average preparation time of recipe	( call SW.listValue ( call SW.aggregate ( string avg ) ( call SW.getProperty ( call SW.getProperty ( call SW.singleton en.recipe ) ( string ! type ) ) ( string preparation_time ) ) ) )
total cooking time of recipe	( call SW.listValue ( call SW.aggregate ( string sum ) ( call SW.getProperty ( call SW.getProperty ( call SW.singleton en.recipe ) ( string ! type ) ) ( string cooking_time ) ) ) )
