number of steals over a season of player kobe bryant with 3 fouls over a season	number of steals (over a season) of player kobe bryant whose number of fouls (over a season) is 3
number of points over a season of player kobe bryant who has 3 blocks over a season	number of points (over a season) of player kobe bryant whose number of blocks (over a season) is 3
who many rebounds in the season did point guard kobe bryant make	number of rebounds (over a season) of player kobe bryant whose position is point guard
which player had less than 3 points in a season	player whose number of points (over a season) is not 3
what player had the same or less fouls as kobe bryant	player whose number of fouls (over a season) is at most number of fouls (over a season) of player kobe bryant
which player has been in the least number of games in any one season	player that has the smallest number of played games (over a season)
number of turnovers over a season of player kobe bryant who has 3 turnovers over a season	number of turnovers (over a season) of player kobe bryant whose number of turnovers (over a season) is 3
which players had 3 or fewer steals over a season	player whose number of steals (over a season) is at most 3
players that played in the most games during a season	player that has the largest number of played games (over a season)
how many assists does kobe bryant usually make in a season after hes made at least 3	number of assists (over a season) of player kobe bryant whose number of assists (over a season) is 3
in how many games did kobe score 3 points	number of played games (over a season) of player kobe bryant whose number of points (over a season) is 3
what player had 3 or more turnovers	player whose number of turnovers (over a season) is at least 3
during the year he played for the los angeles lakers how many fouls did kobe bryant have	number of fouls (over a season) of player kobe bryant whose team is los angeles lakers
what was the total number of assists in all seasons for player kobe bryant when he was with the lose angeles lakers	number of assists (over a season) of player kobe bryant whose team is los angeles lakers
kobe bryans assists for the season he had 3 assists	number of assists (over a season) of player kobe bryant whose number of assists (over a season) is 3
what player had more blocks than kobe bryant this season	player whose number of blocks (over a season) is larger than number of blocks (over a season) of player kobe bryant
2004 season of kobe bryant	season of player kobe bryant whose season is 2004
how many fouls does kobe bryant have in a season	number of fouls (over a season) of player kobe bryant
what team did kobe bryant play for in 2004	team of player kobe bryant whose season is 2004
what position does kobe bryant play	position of player kobe bryant
how many assists did kobe bryant have when he had 3 blocks	number of assists (over a season) of player kobe bryant whose number of blocks (over a season) is 3
what players committed more fouls that kobe bryant over a season	player whose number of fouls (over a season) is larger than number of fouls (over a season) of player kobe bryant
what was the total number of assists over a season for kobe bryant playing point guard	number of assists (over a season) of player kobe bryant whose position is point guard
which player has a maximum of 3 blocks	player whose number of blocks (over a season) is at most 3
player whose steals over a season are not more than steals player kobe bryant over a season	player whose number of steals (over a season) is at most number of steals (over a season) of player kobe bryant
whats  kobe bryants average steals per season	number of steals (over a season) of player kobe bryant whose number of turnovers (over a season) is 3
how many points does kobe bryant have allseason when he also has 3 blocks	number of points (over a season) of player kobe bryant whose number of blocks (over a season) is 3
how many steals did kobe bryant make	number of steals (over a season) of player kobe bryant
name the player with the total number of assists equalling less than 3	player whose number of assists (over a season) is smaller than 3
how many turnovers does kobe bryant have in seasons with over 3 steals	number of turnovers (over a season) of player kobe bryant whose number of steals (over a season) is 3
how many points did kobe bryant score in the position of point guard	number of points (over a season) of player kobe bryant whose position is point guard
how many steals has kobe bryant got in his career	number of steals (over a season) of player kobe bryant
find a player with 3 or less blocks in any given season	player whose number of blocks (over a season) is at most 3
how many fouls does kobe bryant take in an average season	number of fouls (over a season) of player kobe bryant whose number of points (over a season) is 3
what player has under 3 assists all season	player whose number of assists (over a season) is smaller than 3
players with less than 3 blocks over all seasons	player whose number of blocks (over a season) is smaller than 3
who else plays the same position as kobe bryant	player whose position is position of player kobe bryant
who has more or less than 3 blocks	player whose number of blocks (over a season) is not 3
how many rebounds did kobe bryant have when he had 3 steals	number of rebounds (over a season) of player kobe bryant whose number of steals (over a season) is 3
for the season who played the same number of games as kobe bryant	player whose number of played games (over a season) is number of played games (over a season) of player kobe bryant
what players did not play in the 2004 season	player whose season is not 2004
what team did kobe bryant play for in the 2004 season	team of player kobe bryant whose season is 2004
what is the players number for a certain team	number of team
note the player with the highest number of rebounds to their credit in any one season	player that has the largest number of rebounds (over a season)
who has had more or equal to 3 fouls	player whose number of fouls (over a season) is at least 3
how many games has kobe bryant made more than 3 assists	number of played games (over a season) of player kobe bryant whose number of assists (over a season) is 3
name the player with lesser steals than player kobe bryant over a season	player whose number of steals (over a season) is smaller than number of steals (over a season) of player kobe bryant
how many assists did kobebryant get  after getting 3 steals	number of assists (over a season) of player kobe bryant whose number of steals (over a season) is 3
number of assists over a season of player kobe bryant with 3 rebounds over a season	number of assists (over a season) of player kobe bryant whose number of rebounds (over a season) is 3
players that have more and less than 3 steals over all seasons	player whose number of steals (over a season) is not 3
who has played the least amount of games	player that has the smallest number of played games (over a season)
has kobe bryant averaged 3 rebounds a season while playing for any team	team of player kobe bryant whose number of rebounds (over a season) is 3
players with three or more fouls in a season	player whose number of fouls (over a season) is at least 3
what players have the points same as kob bryants highest points	player whose number of points (over a season) is at most number of points (over a season) of player kobe bryant
which player has played for no more than two teams	player that has at most two team
what players play point guard or forward	player whose position is point guard or forward
what players have as many rebounds as kobe bryant over all seasons	player whose number of rebounds (over a season) is at least number of rebounds (over a season) of player kobe bryant
name a player with the fewest turnovers during a season	player that has the smallest number of turnovers (over a season)
how many rebounds were  got by kobe bryant in 2004	number of rebounds (over a season) of player kobe bryant whose season is 2004
how many rebounds has kobe bryant made so far this season	number of rebounds (over a season) of player kobe bryant
which players score at least 3 points per season	player whose number of points (over a season) is at least 3
how many turnovers does kobe bryant make when hes got 3 assists in the season	number of turnovers (over a season) of player kobe bryant whose number of assists (over a season) is 3
who has had the same or less steals than kobe bryant	player whose number of steals (over a season) is at most number of steals (over a season) of player kobe bryant
whos averaged no more than 3 rebounds each season	player whose number of rebounds (over a season) is at most 3
steals by kobe bryant in 2004	number of steals (over a season) of player kobe bryant whose season is 2004
what player had the most points this season	player that has the largest number of points (over a season)
how many turnovers did kobe bryant have in a season he had 3 assists	number of turnovers (over a season) of player kobe bryant whose number of assists (over a season) is 3
players who are forwards or point guards	point guard or forward
what player has the most turnovers in a season	player that has the largest number of turnovers (over a season)
number of points over a season of player kobe bryant from season 2004	number of points (over a season) of player kobe bryant whose season is 2004
number of played games over a season of player kobe bryant whose team is los angeles lakers	number of played games (over a season) of player kobe bryant whose team is los angeles lakers
what team does kobe bryant play for	team of player kobe bryant whose position is point guard
how many assists has kobe bryant got for this season so far	number of assists (over a season) of player kobe bryant
who is someone with less than 3 blocks in a season	player whose number of blocks (over a season) is smaller than 3
during 2004 how many fouls did kobe get against him	number of fouls (over a season) of player kobe bryant whose season is 2004
which player has played in the most games	player that has the largest number of played games (over a season)
which players dont play for the la lakers	player whose team is not los angeles lakers
what season did kobe bryant only have 3 fouls	season of player kobe bryant whose number of fouls (over a season) is 3
how many rebounds made by kob bryant over a season in which he played 3 games	number of rebounds (over a season) of player kobe bryant whose number of played games (over a season) is 3
who has equal to or more than 3 turnovers	player whose number of turnovers (over a season) is at least 3
who has had the same or more fouls as kobe bryant	player whose number of fouls (over a season) is at least number of fouls (over a season) of player kobe bryant
what player had over 3 fouls	player whose number of fouls (over a season) is larger than 3
how many steals did kobe bryant have in 2004	number of steals (over a season) of player kobe bryant whose season is 2004
number of blocks over a season of player kobe bryant from team los angeles lakers	number of blocks (over a season) of player kobe bryant whose team is los angeles lakers
what season did kobe bryant score 3 points	season of player kobe bryant whose number of points (over a season) is 3
which player had more rebounds than kobe bryant	player whose number of rebounds (over a season) is larger than number of rebounds (over a season) of player kobe bryant
players with a total number of rebounds in a season greater than three	player whose number of rebounds (over a season) is at least 3
how many fouls has kobe bryant had	number of fouls (over a season) of player kobe bryant whose number of blocks (over a season) is 3
who is a player that doesnt make even 3 steals per season	player whose number of steals (over a season) is not 3
who had the least rebounds this season	player that has the smallest number of rebounds (over a season)
players that have the least amount of fouls in a season	player that has the smallest number of fouls (over a season)
how many fouls did kobe bryant have when he had 3 rebounds	number of fouls (over a season) of player kobe bryant whose number of rebounds (over a season) is 3
how many assists did kobe have this season	number of assists (over a season) of player kobe bryant
in how many games did kobe bryant get 3 steals	number of played games (over a season) of player kobe bryant whose number of steals (over a season) is 3
players that had the least amount of turnovers in a season	player that has the smallest number of turnovers (over a season)
number of steals over a season of player kobe bryant who has 3 played games over a season	number of steals (over a season) of player kobe bryant whose number of played games (over a season) is 3
how many turnovers did kobe bryant give up during the 2004 regular season	number of turnovers (over a season) of player kobe bryant whose season is 2004
what player equal or more assists than kobe bryant	player whose number of assists (over a season) is at least number of assists (over a season) of player kobe bryant
which player gets as many assists as kobe bryant if not more	player whose number of assists (over a season) is at least number of assists (over a season) of player kobe bryant
how many steals does kobe bryant have over all seasons	number of steals (over a season) of player kobe bryant
in what year did kobe bryant have three fouls	season of player kobe bryant whose number of fouls (over a season) is 3
how many teams are in the nba	number of team
what players had the same games played than kobe bryant over all seasons	player whose number of played games (over a season) is number of played games (over a season) of player kobe bryant
player with fouls over a season not more than fouls over a season of player kobe bryant	player whose number of fouls (over a season) is at most number of fouls (over a season) of player kobe bryant
what was the total number of steals in seasons where kobe bryant had only played three games	number of steals (over a season) of player kobe bryant whose number of played games (over a season) is 3
who has had the same amount of assists as kobe bryant	player whose number of assists (over a season) is number of assists (over a season) of player kobe bryant
how many games as kobe bryant played for the la lakers	number of played games (over a season) of player kobe bryant whose team is los angeles lakers
which player has the minimum number of points of kobebryant	player whose number of points (over a season) is at least number of points (over a season) of player kobe bryant
what player played less than 3 games	player whose number of played games (over a season) is smaller than 3
in which season did kobe bryant play in point guard position	season of player kobe bryant whose position is point guard
which players play for the lakers or cavaliers	player whose team is los angeles lakers or cleveland cavaliers
how many seasons has kobe bryant scored more than 3 points	season of player kobe bryant whose number of points (over a season) is 3
whos a player with less games played than kobe bryant	player whose number of played games (over a season) is at most number of played games (over a season) of player kobe bryant
what player has as many allseason steals as kobe bryant	player whose number of steals (over a season) is at most number of steals (over a season) of player kobe bryant
position of player kobe bryant from los angeles lakers team	position of player kobe bryant whose team is los angeles lakers
how many players	number of player
what players have played less than 3 games over all seasons	player whose number of played games (over a season) is smaller than 3
how many blocks does kobe bryant average in a given season	number of blocks (over a season) of player kobe bryant
what position was kobe playing when he blocked three shots	position of player kobe bryant whose number of blocks (over a season) is 3
in 2004 how many allseason blocks did kobe bryant have	number of blocks (over a season) of player kobe bryant whose season is 2004
what player has been in for only 1 or 2 games in a season	player whose number of played games (over a season) is smaller than 3
total points of kob bryant over a season	number of points (over a season) of player kobe bryant
which is the team of kobebryant who had 3 turnovers	team of player kobe bryant whose number of turnovers (over a season) is 3
team of player kobe bryant who has 3 fouls over a season	team of player kobe bryant whose number of fouls (over a season) is 3
how many 3point games did kobe bryant play allseason	number of played games (over a season) of player kobe bryant whose number of points (over a season) is 3
how many turnovers kob bryant made in season 2004	number of turnovers (over a season) of player kobe bryant whose season is 2004
which player has the least position	player that has the least number of position
what players played less games than kob bryant over a season	player whose number of played games (over a season) is smaller than number of played games (over a season) of player kobe bryant
name a player with no more blocks in a season that kobe bryant	player whose number of blocks (over a season) is at most number of blocks (over a season) of player kobe bryant
which player takes more fouls than kobe bryant or the same per season	player whose number of fouls (over a season) is at least number of fouls (over a season) of player kobe bryant
player with more than 3 rebounds over a season	player whose number of rebounds (over a season) is larger than 3
player whose number of blocks over a season is not less than that ofplayer kobe bryant over a season	player whose number of blocks (over a season) is at least number of blocks (over a season) of player kobe bryant
which player belongs to kobe bryant  steam	player whose team is team of player kobe bryant
what seasons did kobe bryant have only three blocks	season of player kobe bryant whose number of blocks (over a season) is 3
which year did kobe bryant play for the la lakers	season of player kobe bryant whose team is los angeles lakers
team of player kobe bryant	team of player kobe bryant
how many blocks as point guard kobe bryant made	number of blocks (over a season) of player kobe bryant whose position is point guard
what was the total number of games played by kobe bryant in a season	number of played games (over a season) of player kobe bryant
name a player with the same number of blocks as kobe bryant	player whose number of blocks (over a season) is number of blocks (over a season) of player kobe bryant
what position diddoes kobe bryant play for the la lakers	position of player kobe bryant whose team is los angeles lakers
what player had the same number of fouls as kobe bryant allseason	player whose number of fouls (over a season) is at most number of fouls (over a season) of player kobe bryant
which player belongs to the los angeles lakers team or cleveland cavaliers	player whose team is los angeles lakers or cleveland cavaliers
what player had the same amount of rebounds as kobe bryant	player whose number of rebounds (over a season) is number of rebounds (over a season) of player kobe bryant
players that have fewer fouls over a season than that of kobe bryant	player whose number of fouls (over a season) is smaller than number of fouls (over a season) of player kobe bryant
player who has played same number of games over a season as by player kobe bryantover a season	player whose number of played games (over a season) is number of played games (over a season) of player kobe bryant
how many points did kobe bryant have over all seasons	number of points (over a season) of player kobe bryant whose team is los angeles lakers
what players had a total number of rebounds in a season not equal to three	player whose number of rebounds (over a season) is not 3
how many seasons has kobe played more than 3 games and whats his career rebound total	number of rebounds (over a season) of player kobe bryant whose number of played games (over a season) is 3
which player has scored the minimum number of points	player that has the smallest number of points (over a season)
what players made number of rebounds same as  kobe bryant over a season	player whose number of rebounds (over a season) is number of rebounds (over a season) of player kobe bryant
which player has not made3 blocks	player whose number of blocks (over a season) is not 3
who has played the same or less games than kobe bryant	player whose number of played games (over a season) is at most number of played games (over a season) of player kobe bryant
how many points did kobe bryant have when he had 3 blocks	number of points (over a season) of player kobe bryant whose number of blocks (over a season) is 3
how many steals did kobe bryant have with three turnovers	number of steals (over a season) of player kobe bryant whose number of turnovers (over a season) is 3
player who has at least 3 assists over a season	player whose number of assists (over a season) is at least 3
which player has got a maximum of 3 turnovers	player whose number of turnovers (over a season) is at most 3
players who had more than three assists in a season	player whose number of assists (over a season) is larger than 3
what player plays the most positions	player that has the most number of position
what players have played during the same seasons as kobe bryant	player whose season is season of player kobe bryant
player with the least played games in a season	player that has the smallest number of played games (over a season)
how many steals did kobe get in 04	number of steals (over a season) of player kobe bryant whose season is 2004
during the season in which kobe bryants total number of assists was 3 what team was he on	team of player kobe bryant whose number of assists (over a season) is 3
how many fouls did kobe bryant have allseason	number of fouls (over a season) of player kobe bryant
how many assists does kobe bryant manage in seasons limited to 3 fouls	number of assists (over a season) of player kobe bryant whose number of fouls (over a season) is 3
what player has as much steals as most number of steals kob bryant made over a season	player whose number of steals (over a season) is at most number of steals (over a season) of player kobe bryant
what player had the most blocks this season	player that has the largest number of blocks (over a season)
either 2004 or 2010	2004 or 2010
number of fouls over a season of player kobe bryant with 3 blocks over a season	number of fouls (over a season) of player kobe bryant whose number of blocks (over a season) is 3
what player has less rebound over all seasons	player that has the smallest number of rebounds (over a season)
stats of kobe bryant during 2004 season	season of player kobe bryant whose season is 2004
are there players whose total number of assists in any one given season equals at most 3	player whose number of assists (over a season) is at most 3
how many all season steals did kobe bryant have in 3 games	number of steals (over a season) of player kobe bryant whose number of played games (over a season) is 3
in how many seasons has kobe bryant given up exactly 3 turnovers	number of turnovers (over a season) of player kobe bryant whose number of turnovers (over a season) is 3
who has the record for steals	player that has the largest number of steals (over a season)
how many fouls were played by kobe bryant after getting 3 assists	number of fouls (over a season) of player kobe bryant whose number of assists (over a season) is 3
what player has the most blocks in a season	player that has the largest number of blocks (over a season)
which player has made the least number of blocks	player that has the smallest number of blocks (over a season)
how many rebounds did kobe bryant have over the season in which he played 3 games	number of rebounds (over a season) of player kobe bryant whose number of played games (over a season) is 3
which team did kobe bryant play for with three assists	team of player kobe bryant whose number of assists (over a season) is 3
what player has played more or less than 3 games	player whose number of played games (over a season) is not 3
how many steals did kobe bryant make during a season while playing for the los angeles lakers	number of steals (over a season) of player kobe bryant whose team is los angeles lakers
how many blocks has kobe bryant had	number of blocks (over a season) of player kobe bryant
which player has played the minimum number of games	player that has the smallest number of played games (over a season)
what player has more than 3 allseason blocks	player whose number of blocks (over a season) is larger than 3
in which season was it that kobe bryant participated in 3 games total	season of player kobe bryant whose number of played games (over a season) is 3
whos got the lead for fouls in a season	player that has the largest number of fouls (over a season)
who has had more than 3 steals	player whose number of steals (over a season) is larger than 3
what point guard players had more points than kobe bryant	number of points (over a season) of player kobe bryant whose position is point guard
what players made less than three assists over a season	player whose number of assists (over a season) is smaller than 3
players that had the same number of turnovers in a season as kobe byrant	player whose number of turnovers (over a season) is number of turnovers (over a season) of player kobe bryant
who plays for the los angeles lakers or cleveland cavaliers	player whose team is los angeles lakers or cleveland cavaliers
what player played 3 or more games	player whose number of played games (over a season) is at least 3
who has had the least amount of blocks	player that has the smallest number of blocks (over a season)
how many positions	number of position
players with a total number of rebounds in a season no greater than three	player whose number of rebounds (over a season) is at most 3
players with less than three fouls in a season	player whose number of fouls (over a season) is smaller than 3
which player had no more than three turnovers	player whose number of turnovers (over a season) is at most 3
team of player kobe bryant who has 3 steals over a season	team of player kobe bryant whose number of steals (over a season) is 3
who has played the most games	player that has the largest number of played games (over a season)
name the position of kobe bryant when he made three rebounds	position of player kobe bryant whose number of rebounds (over a season) is 3
which player matches the season average steal rate of kobe bryant	player whose number of steals (over a season) is number of steals (over a season) of player kobe bryant
which player has played no more than three games	player whose number of played games (over a season) is at most 3
for which team did kobe bryant make three rebounds	team of player kobe bryant whose number of rebounds (over a season) is 3
which players scored less points over the season than kobe bryant	player whose number of points (over a season) is smaller than number of points (over a season) of player kobe bryant
who had more points than kobe bryant	player whose number of points (over a season) is larger than number of points (over a season) of player kobe bryant
what was the total number of fouls in a season for kobe bryant when he had only three blocks	number of fouls (over a season) of player kobe bryant whose number of blocks (over a season) is 3
what player gets more blocks than  kobe bryant or at least the same	player whose number of blocks (over a season) is at least number of blocks (over a season) of player kobe bryant
name a point guard or a forward	point guard or forward
players that have the same number of points in a season as kobe bryants lowest amount	player whose number of points (over a season) is at least number of points (over a season) of player kobe bryant
what player had the fewest steals all season	player that has the smallest number of steals (over a season)
how many games did kobe bryant get 3 points in	number of played games (over a season) of player kobe bryant whose number of points (over a season) is 3
how many players have had more turnovers in a season than kobe bryant	player whose number of turnovers (over a season) is larger than number of turnovers (over a season) of player kobe bryant
player that scored three or more points per game last season	player whose number of points (over a season) is at least 3
how many turnovers has kobe bryant had	number of turnovers (over a season) of player kobe bryant whose position is point guard
how many fouls did kobe bryant score during the season	number of fouls (over a season) of player kobe bryant whose number of fouls (over a season) is 3
how many points did kobe bryant who had three turnovers have	number of points (over a season) of player kobe bryant whose number of turnovers (over a season) is 3
who has less than 3 blocks	player whose number of blocks (over a season) is smaller than 3
how many allseason blocks did kobe bryant have in 3 allseason games	number of blocks (over a season) of player kobe bryant whose number of played games (over a season) is 3
what position did kobe bryant have 3 turnovers as	position of player kobe bryant whose number of turnovers (over a season) is 3
what position did kobe bryant play when he got 3 rebounds	position of player kobe bryant whose number of rebounds (over a season) is 3
which players have been on two or less teams	player that has at most two team
what position did kobe bryant play when he had 3 fouls	position of player kobe bryant whose number of fouls (over a season) is 3
what was the total number of assist for kobe bryant over a season where he had three rebounds	number of assists (over a season) of player kobe bryant whose number of rebounds (over a season) is 3
what is the number of the player kobe bryant	number of player
find those players responsible for less than 3 points in any given season	player whose number of points (over a season) is smaller than 3
what player played more than 3 games	player whose number of played games (over a season) is larger than 3
what season did kobe bryant have 3 steals	season of player kobe bryant whose number of steals (over a season) is 3
how many turnovers did kobe bryant get after the 3 rebounds	number of turnovers (over a season) of player kobe bryant whose number of rebounds (over a season) is 3
when kobe bryant had 3 allseason turnovers how many allseason points did he have	number of points (over a season) of player kobe bryant whose number of turnovers (over a season) is 3
what players played in 2004 or 2010	player whose season is 2004 or 2010
which player had more assists than kobe bryant	player whose number of assists (over a season) is larger than number of assists (over a season) of player kobe bryant
in seasons with more than 3 steals how many blocks did kobe bryant have	number of blocks (over a season) of player kobe bryant whose number of steals (over a season) is 3
for season 2004 note the number of total assists of kobe bryant	number of assists (over a season) of player kobe bryant whose season is 2004
which players plays in two positions	player that has at most two position
player with less than 3 points over a season	player whose number of points (over a season) is smaller than 3
how many turnovers did kobe bryant have in a game where he had three fouls	number of turnovers (over a season) of player kobe bryant whose number of fouls (over a season) is 3
how many rebounds has players that are not the 3 had	player whose number of rebounds (over a season) is not 3
what is the number of positions	number of position
how many fouls were played by kobe bryant when he was at point guard	number of fouls (over a season) of player kobe bryant whose position is point guard
what position is kobe bryant	position of player kobe bryant whose number of blocks (over a season) is 3
how many teams are there	number of team
who has the record for fewest steals in a season	player that has the smallest number of steals (over a season)
how many turnovers does kobe bryant average over a reason	team of player kobe bryant whose number of turnovers (over a season) is 3
which team does kobe bryant play for which has less than 3 turnovers	team of player kobe bryant whose number of turnovers (over a season) is 3
how many rebounds did kobe bryant have when he had 3 fouls	number of rebounds (over a season) of player kobe bryant whose number of fouls (over a season) is 3
number of turnovers over a season of player kobe bryant who has 3 rebounds over a season	number of turnovers (over a season) of player kobe bryant whose number of rebounds (over a season) is 3
how many blocks did player kobe bryant have with 3 assists over this season	number of blocks (over a season) of player kobe bryant whose number of assists (over a season) is 3
who gets 3 or more turnovers each season	player whose number of turnovers (over a season) is at least 3
find players who have committed a higher amount of fouls in a given season than kobe bryant	player whose number of fouls (over a season) is larger than number of fouls (over a season) of player kobe bryant
which player had the fewest assists	player that has the smallest number of assists (over a season)
what player has no less than 3 allseason rebounds	player whose number of rebounds (over a season) is at least 3
find the player with a total number of blocks less than the total number of blocks performed by kobe bryant in any one season	player whose number of blocks (over a season) is smaller than number of blocks (over a season) of player kobe bryant
player with more fouls over a season than player kobe bryant	player whose number of fouls (over a season) is larger than number of fouls (over a season) of player kobe bryant
how many turnovers has kobe bryant lost in seasons with at least 3 points	number of turnovers (over a season) of player kobe bryant whose number of points (over a season) is 3
what player had the same or more turnovers as kobe bryant	player whose number of turnovers (over a season) is at least number of turnovers (over a season) of player kobe bryant
what was the total number of blocks for kobe bryant in seasons where he had just three fouls	number of blocks (over a season) of player kobe bryant whose number of fouls (over a season) is 3
in how many games did kobebryant get3 turnovers	number of played games (over a season) of player kobe bryant whose number of turnovers (over a season) is 3
what player made least points	player that has the smallest number of points (over a season)
which player had no more than the number of steals by kobe bryant	player whose number of steals (over a season) is at most number of steals (over a season) of player kobe bryant
who has played more than 3 games in a season	player whose number of played games (over a season) is larger than 3
what players played most games over a season same as kob bryant	player whose number of played games (over a season) is at most number of played games (over a season) of player kobe bryant
who has had more or less than 3 steals	player whose number of steals (over a season) is not 3
how many rebounds has kobe bryant had	number of rebounds (over a season) of player kobe bryant
which player has had the most fouls in a season	player that has the largest number of fouls (over a season)
what team did kobe bryant play 3 games for	team of player kobe bryant whose number of played games (over a season) is 3
how many rebounds did kobe bryant make when his total blocks over a season was 3	number of rebounds (over a season) of player kobe bryant whose number of blocks (over a season) is 3
which player has less then two positions	player that has less than two position
what player played in the most games this season	player that has the largest number of played games (over a season)
during the season in which he was responsible for 3 steals what was the name of the team kobe bryant was on	team of player kobe bryant whose number of steals (over a season) is 3
player with most number of steals over a season	player that has the largest number of steals (over a season)
which was the season kob bryant made 3 steals	season of player kobe bryant whose number of steals (over a season) is 3
how many steals did kobe bryant have when he scored three points	number of steals (over a season) of player kobe bryant whose number of points (over a season) is 3
how many turnovers did kobe have during the season he averaged three assists	number of turnovers (over a season) of player kobe bryant whose number of assists (over a season) is 3
who leads the points race so far this season	player that has the largest number of points (over a season)
which player had no more than three assists during the season	player whose number of assists (over a season) is at most 3
which player had got less than 3 turnovers	player whose number of turnovers (over a season) is smaller than 3
how many rebounds did kobe bryant get after 3 turnovers	number of rebounds (over a season) of player kobe bryant whose number of turnovers (over a season) is 3
what is the number of assists by kobe bryant who made 3 assists over the season	number of assists (over a season) of player kobe bryant whose number of assists (over a season) is 3
who has the lowest average blocks per season	player that has the smallest number of blocks (over a season)
how many assists has kobe bryant had	number of assists (over a season) of player kobe bryant whose team is los angeles lakers
who has more than 3 assists to their credit per season	player whose number of assists (over a season) is larger than 3
what player had more fouls than kobe bryant	player whose number of fouls (over a season) is larger than number of fouls (over a season) of player kobe bryant
how many blocks did kobe bryant make when he had three points	number of blocks (over a season) of player kobe bryant whose number of points (over a season) is 3
which players played more games than kobe bryant the seasons he played	player whose number of played games (over a season) is larger than number of played games (over a season) of player kobe bryant
what position did kobe bryant play for only three games during the season	position of player kobe bryant whose number of played games (over a season) is 3
points of kob bryant over a season in which he made 3 blocks	number of points (over a season) of player kobe bryant whose number of blocks (over a season) is 3
who has had the most fouls	player that has the largest number of fouls (over a season)
which player has played less games than kobe bryant	player whose number of played games (over a season) is smaller than number of played games (over a season) of player kobe bryant
what position did kobe play when her had three turnover this season	position of player kobe bryant whose number of turnovers (over a season) is 3
what player has the most steals during a single season	player that has the largest number of steals (over a season)
how many steals did kobe bryant have in season where he had only three rebounds	number of steals (over a season) of player kobe bryant whose number of rebounds (over a season) is 3
who has had the same or less points this season as kobe bryant	player whose number of points (over a season) is at most number of points (over a season) of player kobe bryant
player whose number of fouls over a season is less than that of player kobe bryant over a season	player whose number of fouls (over a season) is smaller than number of fouls (over a season) of player kobe bryant
players that had the lowest number of assists in a season	player that has the smallest number of assists (over a season)
kobe bryant had3 turnovers	number of turnovers (over a season) of player kobe bryant whose number of turnovers (over a season) is 3
who has had less fouls than kobe bryant	player whose number of fouls (over a season) is smaller than number of fouls (over a season) of player kobe bryant
for which team kob bryant made 3 blocks over a season	team of player kobe bryant whose number of blocks (over a season) is 3
how many games kob bryant played in the season in which he made 3 assists	number of played games (over a season) of player kobe bryant whose number of assists (over a season) is 3
which player has the minimum number of fouls	player that has the smallest number of fouls (over a season)
how many rebounds did kobe bryant make in 2004	number of rebounds (over a season) of player kobe bryant whose season is 2004
what player had less turnovers than kobe bryant this season	player whose number of turnovers (over a season) is smaller than number of turnovers (over a season) of player kobe bryant
player with less than 3 steals	player whose number of steals (over a season) is smaller than 3
players who had no more rebounds over a season than that of kobe bryant	player whose number of rebounds (over a season) is at most number of rebounds (over a season) of player kobe bryant
what player had less than 3 steals	player whose number of steals (over a season) is smaller than 3
turnovers of kob bryant over a season in which he made 3 assists	number of turnovers (over a season) of player kobe bryant whose number of assists (over a season) is 3
number of blocks over a season of player kobe bryant who has played 3 games over a season	number of blocks (over a season) of player kobe bryant whose number of played games (over a season) is 3
player from los angeles lakers or cleveland cavaliers	player whose team is los angeles lakers or cleveland cavaliers
player with at least as many turnover as kobe bryant	player whose number of turnovers (over a season) is at least number of turnovers (over a season) of player kobe bryant
how many assists were made by kob bryant over a season in which he made 3 fouls	number of assists (over a season) of player kobe bryant whose number of fouls (over a season) is 3
which player got lesser number of assists than kobe bryant	player whose number of assists (over a season) is smaller than number of assists (over a season) of player kobe bryant
how many seasons have kobe bryant played	season of player kobe bryant
how many assists did kobe bryant have after 3 games	number of assists (over a season) of player kobe bryant whose number of played games (over a season) is 3
name a player who did not have three assists	player whose number of assists (over a season) is not 3
which player plays fewer than two positions	player that has less than two position
which player had fewer rebounds than kobe bryant	player whose number of rebounds (over a season) is smaller than number of rebounds (over a season) of player kobe bryant
how many turnovers did kobe bryant have over the season for the la lakers	number of turnovers (over a season) of player kobe bryant whose team is los angeles lakers
which player has scored at least as many points as kobe bryant	player whose number of points (over a season) is at least number of points (over a season) of player kobe bryant
in the season he had 3 blocks kobe bryant was playing for what team	position of player kobe bryant whose number of blocks (over a season) is 3
who played the fewest games in a season	player that has the smallest number of played games (over a season)
what players made less than 4 assists in a season	player whose number of assists (over a season) is not 3
how many steals did kobe bryant have in the 2004 season	number of steals (over a season) of player kobe bryant whose season is 2004
who has at least as many assists as kobe bryant over a season	player whose number of assists (over a season) is number of assists (over a season) of player kobe bryant
name a player who had a point score that was not three	player whose number of points (over a season) is not 3
which players played the most games in a season	player that has the largest number of played games (over a season)
what players are associated with one or no team	player that has less than two team
what player had the most turnovers	player that has the largest number of turnovers (over a season)
players that have the same or fewer total fouls as kobe bryant	player whose number of fouls (over a season) is at most number of fouls (over a season) of player kobe bryant
what players did not score more than three points in a season	player whose number of points (over a season) is at most 3
how many fouls did kobe have in the season he played point gaurd	number of fouls (over a season) of player kobe bryant whose position is point guard
kobe bryant belongs to the los angeles lakers team	team of player kobe bryant whose team is los angeles lakers
how many blocks were made by kobe bryant who belonged to the los angeles lakers team	number of blocks (over a season) of player kobe bryant whose team is los angeles lakers
find those players committing a total number of steals that is larger than the total number of steals committed by kobe bryant in any one season	player whose number of steals (over a season) is larger than number of steals (over a season) of player kobe bryant
what player played in 2004 or 2010	player whose season is 2004 or 2010
in which season did kobe bryant average 3 blocks	season of player kobe bryant whose number of blocks (over a season) is 3
name those players with total foul tallies of less than 3 in any one particular season	player whose number of fouls (over a season) is smaller than 3
is there a player with the same number of turnovers in a specific season as kobe bryant has in a specific season as well	player whose number of turnovers (over a season) is number of turnovers (over a season) of player kobe bryant
which season did kobe bryant play 3 games	season of player kobe bryant whose number of played games (over a season) is 3
name players other than point guard	player whose position is not point guard
number of rebounds over a season of player kobe bryant who has played 3 games over a season	number of rebounds (over a season) of player kobe bryant whose number of played games (over a season) is 3
how many turnovers did kobe bryant have when his all season steals equaled 3	number of turnovers (over a season) of player kobe bryant whose number of steals (over a season) is 3
player with most turnovers over a season	player that has the largest number of turnovers (over a season)
player who made lesser steals than kob bryant over a season	player whose number of steals (over a season) is smaller than number of steals (over a season) of player kobe bryant
over a season which player has the largest number of rebounds	player that has the largest number of rebounds (over a season)
how many blocks does kobe bryant average in a season with 3 points	number of blocks (over a season) of player kobe bryant whose number of points (over a season) is 3
how many assists did player kobe bryant have over this season to get 3 turnovers	number of assists (over a season) of player kobe bryant whose number of turnovers (over a season) is 3
what player had the same or fewer steals than kobe bryant	player whose number of steals (over a season) is at most number of steals (over a season) of player kobe bryant
how many points does kobe bryant average in seasons with 3 fouls	number of points (over a season) of player kobe bryant whose number of fouls (over a season) is 3
during the season in which he had 3 turnovers name the number of games in which kobe bryant participated in	number of played games (over a season) of player kobe bryant whose number of turnovers (over a season) is 3
team of player kobe bryant who has 3 assists over a season	team of player kobe bryant whose number of assists (over a season) is 3
how many fouls did kobe bryant have with three points	number of fouls (over a season) of player kobe bryant whose number of points (over a season) is 3
who has played the same number of games as kobe bryant	player whose number of played games (over a season) is number of played games (over a season) of player kobe bryant
how many steals did kobebryant get in 2004	number of steals (over a season) of player kobe bryant whose season is 2004
player with not more than 3 blocks over a season	player whose number of blocks (over a season) is at most 3
which player had fewer turnovers than three	player whose number of turnovers (over a season) is smaller than 3
in which seasons kob bryant made 3 blocks	season of player kobe bryant whose number of blocks (over a season) is 3
name a player with more than three played games	player whose number of played games (over a season) is larger than 3
kobe bryant played three games	number of played games (over a season) of player kobe bryant whose number of played games (over a season) is 3
what team did kobe play for during his three steam season	team of player kobe bryant whose number of steals (over a season) is 3
player with at least 3 rebounds over a season	player whose number of rebounds (over a season) is at least 3
how many seasons has kobe bryant played for the lakers	season of player kobe bryant whose team is los angeles lakers
number of fouls kobe bryant  who has 3 assists	number of fouls (over a season) of player kobe bryant whose number of assists (over a season) is 3
which player has more assists than kobe bryant	player whose number of assists (over a season) is larger than number of assists (over a season) of player kobe bryant
player who has maximum number of teams	player that has the most number of team
which player has had the most  turnovers in any one season	player that has the largest number of turnovers (over a season)
which player has played with at most two teams	player that has at most two team
which player has the minimum number of turnovers of kobe bryant	player whose number of turnovers (over a season) is at least number of turnovers (over a season) of player kobe bryant
number of played games over a season of player kobe bryant who is at point guard	number of played games (over a season) of player kobe bryant whose position is point guard
how many blocks did kobe bryant make during the season	number of blocks (over a season) of player kobe bryant whose number of played games (over a season) is 3
kobe bryant made 3 blocks	number of blocks (over a season) of player kobe bryant whose number of blocks (over a season) is 3
how many fouls were played by kobe bryant after having 3 rebounds	number of fouls (over a season) of player kobe bryant whose number of rebounds (over a season) is 3
in which season did kobe bryant have three steals	season of player kobe bryant whose number of steals (over a season) is 3
how many steals did kobe bryant have	number of steals (over a season) of player kobe bryant
how many games has kobe bryant had more than 3 turnovers in all seasons	number of turnovers (over a season) of player kobe bryant whose number of blocks (over a season) is 3
which player has  played lesser than 3 fouls	player whose number of fouls (over a season) is smaller than 3
what team did kobe bryant play for while making 3 assists per season	team of player kobe bryant whose number of assists (over a season) is 3
how many points did kobe bryant score after 3 games	number of points (over a season) of player kobe bryant whose number of played games (over a season) is 3
how many assists did kobe bryant get when he was in the position of point guard	number of assists (over a season) of player kobe bryant whose position is point guard
which player has got a minimum of 3 turnovers	player whose number of turnovers (over a season) is at least 3
how many blocks did kobe bryant have during a season	number of blocks (over a season) of player kobe bryant whose number of steals (over a season) is 3
players that have more and less than 3 blocks over seasons	player whose number of blocks (over a season) is not 3
what number is kobe bryant and how many assists does he have	team of player kobe bryant whose number of assists (over a season) is 3
a player with at least 3 fouls	player whose number of fouls (over a season) is at least 3
which year 2004 or 2010	2004 or 2010
how  many rebounds in a season did kobe bryant have in 2004	number of rebounds (over a season) of player kobe bryant whose season is 2004
how many rebounds did kobe bryant get in 3 games	number of rebounds (over a season) of player kobe bryant whose number of played games (over a season) is 3
how many turnovers did kobe get after scoring 3 points	number of turnovers (over a season) of player kobe bryant whose number of points (over a season) is 3
team of player kobe bryant with 3 points over a season	team of player kobe bryant whose number of points (over a season) is 3
number of rebounds over a season of player kobe bryant with 3 turnovers over a season	number of rebounds (over a season) of player kobe bryant whose number of turnovers (over a season) is 3
what player had less than 3 fouls	player whose number of fouls (over a season) is smaller than 3
how many rebounds did kobe bryant get as point guard	number of rebounds (over a season) of player kobe bryant whose position is point guard
how many turnovers did kobe bryant make over a season when played as point guard	number of turnovers (over a season) of player kobe bryant whose position is point guard
what player had more blocks than kobe bryant over a season	player whose number of blocks (over a season) is larger than number of blocks (over a season) of player kobe bryant
player whose number of turnovers over a season is more than that of player kobe bryant over a season	player whose number of turnovers (over a season) is larger than number of turnovers (over a season) of player kobe bryant
what player had more than 3 steals	player whose number of steals (over a season) is larger than 3
how many assists did kboe bryant have when he had 3 steals	number of assists (over a season) of player kobe bryant whose number of steals (over a season) is 3
position of player kobe bryant who has played 3 games over a season	position of player kobe bryant whose number of played games (over a season) is 3
during  season 2004 note the total number of points scored by kobe bryant	number of points (over a season) of player kobe bryant whose season is 2004
which team did kobe bryant play on in 2004	team of player kobe bryant whose season is 2004
during the season in which he scored 3 points name the number of rebounds he was responsible for kobe bryant	number of rebounds (over a season) of player kobe bryant whose number of points (over a season) is 3
koby bryant position	position of player kobe bryant
player who plays the same position as kobe bryant	player whose position is position of player kobe bryant
kobe bryant got 3 steals	number of steals (over a season) of player kobe bryant whose number of steals (over a season) is 3
find players responsible for the same amount of assists in any one specific season as kobe bryant	player whose number of assists (over a season) is number of assists (over a season) of player kobe bryant
player with not less than 3 fouls over a season is at least 3	player whose number of fouls (over a season) is at least 3
player who does not play point guard	player whose position is not point guard
name a player with no more than three rebounds in the season	player whose number of rebounds (over a season) is at most 3
has kobe bryant averaged 3 fouls and 3 blocks per game over a season	number of blocks (over a season) of player kobe bryant whose number of fouls (over a season) is 3
which player has the highest number of assists	player that has the largest number of assists (over a season)
player whoplayed less games over a season than player kobe bryant has played over a season	player whose number of played games (over a season) is smaller than number of played games (over a season) of player kobe bryant
how many turnovers kob bryant made in the season he made 3 points	number of turnovers (over a season) of player kobe bryant whose number of points (over a season) is 3
what position did kobe bryant play in the 2004 season	position of player kobe bryant whose season is 2004
what players have the same number of turnovers over all their seasons equal to or worse than that of kobe bryant	player whose number of turnovers (over a season) is at least number of turnovers (over a season) of player kobe bryant
what players have a total number of fouls over a season that is not 3	player whose number of fouls (over a season) is not 3
how many all season rebounds did kobe bryant have as point guard	number of rebounds (over a season) of player kobe bryant whose position is point guard
the number of turnovers of player kobe bryant over this season is 3	number of turnovers (over a season) of player kobe bryant whose number of turnovers (over a season) is 3
how many turnovers did kobe bryant have when he played in three games	number of turnovers (over a season) of player kobe bryant whose number of played games (over a season) is 3
name the player that represented most teams	player that has the most number of team
during the same season that he acquired 3 points how many turnovers did kobe bryant have	number of turnovers (over a season) of player kobe bryant whose number of points (over a season) is 3
how many assists kob bryant made over a season	number of assists (over a season) of player kobe bryant
kobe bryants rebounds for the season	number of rebounds (over a season) of player kobe bryant
how many rebounds did kobe bryant get in the seasons he scored 3 points	number of rebounds (over a season) of player kobe bryant whose number of points (over a season) is 3
what player made less than 4 points in a season	player whose number of turnovers (over a season) is at most 3
which player had fewer points in the season than kobe bryant	player whose number of points (over a season) is smaller than number of points (over a season) of player kobe bryant
in which season kobe has scored  3 points	season of player kobe bryant whose number of points (over a season) is 3
name a player with at least as many steals as kobe bryant	player whose number of steals (over a season) is at least number of steals (over a season) of player kobe bryant
kobe bryant played in the season 2004	season of player kobe bryant whose season is 2004
what player has held the most positions	player that has the most number of position
what player has a maximum of 3 allseason turnovers	player whose number of turnovers (over a season) is at most 3
what player has more allseason steals than kobe bryant	player whose number of steals (over a season) is larger than number of steals (over a season) of player kobe bryant
how many steals has kobe bryant had	number of steals (over a season) of player kobe bryant
in the season in which he had 3 turnovers find the number of  point for which kobe bryant was responsible	number of points (over a season) of player kobe bryant whose number of turnovers (over a season) is 3
who has played less than 4 games per season	player whose number of played games (over a season) is at most 3
for which team did kobe bryant play three games	team of player kobe bryant whose number of played games (over a season) is 3
which player had no more rebounds than kobe bryant	player whose number of rebounds (over a season) is at most number of rebounds (over a season) of player kobe bryant
what player had equal or more fouls as kobe bryant	player whose number of fouls (over a season) is at least number of fouls (over a season) of player kobe bryant
which season kob bryant made 3 rebounds	season of player kobe bryant whose number of rebounds (over a season) is 3
name a player who did not have three turnovers	player whose number of turnovers (over a season) is not 3
how many fouls will kobe bryant have in seasons when hes got 3 assists	number of fouls (over a season) of player kobe bryant whose number of assists (over a season) is 3
find the player with the highest score of assists performed in any one given season	player that has the largest number of assists (over a season)
mention the number of turnovers of player kobe bryant in 3 games played over this season	number of turnovers (over a season) of player kobe bryant whose number of played games (over a season) is 3
who are the players with foul totals equivalent in any one season to that of kobe bryant in any one season	player whose number of fouls (over a season) is number of fouls (over a season) of player kobe bryant
player with less points over a season than that of player kobe bryant over a season	player whose number of points (over a season) is smaller than number of points (over a season) of player kobe bryant
what players did not play in 2004	player whose season is not 2004
how many fouls did kobe bryant have when he made three turnovers	number of fouls (over a season) of player kobe bryant whose number of turnovers (over a season) is 3
find those players with a total number of turnovers in any one specific season that is less than 3	player whose number of turnovers (over a season) is smaller than 3
what position did kobe bryant play when he had 3 blocks in a season	position of player kobe bryant whose number of blocks (over a season) is 3
number of fouls over a season of player kobe bryant with 3 assists over a season	number of fouls (over a season) of player kobe bryant whose number of assists (over a season) is 3
position of player kobe bryant who has 3 points over a season	position of player kobe bryant whose number of points (over a season) is 3
which player played fewer than three games	player whose number of played games (over a season) is smaller than 3
how many assists did kobe bryant have in the games where he had three fouls	number of assists (over a season) of player kobe bryant whose number of fouls (over a season) is 3
how many turnovers does kobe bryant average in games with more than 3 rebounds for him	number of turnovers (over a season) of player kobe bryant whose number of rebounds (over a season) is 3
what team did kobe play for during the season he average three blocks	team of player kobe bryant whose number of blocks (over a season) is 3
name a player who has had more blocks than kobe bryant	player whose number of blocks (over a season) is larger than number of blocks (over a season) of player kobe bryant
kobe bryant play point guard	position of player kobe bryant whose position is point guard
number of seasons where kobe bryant had three fouls	number of fouls (over a season) of player kobe bryant whose number of fouls (over a season) is 3
how blocks did  did kobe bryant make after playing 3 fouls	number of blocks (over a season) of player kobe bryant whose number of fouls (over a season) is 3
which player has the minimum number of fouls of kobebryant	player whose number of fouls (over a season) is at least number of fouls (over a season) of player kobe bryant
players with less blocks than kobe bryant over all seasons	player whose number of blocks (over a season) is smaller than number of blocks (over a season) of player kobe bryant
who had the most steals	player that has the largest number of steals (over a season)
how many games has kobe bryant played	number of played games (over a season) of player kobe bryant whose season is 2004
name a player with fewer than three blocks per season	player whose number of blocks (over a season) is smaller than 3
which player has a similar per season rebound average as kobe bryant	player whose number of rebounds (over a season) is number of rebounds (over a season) of player kobe bryant
what player didnt have 3 assists	player whose number of assists (over a season) is not 3
which season did kobe bryant have 3 turnovers	season of player kobe bryant whose number of turnovers (over a season) is 3
how many points did kobe bryant have when he had 3 fouls	number of points (over a season) of player kobe bryant whose number of fouls (over a season) is 3
how many all season fouls did kobe bryant have as an la laker	number of fouls (over a season) of player kobe bryant whose team is los angeles lakers
who has played the record number of games in a season	player that has the largest number of played games (over a season)
season of player kobe bryant from los angeles lakers team	season of player kobe bryant whose team is los angeles lakers
position of player kobe bryant who has 3 turnovers over a season	position of player kobe bryant whose number of turnovers (over a season) is 3
how many seasons has kobe bryant played for the los angeles lakers	season of player kobe bryant whose team is los angeles lakers
what player had more all season points than kobe bryant	player whose number of points (over a season) is larger than number of points (over a season) of player kobe bryant
what was the position of kob bryant in the season he made 3 turnovers	position of player kobe bryant whose number of turnovers (over a season) is 3
how many turnovers did kobe bryant have when he had 3 blocks	number of turnovers (over a season) of player kobe bryant whose number of blocks (over a season) is 3
how many rebounds did kobe bryant make	number of rebounds (over a season) of player kobe bryant whose number of turnovers (over a season) is 3
how many turnovers does kobe bryant have over all seasons	number of turnovers (over a season) of player kobe bryant whose number of assists (over a season) is 3
what team did kobe bryant have 3 turnovers on	team of player kobe bryant whose number of turnovers (over a season) is 3
player with more rebounds over a season than that of player kobe bryant over a season	player whose number of rebounds (over a season) is larger than number of rebounds (over a season) of player kobe bryant
what player scored equal or less points as kobe bryant	player whose number of points (over a season) is at least number of points (over a season) of player kobe bryant
name the number of turnovers achieved by kobe bryant in 2004	number of turnovers (over a season) of player kobe bryant whose season is 2004
who had at least as many fouls as kobe bryant in a season	player whose number of fouls (over a season) is at least number of fouls (over a season) of player kobe bryant
player with more than 3 blocks over a season	player whose number of blocks (over a season) is larger than 3
how many rebounds did kboe bryant have when he had 3 points	number of rebounds (over a season) of player kobe bryant whose number of points (over a season) is 3
player who has maximum two team	player that has at most two team
what is the points kob bryant scored in season 2004	number of points (over a season) of player kobe bryant whose season is 2004
what season did kobe bryant have 3 fouls	season of player kobe bryant whose number of fouls (over a season) is 3
during the season in which he had 3 steals how many rebounds was kobe bryant responsible for	number of rebounds (over a season) of player kobe bryant whose number of steals (over a season) is 3
how many fouls has kobe bryant averaged per season as a laker	number of fouls (over a season) of player kobe bryant whose team is los angeles lakers
how many steals did kobe bryant have when he had 3 blocks	number of steals (over a season) of player kobe bryant whose number of blocks (over a season) is 3
who plays on the same team as kobe bryant	player whose team is team of player kobe bryant
what player did not score 3 rebounds	player whose number of rebounds (over a season) is not 3
which player does not have 3 steals	player whose number of steals (over a season) is not 3
how many rebounds in a season did kobe bryant have	number of rebounds (over a season) of player kobe bryant
which players have committed 3 or more fouls in a season	player whose number of fouls (over a season) is at least 3
how many turnovers has kobe bryant made in 3 games	number of turnovers (over a season) of player kobe bryant whose number of played games (over a season) is 3
team of player kobe bryant who is at point guard	team of player kobe bryant whose position is point guard
in which year did kobe bryant have three steals	season of player kobe bryant whose number of steals (over a season) is 3
which player had as many rebounds as kobe bryant in a season	player whose number of rebounds (over a season) is number of rebounds (over a season) of player kobe bryant
how many assists did kobe bryant make in a season with steals over 3	number of assists (over a season) of player kobe bryant whose number of steals (over a season) is 3
who has a total foul count under 3 for the season	player whose number of fouls (over a season) is smaller than 3
how many rebounds does kobe bryant make by the time hes got 3 points in a season	number of rebounds (over a season) of player kobe bryant whose number of points (over a season) is 3
during which seasons did kobe bryant make 3 blocks	season of player kobe bryant whose number of blocks (over a season) is 3
players that player more games in a season than that of kobe bryant	player whose number of played games (over a season) is larger than number of played games (over a season) of player kobe bryant
how many blocks did kobe bryant have over  the season	number of blocks (over a season) of player kobe bryant
who did kobe bryant play for when he had 3 all season rebounds	team of player kobe bryant whose number of rebounds (over a season) is 3
how many steals does kobe bryant get in a season when hes got 3 points	number of steals (over a season) of player kobe bryant whose number of points (over a season) is 3
players who do not have three steals over the course of a season	player whose number of steals (over a season) is not 3
players with the most steals in a season	player that has the largest number of steals (over a season)
what team did kobe bryant play for	team of player kobe bryant whose number of played games (over a season) is 3
how many asists kob bryant made over a season in which he made 3 turnovers	number of assists (over a season) of player kobe bryant whose number of turnovers (over a season) is 3
number of played games over a season of player kobe bryant who has played 3 games over a season	number of played games (over a season) of player kobe bryant whose number of played games (over a season) is 3
how many games did kobebryant play making 3 fouls	number of played games (over a season) of player kobe bryant whose number of fouls (over a season) is 3
in what season did kobe bryant score a total of 3 assists	season of player kobe bryant whose number of assists (over a season) is 3
number of turnovers over a season of player kobe bryant from season 2004	number of turnovers (over a season) of player kobe bryant whose season is 2004
steals by kobe bryant over all seasons with 3 or more points	number of steals (over a season) of player kobe bryant whose number of points (over a season) is 3
how many turnovers does kobe bryant have in a season he has 3 rebounds	number of turnovers (over a season) of player kobe bryant whose number of rebounds (over a season) is 3
during the season in which he had 3 turnovers what team was kobe bryant on	team of player kobe bryant whose number of turnovers (over a season) is 3
which players play no more than two positions	player that has at most two position
for which team kob bryant made 3 assists over a season	team of player kobe bryant whose number of assists (over a season) is 3
what players had more points than kobe bryant in 2004	number of points (over a season) of player kobe bryant whose season is 2004
what player had more than 3 assists	player whose number of assists (over a season) is larger than 3
how many blocks has kobe bryant made playing point guard	number of blocks (over a season) of player kobe bryant whose position is point guard
name someone with more games per season played than kobe bryant	player whose number of played games (over a season) is larger than number of played games (over a season) of player kobe bryant
player with more played games in a season than kobe bryant	player whose number of played games (over a season) is larger than number of played games (over a season) of player kobe bryant
kobe bryants number of games played the season he had 3 rebounds	number of played games (over a season) of player kobe bryant whose number of rebounds (over a season) is 3
kobe bryant had 3 rebounds	number of rebounds (over a season) of player kobe bryant whose number of rebounds (over a season) is 3
player who has minimum number of teams	player that has the least number of team
find those players responsible for 3 or less fouls in any one given season	player whose number of fouls (over a season) is at most 3
how many assists did kobe bryant make during a season	number of assists (over a season) of player kobe bryant whose number of blocks (over a season) is 3
which players have had the least amount of turnovers in any one particular season	player that has the smallest number of turnovers (over a season)
name the player with the most blocks during the season	player that has the largest number of blocks (over a season)
player whose number of blocks over a season is less than that of player kobe bryant over a season	player whose number of blocks (over a season) is smaller than number of blocks (over a season) of player kobe bryant
how many blocks did kobe bryant have when he had 3 points	number of blocks (over a season) of player kobe bryant whose number of points (over a season) is 3
how many turnovers did kobe bryant make in an allseason total of 3 games	number of turnovers (over a season) of player kobe bryant whose number of played games (over a season) is 3
during his season playing point guard how many assists was bryant kobe responsible for	number of assists (over a season) of player kobe bryant whose position is point guard
in the season in which he made 3 steals how many games was kobe bryant in	number of played games (over a season) of player kobe bryant whose number of steals (over a season) is 3
what player had 3 or more assists	player whose number of assists (over a season) is at least 3
how many rebounds did kobe get after playing 3 fouls	number of rebounds (over a season) of player kobe bryant whose number of fouls (over a season) is 3
what is number of the player	number of player
how many fouls did kobe bryant have on the los angeles lakers	number of fouls (over a season) of player kobe bryant whose team is los angeles lakers
how many games did kobe bryant play in the 2004 season	number of played games (over a season) of player kobe bryant whose season is 2004
what players made more points than kob bryant over a season	player whose number of points (over a season) is larger than number of points (over a season) of player kobe bryant
how many rebounds did la laker player kobe bryant have	number of rebounds (over a season) of player kobe bryant whose team is los angeles lakers
who has had more steals than kobe bryant	player whose number of steals (over a season) is larger than number of steals (over a season) of player kobe bryant
player who never played 3 games over a season	player whose number of played games (over a season) is not 3
what players had more than three fouls over a season	player whose number of fouls (over a season) is larger than 3
what players have had more blocks than kobe bryant	player whose number of blocks (over a season) is larger than number of blocks (over a season) of player kobe bryant
how many fouls were played by kobe bryant after 3 turnovers	number of fouls (over a season) of player kobe bryant whose number of turnovers (over a season) is 3
how many different positions are there	number of position
which player did not score 3 points	player whose number of points (over a season) is not 3
what players played games same as the least number of games played by kobe bryant over a season	player whose number of played games (over a season) is at least number of played games (over a season) of player kobe bryant
how many turnovers did kobebryant get	number of turnovers (over a season) of player kobe bryant
which player has as many fouls as kobe bryant	player whose number of fouls (over a season) is number of fouls (over a season) of player kobe bryant
which player has had the fewest fouls	player that has the smallest number of fouls (over a season)
players that have the same number of fouls as kobe bryant over all seasons	player whose number of fouls (over a season) is at least number of fouls (over a season) of player kobe bryant
how many fouls did kobe bryant have when he had 3 turnovers	number of fouls (over a season) of player kobe bryant whose number of turnovers (over a season) is 3
what player had the most fouls this season	player that has the largest number of fouls (over a season)
98019705layers with the fewest turnovers per game during the season	player that has the smallest number of turnovers (over a season)
how many blocks kob bryant made over a season	number of blocks (over a season) of player kobe bryant
how many games did kobe bryant play in the year he had three fouls	number of played games (over a season) of player kobe bryant whose number of fouls (over a season) is 3
what player had less than 3 blocks allseason	player whose number of blocks (over a season) is smaller than 3
what players made more than 2 points over a season	player whose number of points (over a season) is at least 3
player with most number of fouls over a season	player that has the largest number of fouls (over a season)
how many blocks does kobe bryant have in a season with at least 3 turnovers	number of blocks (over a season) of player kobe bryant whose number of turnovers (over a season) is 3
how many rebounds kob bryant made over a season in which he made 3 fouls	number of rebounds (over a season) of player kobe bryant whose number of fouls (over a season) is 3
find the player who made the same or a lesser number of assists in the same season as kobe bryant	player whose number of assists (over a season) is at most number of assists (over a season) of player kobe bryant
players with greater than three blocks in a season	player whose number of blocks (over a season) is larger than 3
how many points does kobe bryant get per season	number of points (over a season) of player kobe bryant whose number of points (over a season) is 3
player who has played largest numbergames over a season	player that has the largest number of played games (over a season)
what players had more 3 or more turnovers in a game	player whose number of turnovers (over a season) is at least 3
which player has scored lesser points than kobe bryant	player whose number of points (over a season) is smaller than number of points (over a season) of player kobe bryant
how many games did kobe bryant play where he had more than 3 fouls	number of played games (over a season) of player kobe bryant whose number of fouls (over a season) is 3
what team will kobe bryant be on this year	team of player kobe bryant whose number of played games (over a season) is 3
how many blocks were made by kobe bryant in 3 games	number of blocks (over a season) of player kobe bryant whose number of played games (over a season) is 3
which player doesnt average over 3 assists per game	player whose number of assists (over a season) is not 3
how many games did kobe bryant play where he made three assists	number of played games (over a season) of player kobe bryant whose number of assists (over a season) is 3
name a player who had at least three fouls in the season	player whose number of fouls (over a season) is at least 3
what team is kobe bryant on	team of player kobe bryant
number of fouls over a season of player kobe bryant who is at point guard	number of fouls (over a season) of player kobe bryant whose position is point guard
what player had the least assists this season	player that has the smallest number of assists (over a season)
which players played in the 2004 or 2010 seasons	player whose season is 2004 or 2010
which team was kobe bryant on when he had 3 blocks in a season	team of player kobe bryant whose number of blocks (over a season) is 3
how many turnovers did kobe bryant have during the season	number of turnovers (over a season) of player kobe bryant whose number of turnovers (over a season) is 3
how many players have been on the lakers or cavaliers	player whose team is los angeles lakers or cleveland cavaliers
are there players whose total tally of assists is less than the tallly of assists acquired by kobe bryant in the same season	player whose number of assists (over a season) is smaller than number of assists (over a season) of player kobe bryant
how many fouls does kobe bryant average in seasons limited to 3 rebounds	number of assists (over a season) of player kobe bryant whose number of rebounds (over a season) is 3
who has at most 3 assists total in a season	player whose number of assists (over a season) is at most 3
what player has the fewest allseason turnovers	player that has the smallest number of turnovers (over a season)
how many assists did kobe bryant get after playing 3 fouls	number of assists (over a season) of player kobe bryant whose number of fouls (over a season) is 3
which players played in the same season as kobe bryant	player whose season is season of player kobe bryant
which player had a maximum of 3 assists	player whose number of assists (over a season) is at most 3
which players are on the same team as kobe bryant	player whose team is team of player kobe bryant
name those players with blocks to their credit that tally less than 3 or more than 3	player whose number of blocks (over a season) is not 3
player who has most rebounds over a season	player that has the largest number of rebounds (over a season)
a player that has played for no more than two teams	player that has at most two team
name a player with fewer than three steals	player whose number of steals (over a season) is smaller than 3
number of assists over a season of player kobe bryant whose team is los angeles lakers	number of assists (over a season) of player kobe bryant whose team is los angeles lakers
player who has played more games over a season player kobe bryant has played over a season	player whose number of played games (over a season) is at least number of played games (over a season) of player kobe bryant
how many all season rebounds did kobe bryant have	number of rebounds (over a season) of player kobe bryant
name a player with fewer turnovers during the season than kobe bryant	player whose number of turnovers (over a season) is smaller than number of turnovers (over a season) of player kobe bryant
whats the number of assists kobe bryant gets in a season when hes got 3 or more blocks	number of assists (over a season) of player kobe bryant whose number of blocks (over a season) is 3
how many blocks does kobe bryant usually make if hes already got 3	number of blocks (over a season) of player kobe bryant whose number of blocks (over a season) is 3
how many turnovers did kobe bryant get after getting 3 steals	number of turnovers (over a season) of player kobe bryant whose number of steals (over a season) is 3
what is the position of player kobe bryant with 3 rebounds over this season	position of player kobe bryant whose number of rebounds (over a season) is 3
what was the total number of blocks in a season for kobe bryant when he had three assists	number of blocks (over a season) of player kobe bryant whose number of assists (over a season) is 3
what was the total number of assist in a season for kobe bryant when he had 3 steals	number of assists (over a season) of player kobe bryant whose number of steals (over a season) is 3
how many fouls kob bryant made in the season in which he made 3 rebounds	number of fouls (over a season) of player kobe bryant whose number of rebounds (over a season) is 3
what player has 3 allseason rebounds maximum	player whose number of rebounds (over a season) is at most 3
what player played more games than kobe bryant this season	player whose number of played games (over a season) is larger than number of played games (over a season) of player kobe bryant
what player had more blocks than kobe bryant whose number of assists is 3	number of blocks (over a season) of player kobe bryant whose number of assists (over a season) is 3
what player had at least as many blocks in the season as kobe bryant	player whose number of blocks (over a season) is at least number of blocks (over a season) of player kobe bryant
what player played less than 4 games over a season	player whose number of played games (over a season) is at most 3
how many rebounds did kobe bryant have after 3 games	number of rebounds (over a season) of player kobe bryant whose number of played games (over a season) is 3
what player has no less than 3 all season assists	player whose number of assists (over a season) is at least 3
how many assists did kobe get after scoring 3 points	number of assists (over a season) of player kobe bryant whose number of points (over a season) is 3
how many assists did kobe bryant have while playing point guard	number of assists (over a season) of player kobe bryant whose position is point guard
in the season in which kobe bryant played 3 games how many turnovers did he have	number of turnovers (over a season) of player kobe bryant whose number of played games (over a season) is 3
how many fouls in a season has point guard kobe bryant had	number of fouls (over a season) of player kobe bryant whose position is point guard
which player had at least three steals	player whose number of steals (over a season) is at least 3
player whose number of points over a season is not less  than that of player kobe bryantover a season	player whose number of points (over a season) is at least number of points (over a season) of player kobe bryant
what was the team of kobe bryant  in 2004	team of player kobe bryant whose season is 2004
how many blocks kob bryant made over a season in which he made 3 fouls	number of blocks (over a season) of player kobe bryant whose number of fouls (over a season) is 3
name the player with fewer than three assists	player whose number of assists (over a season) is smaller than 3
what player has less rebounds than kobe bryant	player whose number of rebounds (over a season) is smaller than number of rebounds (over a season) of player kobe bryant
what team did kobe bryant play for when he had three blocks during a single season	team of player kobe bryant whose number of blocks (over a season) is 3
how many blocks did kobe bryant have this season	number of blocks (over a season) of player kobe bryant
what player had more blocks than kobe bryant whose number of points is 3	number of points (over a season) of player kobe bryant whose number of points (over a season) is 3
which player has played the fewest positions	player that has the least number of position
player who is not a los angleles laker	player whose team is not los angeles lakers
how many points did kobe bryant aquire over the entire season	number of points (over a season) of player kobe bryant
how many points does kobe bryant get in seasons with 3 assists	number of points (over a season) of player kobe bryant whose number of assists (over a season) is 3
the player who made most fouls over a season	player that has the largest number of fouls (over a season)
during the season in which he played in 3 games total what position was kobe bryant playing	position of player kobe bryant whose number of played games (over a season) is 3
which player has had the most rebounds in a season	player that has the largest number of rebounds (over a season)
what player has more or less than 3 all season rebounds	player whose number of rebounds (over a season) is not 3
how many blocks did kobe bryant have in a season he had 3 points	number of blocks (over a season) of player kobe bryant whose number of points (over a season) is 3
how many games did kobe bryant play during the season his total number of blocks equaled 3	number of played games (over a season) of player kobe bryant whose number of blocks (over a season) is 3
in which season did kobe bryant have 3 turnovers	season of player kobe bryant whose number of turnovers (over a season) is 3
who has 3 or more steals in a season	player whose number of steals (over a season) is at least 3
who has had the most turnovers	player that has the largest number of turnovers (over a season)
what player has had more or less fouls than 3 over a season	player whose number of fouls (over a season) is not 3
number of assists over a season of player kobe bryant whoplayed 3 games over a season	number of assists (over a season) of player kobe bryant whose number of played games (over a season) is 3
players whose number of turnovers in a season is no more than that of kobe byrant	player whose number of turnovers (over a season) is at most number of turnovers (over a season) of player kobe bryant
which player had the same number of points in the season as kobe bryant	player whose number of points (over a season) is number of points (over a season) of player kobe bryant
what players hold two or less positions	player that has less than two position
which player played more than 3 fouls	player whose number of fouls (over a season) is larger than 3
player with assists over a season not less than that of player kobe bryant	player whose number of assists (over a season) is at least number of assists (over a season) of player kobe bryant
fouls by kobe bryant in 2004	number of fouls (over a season) of player kobe bryant whose season is 2004
what position does kobe bryant play who had three fouls in the season	position of player kobe bryant whose number of fouls (over a season) is 3
how many blocks kob bryant made in the season 2004	number of rebounds (over a season) of player kobe bryant whose season is 2004
how many blocks does kobe bryant make in seasons with only 3 fouls against him	number of blocks (over a season) of player kobe bryant whose number of fouls (over a season) is 3
mention the points scored by player kobe bryant who has had 3 rebounds over this season	number of points (over a season) of player kobe bryant whose number of rebounds (over a season) is 3
what player has fewer per season assists than  point guard kobe bryant	player whose number of assists (over a season) is smaller than number of assists (over a season) of player kobe bryant
players that overall outrebounded kobe bryant during the season	player whose number of rebounds (over a season) is larger than number of rebounds (over a season) of player kobe bryant
number of steals over a season of player kobe bryant with 3 blocks over a season	number of steals (over a season) of player kobe bryant whose number of blocks (over a season) is 3
who has had less than 3 turnovers	player whose number of turnovers (over a season) is smaller than 3
who had less than or equal to 3 points	player whose number of points (over a season) is at most 3
find the player with assists to his credit for any one season  tallying more than the total number of assists performed by kobe bryant in any one season	player whose number of assists (over a season) is larger than number of assists (over a season) of player kobe bryant
how many blocks did kobe bryant have all season when he had 3 turnovers	number of blocks (over a season) of player kobe bryant whose number of turnovers (over a season) is 3
which player has the same position as kobe bryant	player whose position is position of player kobe bryant
how many steals did point guard kobe bryant have over the season	number of steals (over a season) of player kobe bryant whose position is point guard
how many steals did kobe bryant have after 3 games	number of steals (over a season) of player kobe bryant whose number of played games (over a season) is 3
player whose number of points over a season is same as that of player kobe bryantcover a season	player whose number of points (over a season) is number of points (over a season) of player kobe bryant
find those players who made more than 3 steals in a given season	player whose number of steals (over a season) is larger than 3
what player has more than 3 rebounds in every season	player whose number of rebounds (over a season) is larger than 3
in what year did kobe bryant play three games	number of played games (over a season) of player kobe bryant whose number of played games (over a season) is 3
how many points did kobe bryant score in three played games	number of points (over a season) of player kobe bryant whose number of played games (over a season) is 3
what player had 3 or more steals this season	player whose number of steals (over a season) is at least 3
number of steals over a season of player kobe bryant with 3 points over a season	number of steals (over a season) of player kobe bryant whose number of points (over a season) is 3
how many points has kobe bryant scored this season	number of points (over a season) of player kobe bryant
how many seasons has kobe bryant broken 3 turnovers	season of player kobe bryant whose number of turnovers (over a season) is 3
number of rebounds over a season of player kobe bryant from los angeles lakers team	number of rebounds (over a season) of player kobe bryant whose team is los angeles lakers
players that have more than 3 turnovers over all seasons	player whose number of turnovers (over a season) is larger than 3
which team did kobe bryant play for when he had only three rebounds in a season	team of player kobe bryant whose number of rebounds (over a season) is 3
how many rebounds did kobe bryant have over a season	number of rebounds (over a season) of player kobe bryant whose team is los angeles lakers
how many rebounds did kobe bryant have this season	number of rebounds (over a season) of player kobe bryant
how many points were scored by kobe bryant	number of points (over a season) of player kobe bryant
during the same season that he participated in 3 games name the number of fouls committed by kobe bryant	number of fouls (over a season) of player kobe bryant whose number of played games (over a season) is 3
how many games was kobe bryant in during the season that he played with the los angeles lakers	number of played games (over a season) of player kobe bryant whose team is los angeles lakers
which player has no more than three steals	player whose number of steals (over a season) is at most 3
how many fouls were played by kobebryant	number of fouls (over a season) of player kobe bryant
what position does kobe bryant play in his best scoring seasons	position of player kobe bryant whose number of points (over a season) is 3
who has played 3 or less games	player whose number of played games (over a season) is at most 3
who has the same per season blocks as kobe bryant	player whose number of blocks (over a season) is number of blocks (over a season) of player kobe bryant
how many fouls were played by kobe bryant after getting 3 steals	number of fouls (over a season) of player kobe bryant whose number of steals (over a season) is 3
which player played in 2004 or 2010	player whose season is 2004 or 2010
what seasons did kobe bryant play point guard	season of player kobe bryant whose position is point guard
how many fouls did kobe bryant make in 2004	number of fouls (over a season) of player kobe bryant whose season is 2004
whos a player with less points per season than kobe bryant	player whose number of points (over a season) is smaller than number of points (over a season) of player kobe bryant
how many points has kobe bryant gotten this season	number of points (over a season) of player kobe bryant whose number of played games (over a season) is 3
how many all season points did kobe bryant have as point guard	number of points (over a season) of player kobe bryant whose position is point guard
player not with 3 blocks over a season	player whose number of blocks (over a season) is not 3
how many games has kobe been in since he went pro	number of played games (over a season) of player kobe bryant whose number of fouls (over a season) is 3
player with more steals over a season than that of player kobe bryant over a season	player whose number of steals (over a season) is larger than number of steals (over a season) of player kobe bryant
who has had more than 3 turnovers	player whose number of turnovers (over a season) is larger than 3
how many turnovers has kobe bryant had over all seasons	number of turnovers (over a season) of player kobe bryant
what team did kobe bryant play on when he had 3 assists	team of player kobe bryant whose number of assists (over a season) is 3
find players who have point scores for any one season of no more than 3	player whose number of points (over a season) is at most 3
which player had at least 3 turnovers in a season	player whose number of turnovers (over a season) is at least 3
what team did kobe bryant play for when he had 3 blocks	team of player kobe bryant whose number of blocks (over a season) is 3
what team did kobe bryant play when he made 3 rebounds over the season	team of player kobe bryant whose number of rebounds (over a season) is 3
what player had as many blocks as kobe bryant over as season	player whose number of blocks (over a season) is number of blocks (over a season) of player kobe bryant
which player has not had three rebounds in a season	player whose number of rebounds (over a season) is not 3
what players made blocks same as maximum blocks by kobe bryant over a season	player whose number of blocks (over a season) is at most number of blocks (over a season) of player kobe bryant
in how many games has kobe bryant made 3 blocks	number of played games (over a season) of player kobe bryant whose number of blocks (over a season) is 3
number of blocks over a season of player kobe bryant who is at point guard	number of blocks (over a season) of player kobe bryant whose position is point guard
what player has lesser assists than kob bryant	player whose number of assists (over a season) is smaller than number of assists (over a season) of player kobe bryant
which players have as many rebounds as kobe bryant over a season	player whose number of rebounds (over a season) is at least number of rebounds (over a season) of player kobe bryant
number of assists over a season of player kobe bryant with 3 fouls over a season	number of assists (over a season) of player kobe bryant whose number of fouls (over a season) is 3
which player had no more turnovers in a season than kobe bryant	player whose number of turnovers (over a season) is at most number of turnovers (over a season) of player kobe bryant
how any steals did kobe bryant get	number of steals (over a season) of player kobe bryant
what was the position of kobe bryant when he played 3 fouls	position of player kobe bryant whose number of fouls (over a season) is 3
players that average at least three assists per game over a season	player whose number of assists (over a season) is at least 3
how many career turnovers has kobe bryant has	number of turnovers (over a season) of player kobe bryant whose number of fouls (over a season) is 3
which team did kobe bryant play as point guard	team of player kobe bryant whose position is point guard
name the total points of kobe bryant over the season and note the comparisonn to the player whose total number of blocks throughout the season was 3	number of points (over a season) of player kobe bryant whose number of blocks (over a season) is 3
how many fouls were played by kobe bryant when he scored 3 points	number of fouls (over a season) of player kobe bryant whose number of points (over a season) is 3
how many players are there	number of player
find the number of blocks in the season in which kobe bryant  also acquired 3 steals	number of blocks (over a season) of player kobe bryant whose number of steals (over a season) is 3
how many games did kobe bryant play where he made three blocks	number of blocks (over a season) of player kobe bryant whose number of blocks (over a season) is 3
who has had less than 3 assists	player whose number of assists (over a season) is smaller than 3
who were kobe bryants team mates	player whose team is team of player kobe bryant
what teams did kobe bryant play on as point guard	team of player kobe bryant whose position is point guard
which player had no more than three blocks	player whose number of blocks (over a season) is at most 3
what players made less turnovers than kob bryant over a season	player whose number of turnovers (over a season) is smaller than number of turnovers (over a season) of player kobe bryant
how many points did kobe bryant score when he had three rebounds	number of points (over a season) of player kobe bryant whose number of rebounds (over a season) is 3
what player has at least as many all season points as kobe bryant	player whose number of points (over a season) is at least number of points (over a season) of player kobe bryant
who has the same number of rebounds as kobe bryant	player whose number of rebounds (over a season) is number of rebounds (over a season) of player kobe bryant
player with less than 3 turnovers in a season	player whose number of turnovers (over a season) is smaller than 3
what player scored fewer than 3 points in a season	player whose number of points (over a season) is smaller than 3
what is kobe bryants team	team of player kobe bryant
what player made more than 3 block over a season	player whose number of blocks (over a season) is larger than 3
how many steals did kobe get after getting 3 assists	number of steals (over a season) of player kobe bryant whose number of assists (over a season) is 3
who gets no more fouls each year than kobe bryant	player whose number of fouls (over a season) is at most number of fouls (over a season) of player kobe bryant
the player with least blocks over a season	player that has the smallest number of blocks (over a season)
who has played more than 3 games	player whose number of played games (over a season) is larger than 3
which players are point guard or forward	player whose position is point guard or forward
which player had more than three fouls in the season	player whose number of fouls (over a season) is larger than 3
how many turnovers  did kobe bryant get after he made 3 blocks	number of turnovers (over a season) of player kobe bryant whose number of blocks (over a season) is 3
which plater made the least amount of blocks during the season	player that has the smallest number of blocks (over a season)
how many did kobe bryant play so far this year	number of played games (over a season) of player kobe bryant
what player had the least fouls this season	player that has the smallest number of fouls (over a season)
how many games kob bryant played over a season in which he made 3 points	number of played games (over a season) of player kobe bryant whose number of points (over a season) is 3
what players have played for fewer than two teams	player that has less than two team
what players has the most points over all seasons	player that has the largest number of points (over a season)
how many points did kobe bryant score when he averaged 3 assists per game over the season	number of points (over a season) of player kobe bryant whose number of assists (over a season) is 3
what position did kobe bryant get 3 steals as	position of player kobe bryant whose number of steals (over a season) is 3
what season did kobe bryant get 3 assists	season of player kobe bryant whose number of assists (over a season) is 3
what players made more than 3 fouls over a season	player whose number of fouls (over a season) is larger than 3
who has the most rebounds	player that has the largest number of rebounds (over a season)
what players has less than 3 allseason fouls	player whose number of fouls (over a season) is smaller than 3
how many points did kobe bryant score as point guard	number of points (over a season) of player kobe bryant whose position is point guard
how many assists does kobe bryant have over all seasons	number of assists (over a season) of player kobe bryant whose number of played games (over a season) is 3
which player had at least three assists last season	player whose number of assists (over a season) is at least 3
in which season did kobe bryant get 3 rebounds	season of player kobe bryant whose number of rebounds (over a season) is 3
how many allseason points did kobe bryant score when rebounds equaled 3	number of points (over a season) of player kobe bryant whose number of rebounds (over a season) is 3
number of assists over a season of player kobe bryant from season 2004	number of assists (over a season) of player kobe bryant whose season is 2004
players that played for either one or two nba teams	player that has at most two team
which season did kobe bryant average over 3 steals a game	season of player kobe bryant whose number of steals (over a season) is 3
what player had 3 or less assists this season	player whose number of assists (over a season) is at most 3
find the player responsible for the biggest number of steals in any one season	player that has the largest number of steals (over a season)
what player scored more than 3 points	player whose number of points (over a season) is larger than 3
what players have had the same or more blocks than kobe bryant	player whose number of blocks (over a season) is at least number of blocks (over a season) of player kobe bryant
how many allseason assists did kobe bryant have along with 3 allseason blocks	number of assists (over a season) of player kobe bryant whose number of blocks (over a season) is 3
name a player with fewer blocks than kobe bryant	player whose number of blocks (over a season) is smaller than number of blocks (over a season) of player kobe bryant
how many rebounds does kobe bryant make per season	number of rebounds (over a season) of player kobe bryant whose number of assists (over a season) is 3
which player has more rebounds per season than kobe bryant	player whose number of rebounds (over a season) is larger than number of rebounds (over a season) of player kobe bryant
players that scored the same or fewer points than kobe during the season	player whose number of points (over a season) is at most number of points (over a season) of player kobe bryant
what player has the lowest amount of rebounds in a season	player that has the smallest number of rebounds (over a season)
which players are not point guards	player whose position is not point guard
players with a total number of steals in a season that is equal to the lowest number of steals in a season for kobe bryant	player whose number of steals (over a season) is at least number of steals (over a season) of player kobe bryant
player who has not played 3 games over a season	player whose number of played games (over a season) is not 3
player whose fouls are not 3 over a season	player whose number of fouls (over a season) is not 3
how many assists did kobe bryant have with three blocks	number of assists (over a season) of player kobe bryant whose number of blocks (over a season) is 3
who has played less games than kobe bryant	player whose number of played games (over a season) is smaller than number of played games (over a season) of player kobe bryant
during the season he scored he 3 points what was the number of fouls kobe bryant was responsible for	number of fouls (over a season) of player kobe bryant whose number of points (over a season) is 3
how many games did kobe bryant play as point guart during a season	number of played games (over a season) of player kobe bryant whose position is point guard
what player had 3 or less blocks this season	player whose number of blocks (over a season) is at most 3
what players had more that three steals over all seasons	player whose number of steals (over a season) is larger than 3
which player had the most career blocks per season	player that has the largest number of blocks (over a season)
player with the same or fewer blocks per season as kobe bryant	player whose number of blocks (over a season) is at most number of blocks (over a season) of player kobe bryant
what player had 3 or less steals this season	player whose number of steals (over a season) is at most 3
which player does not have3 rebounds	player whose number of rebounds (over a season) is not 3
how many blocks did kobe bryant make after getting 3 steals	number of blocks (over a season) of player kobe bryant whose number of steals (over a season) is 3
how many fouls did kobe have last season	number of fouls (over a season) of player kobe bryant
how many games kob bryant played in point guard position over a season	number of played games (over a season) of player kobe bryant whose position is point guard
players that had were outrebounded by	player whose number of rebounds (over a season) is smaller than number of rebounds (over a season) of player kobe bryant
how many fouls did kobe bryant have during the season	number of fouls (over a season) of player kobe bryant
how many blocks has kobe bryant made in seasons with exactly 3 assists	number of blocks (over a season) of player kobe bryant whose number of assists (over a season) is 3
whats kobe bryants season turnover average	number of turnovers (over a season) of player kobe bryant
what player has no less than 3 allseason steals	player whose number of steals (over a season) is at least 3
how many fouls in a single season did kobe bryant have that is greater than three assists	number of steals (over a season) of player kobe bryant whose number of assists (over a season) is 3
which player had the same number of fouls as kobe bryant	player whose number of fouls (over a season) is number of fouls (over a season) of player kobe bryant
how many blocks were made by kobe bryant in 2004	number of blocks (over a season) of player kobe bryant whose season is 2004
who has the least fouls	player that has the smallest number of fouls (over a season)
who has played at least 3 games in a season	player whose number of played games (over a season) is at least 3
how many steals does kobe bryant get in a season	number of steals (over a season) of player kobe bryant whose number of fouls (over a season) is 3
what players have had 3 or less rebounds	player whose number of rebounds (over a season) is at most 3
what position was kobe bryant playing when he has 3 rebounds over a full season	position of player kobe bryant whose number of rebounds (over a season) is 3
find the player with the highest number of blocks to his credit in any one season	player that has the largest number of blocks (over a season)
how many fouls did kobe average in his three point total games over the season	number of fouls (over a season) of player kobe bryant whose number of turnovers (over a season) is 3
who plays for either la lakers or cleveland cavaliers	player whose team is los angeles lakers or cleveland cavaliers
kobe bryant with three assists had how many rebounds	number of rebounds (over a season) of player kobe bryant whose number of assists (over a season) is 3
how many points kob bryant made over a season in which he made 3 assists	number of points (over a season) of player kobe bryant whose number of assists (over a season) is 3
how many turnovers has kobe bryant played	number of turnovers (over a season) of player kobe bryant
what position did kobe bryant play for the los angeles lakers	position of player kobe bryant whose team is los angeles lakers
who has played more games in a season than kobe bryant	player whose number of played games (over a season) is larger than number of played games (over a season) of player kobe bryant
in which season did kobe bryant commit 3 fouls	season of player kobe bryant whose number of fouls (over a season) is 3
how many games did kobe bryant play for the los angeles lakers	number of played games (over a season) of player kobe bryant whose team is los angeles lakers
how many allseason blocks did kobe bryant have as an la laker	number of blocks (over a season) of player kobe bryant whose team is los angeles lakers
this is the season of player kobe bryant who has played 3 games	season of player kobe bryant whose number of played games (over a season) is 3
number of played games over a season of player kobe bryant who has 3 steals over a season	number of played games (over a season) of player kobe bryant whose number of steals (over a season) is 3
what players are point guards or forwards	player whose position is point guard or forward
what player has the fewest all season fouls	player that has the smallest number of fouls (over a season)
how many turnovers did kobe bryant have when he had 3 points	number of turnovers (over a season) of player kobe bryant whose number of points (over a season) is 3
how many blocks kob bryant made in the season in which he played 3 games	number of blocks (over a season) of player kobe bryant whose number of played games (over a season) is 3
how many rebounds did kobe bryant who had three steals have	number of rebounds (over a season) of player kobe bryant whose number of steals (over a season) is 3
what players all season assists totaled at least as many as kobe bryants	player whose number of assists (over a season) is at least number of assists (over a season) of player kobe bryant
how many points did kobe bryant score in the season that he had three steals	number of points (over a season) of player kobe bryant whose number of steals (over a season) is 3
how many games has kobe bryant played in the last 3 seasons	number of played games (over a season) of player kobe bryant whose number of played games (over a season) is 3
name players who are not in los angeles lakers	player whose team is not los angeles lakers
which player has more than 3 turnovers in each season theyve played	player whose number of turnovers (over a season) is larger than 3
how many blocks did kobe bryant have in three games of the season	number of blocks (over a season) of player kobe bryant whose number of played games (over a season) is 3
this is considered the season of player kobe bryant with 3 blocks	season of player kobe bryant whose number of blocks (over a season) is 3
how many games in a season did kobe bryant play where he had 3 fouls	number of played games (over a season) of player kobe bryant whose number of fouls (over a season) is 3
what player did not have 3 steals	player whose number of steals (over a season) is not 3
what was the total number of rebounds of kobe bryant in season where he only had three blocks	number of rebounds (over a season) of player kobe bryant whose number of blocks (over a season) is 3
how many turnovers did kobe when playing with three fouls over the season	number of turnovers (over a season) of player kobe bryant whose number of fouls (over a season) is 3
who has played 3 or more games	player whose number of played games (over a season) is at least 3
name the number of assists attributable to kobe bryant during a season	number of assists (over a season) of player kobe bryant
who has had the most blocks in a season	player that has the largest number of blocks (over a season)
which position has kobe made more than 3 steals from	position of player kobe bryant whose number of steals (over a season) is 3
how many fouls did kobe bryant have after 3 games	number of fouls (over a season) of player kobe bryant whose number of played games (over a season) is 3
season of player kobe bryant who has 3 rebounds over a season	season of player kobe bryant whose number of rebounds (over a season) is 3
which player has played in the fewest games in a season	player that has the smallest number of played games (over a season)
how many turnovers did kobe bryant make over the season where he made 3 steals	number of turnovers (over a season) of player kobe bryant whose number of steals (over a season) is 3
what player has the same amount of turnovers as kobe bryant over a season	player whose number of turnovers (over a season) is number of turnovers (over a season) of player kobe bryant
what team did kobe bryant get 3 rebounds in	team of player kobe bryant whose number of rebounds (over a season) is 3
in what position was kobe able to get 3 assists	position of player kobe bryant whose number of assists (over a season) is 3
whats the name of a player with less turnovers per season than kobe bryant	player whose number of turnovers (over a season) is smaller than number of turnovers (over a season) of player kobe bryant
which player doesnt have 3 assists	player whose number of assists (over a season) is not 3
what player had less than 3 points	player whose number of points (over a season) is smaller than 3
players that did not play in 2004	player whose season is not 2004
number of fouls over a season of player kobe bryant from los angeles lakers team	number of fouls (over a season) of player kobe bryant whose team is los angeles lakers
whos got the least turnovers so far this season	player that has the smallest number of turnovers (over a season)
what year did kobe bryants points total three	season of player kobe bryant whose number of points (over a season) is 3
who has had less than or the same number of turnovers as kobe bryant	player whose number of turnovers (over a season) is at most number of turnovers (over a season) of player kobe bryant
what was the total number of turnovers in a season for kobe bryant at point guard	number of turnovers (over a season) of player kobe bryant whose position is point guard
in which season did kobe bryant play 3 fouls	season of player kobe bryant whose number of fouls (over a season) is 3
how many points did kobe bryant score during a season	number of points (over a season) of player kobe bryant whose number of steals (over a season) is 3
player that plays in two positions	player that has at most two position
player whose number of assists over a season is more than that of  of player kobe bryant over a season	player whose number of assists (over a season) is larger than number of assists (over a season) of player kobe bryant
what players have at least as many turnovers that kobe bryant has during a season	player whose number of turnovers (over a season) is at least number of turnovers (over a season) of player kobe bryant
who has had 3 or more assists	player whose number of assists (over a season) is at least 3
who has had more than 3 rebounds	player whose number of rebounds (over a season) is larger than 3
how many assists did kobe bryant have who had three rebounds	number of assists (over a season) of player kobe bryant whose number of rebounds (over a season) is 3
how many fouls does kobe bryant have in seasons when he makes a total of 3 steals	number of fouls (over a season) of player kobe bryant whose number of steals (over a season) is 3
find players with assist scores over any given season that tally more than 3	player whose number of assists (over a season) is larger than 3
player with more than 3 points over a season	player whose number of points (over a season) is larger than 3
what position did kobe bryant play 3 games as	position of player kobe bryant whose number of played games (over a season) is 3
what players have been on the most teams	player that has the most number of team
position of player kobe bryant from 2004 season	position of player kobe bryant whose season is 2004
what player has fewer blocks per season than kobe bryant	player whose number of blocks (over a season) is smaller than number of blocks (over a season) of player kobe bryant
which player has had as many fouls or more as kobe bryant	player whose number of fouls (over a season) is at least number of fouls (over a season) of player kobe bryant
players that never made 3 blocks in a season	player whose number of blocks (over a season) is not 3
how many rebounds did kobe get after he made 3 blocks	number of rebounds (over a season) of player kobe bryant whose number of blocks (over a season) is 3
what player had more assists than kobe bryant this season	player whose number of assists (over a season) is larger than number of assists (over a season) of player kobe bryant
what season did kobe bryant have 3 allseason assists	season of player kobe bryant whose number of assists (over a season) is 3
name the player with more turnovers per season than kobe bryant	player whose number of turnovers (over a season) is larger than number of turnovers (over a season) of player kobe bryant
what was the total number of blocks for kobe bryant in the 2004 season	number of blocks (over a season) of player kobe bryant whose season is 2004
what player scored 3 or less points during a season	player whose number of points (over a season) is at most 3
how many turn overs kob bryant made over a season	number of turnovers (over a season) of player kobe bryant
are there players who have participated in more than 3 games in a season	player whose number of played games (over a season) is larger than 3
how many points did kobe bryant score allseason when his steals equaled 3	number of points (over a season) of player kobe bryant whose number of steals (over a season) is 3
how many points did kobe bryant score during the season	number of points (over a season) of player kobe bryant whose number of points (over a season) is 3
how many threepoint turnovers did kobe bryant have	number of turnovers (over a season) of player kobe bryant whose number of points (over a season) is 3
when kobe bryant has had 2 blocks in a season how many turnovers had he made	number of turnovers (over a season) of player kobe bryant whose number of blocks (over a season) is 3
player who has one team	player that has less than two team
how many points has kobe bryant made in a season when he made 3 plus rebounds	number of points (over a season) of player kobe bryant whose number of rebounds (over a season) is 3
players with no more than 3 steals a season	player whose number of steals (over a season) is at most 3
name a player with no more than three points per season	player whose number of points (over a season) is at most 3
what position did kobe bryant play when his allseason turnovers equaled 3	position of player kobe bryant whose number of turnovers (over a season) is 3
how many seasons has kobe bryant been starting point guard	season of player kobe bryant whose position is point guard
who has had the same number of turnovers as kobe bryant	player whose number of fouls (over a season) is number of fouls (over a season) of player kobe bryant
did kobe bryant play in 2004	season of player kobe bryant whose season is 2004
name those players with scored assists in any one season tallying at least 3	player whose number of assists (over a season) is at least 3
player who committed more fouls than kob bryant	player whose number of fouls (over a season) is larger than number of fouls (over a season) of player kobe bryant
who has the most assists	player that has the largest number of assists (over a season)
player from player kobe bryants team	player whose team is team of player kobe bryant
who matches or beats kobe bryant in steals per season	player whose number of steals (over a season) is at least number of steals (over a season) of player kobe bryant
number of turnovers over a season of player kobe bryant who has assists over a season	number of turnovers (over a season) of player kobe bryant whose number of assists (over a season) is 3
which players have at least 3 turnovers in a season	player whose number of turnovers (over a season) is at least 3
what player has as much fouls as maximum fouls kob bryant made over a season	player whose number of fouls (over a season) is at most number of fouls (over a season) of player kobe bryant
which team did kobe bryant play for in 2004	team of player kobe bryant whose season is 2004
player with more points over a season than that of player kobe bryant over a season	player whose number of points (over a season) is larger than number of points (over a season) of player kobe bryant
how many turnovers were got by kobe bryant who belonged to the los angeles lakers team	number of turnovers (over a season) of player kobe bryant whose team is los angeles lakers
how many turnovers in the season did kobe bryant have for the lakers	number of turnovers (over a season) of player kobe bryant whose team is los angeles lakers
what was the total number of games played by kobe bryant in season where he had only three rebounds	number of played games (over a season) of player kobe bryant whose number of rebounds (over a season) is 3
what players have no more than three assists over a season	player whose number of assists (over a season) is at most 3
in how many games during a single season did kobe bryant have more than three blocks	number of played games (over a season) of player kobe bryant whose number of blocks (over a season) is 3
name the season in which kobe bryant performed 3 blocks	number of blocks (over a season) of player kobe bryant whose number of blocks (over a season) is 3
name a player with at least three played games	player whose number of played games (over a season) is at least 3
which player gives up te same number of turnovers as kobe bryant each season	player whose number of turnovers (over a season) is number of turnovers (over a season) of player kobe bryant
what players have had less than or equal the number of rebounds as kobe bryant	player whose number of blocks (over a season) is at most number of blocks (over a season) of player kobe bryant
player with smaller turnovers over a season than player kobe bryant over a season	player whose number of turnovers (over a season) is smaller than number of turnovers (over a season) of player kobe bryant
how many points has kobe bryant scored in each season with the los angeles lakers	number of points (over a season) of player kobe bryant whose team is los angeles lakers
how many positions are there	number of position
how many steals in a season did kobe bryant have for the lakers	number of steals (over a season) of player kobe bryant whose team is los angeles lakers
which player is at point guard or forward position	player whose position is point guard or forward
how many turnovers kob bryant made in the season he played for los angeles lakers	number of turnovers (over a season) of player kobe bryant whose team is los angeles lakers
what position did kobe bryant play for the lakers	position of player kobe bryant whose team is los angeles lakers
players who had a greater number of assists in a season than kobe bryant	player whose number of assists (over a season) is larger than number of assists (over a season) of player kobe bryant
how many steals did kobe get after 3 turnovers	number of steals (over a season) of player kobe bryant whose number of turnovers (over a season) is 3
what player played the fewest positions	player that has the least number of position
what players have less fouls than kobe bryant over all seasons	player whose number of fouls (over a season) is smaller than number of fouls (over a season) of player kobe bryant
how many blocks in a season did kobe bryant have	number of blocks (over a season) of player kobe bryant
which player has not played 3 fouls	player whose number of fouls (over a season) is not 3
what player did not play point guard	player whose position is not point guard
how many steals kob bryant made over a season	number of steals (over a season) of player kobe bryant
which is the season kob bryant made 3 fouls	season of player kobe bryant whose number of played games (over a season) is 3
name the season during which kobe bryant committed 3 fouls	number of fouls (over a season) of player kobe bryant whose number of fouls (over a season) is 3
player who scored the least on the team	player that has the least number of team
what year did kobe bryant have exactly 3 steals	season of player kobe bryant whose number of steals (over a season) is 3
players whose total number of points in a season is not 3	player whose number of points (over a season) is not 3
player whose number of steals over a season is less than that of  of player kobe bryant over a season	player whose number of steals (over a season) is smaller than number of steals (over a season) of player kobe bryant
how many fouls in a season did the los angeles lakers kobe bryant commit	number of fouls (over a season) of player kobe bryant whose team is los angeles lakers
what player has played the least number of positions	player that has the least number of position
name the player who has scored the most points in a season	player that has the largest number of points (over a season)
which player has no more played games than kobe bryant	player whose number of played games (over a season) is at most number of played games (over a season) of player kobe bryant
what team was kobe bryant on when he played less than three games in a season	team of player kobe bryant whose number of played games (over a season) is 3
what was the total number of season where kobe bryant had just three rebounds	number of rebounds (over a season) of player kobe bryant whose number of rebounds (over a season) is 3
what player has most allseason points	player that has the largest number of points (over a season)
when did kobe bryant have 3 all season assists	number of assists (over a season) of player kobe bryant whose number of assists (over a season) is 3
what player had the same or more number of blocks as kobe bryant	player whose number of blocks (over a season) is at least number of blocks (over a season) of player kobe bryant
name players who did not play in 2004	player whose season is not 2004
how many points kob bryant made over a season in which he made 3 rebounds	number of points (over a season) of player kobe bryant whose number of rebounds (over a season) is 3
what player scored more points than kobe bryant this season	player whose number of points (over a season) is larger than number of points (over a season) of player kobe bryant
player having not less than 3 blocks over a season	player whose number of blocks (over a season) is at least 3
whos got the fewest points in a year	player that has the smallest number of points (over a season)
which player has had the most steals per season	player that has the largest number of steals (over a season)
who has had the same or more turnovers than kobe bryant	player whose number of turnovers (over a season) is at least number of turnovers (over a season) of player kobe bryant
what player has had more turnovers than kobe bryant during a season	player whose number of turnovers (over a season) is larger than number of turnovers (over a season) of player kobe bryant
which player has the maximum points of kobe bryant	player whose number of points (over a season) is at most number of points (over a season) of player kobe bryant
what player played in the same or less games as kobe bryant	player whose number of played games (over a season) is at most number of played games (over a season) of player kobe bryant
in what position was kobe able  to make 3 blocks	position of player kobe bryant whose number of blocks (over a season) is 3
how many games has kobe given up exactly 3 turnovers	number of played games (over a season) of player kobe bryant whose number of turnovers (over a season) is 3
which players have made fewer assists than kobe bryant	player whose number of assists (over a season) is smaller than number of assists (over a season) of player kobe bryant
what year did kobe bryant play	season of player kobe bryant
who has had less assists than kobe bryant	player whose number of assists (over a season) is smaller than number of assists (over a season) of player kobe bryant
what team did kobe bryant have 3 steals on	team of player kobe bryant whose number of steals (over a season) is 3
what was the total number of assists in seasons where kobe bryant had just three points	number of assists (over a season) of player kobe bryant whose number of points (over a season) is 3
which players have played two or fewer positions	player that has at most two position
how many rebounds did kobe have in 04	number of rebounds (over a season) of player kobe bryant whose season is 2004
what players have gotten time in at least 3 games	player whose number of played games (over a season) is at least 3
number of played games over a season of player kobe bryant with 3 turnovers over a season	number of played games (over a season) of player kobe bryant whose number of turnovers (over a season) is 3
name a player with more than three assists during the season	player whose number of assists (over a season) is larger than 3
what players scored more or less than 3 points in a season	player whose number of points (over a season) is not 3
player with number of blocks over a season as that of player kobe bryantis	player whose number of blocks (over a season) is number of blocks (over a season) of player kobe bryant
how many points did kobe bryant score this season	number of points (over a season) of player kobe bryant
whos got more than 3 assists each season	player whose number of assists (over a season) is at least 3
who is a player with fewer rebounds than kobe bryant	player whose number of rebounds (over a season) is smaller than number of rebounds (over a season) of player kobe bryant
number of steals over a season of player kobe bryant wit 3 steals over a season	number of steals (over a season) of player kobe bryant whose number of steals (over a season) is 3
player with maximum 3 steals over a season	player whose number of steals (over a season) is at most 3
name those players responsible for less than 3 blocks in any one season	player whose number of blocks (over a season) is smaller than 3
in which season did kobe bryant participate in 3 games	number of played games (over a season) of player kobe bryant whose number of played games (over a season) is 3
whos got the lead for most turnovers in a season	player that has the largest number of turnovers (over a season)
during the season in which he scored 3 assists what position was kobe bryant playing	position of player kobe bryant whose number of assists (over a season) is 3
what player had less than 3 turnovers	player whose number of turnovers (over a season) is smaller than 3
what position did kobe bryant play when he made three assists	position of player kobe bryant whose number of assists (over a season) is 3
what team does kobe bryant play on	team of player kobe bryant
what player has the same number of all season assists as kobe bryant	player whose number of assists (over a season) is number of assists (over a season) of player kobe bryant
player with the most played games over all seasons	player that has the largest number of played games (over a season)
how many turnovers does point guard kobe bryant have in a season	number of turnovers (over a season) of player kobe bryant whose position is point guard
players that plat one or two different positions	player that has at most two position
during his season as point guard how many blocks did kobe bryant perform	number of blocks (over a season) of player kobe bryant whose position is point guard
player with most points scored over all seasons	player that has the largest number of points (over a season)
what season did kobe bryant play point guard	season of player kobe bryant whose position is point guard
which player has the fewest rebounds ever	player that has the smallest number of rebounds (over a season)
what players had the same or more steals kobe over the season	player whose number of steals (over a season) is at least number of steals (over a season) of player kobe bryant
which season did kobe bryant have only 3 rebounds in	season of player kobe bryant whose number of rebounds (over a season) is 3
players with the same number of played games as kobe bryant over all seasons	player whose number of played games (over a season) is number of played games (over a season) of player kobe bryant
how many blocks did kobe have in 2004	number of blocks (over a season) of player kobe bryant whose season is 2004
how any blocks did kobe make after getting 3 rebounds	number of blocks (over a season) of player kobe bryant whose number of rebounds (over a season) is 3
what player had the same amount of turnovers as kobe bryant	player whose number of turnovers (over a season) is number of turnovers (over a season) of player kobe bryant
who has had less points than kobe bryant in a season	player whose number of points (over a season) is smaller than number of points (over a season) of player kobe bryant
whats the per season average for points scored while kobe bryant was at point guard	number of points (over a season) of player kobe bryant whose position is point guard
how many blocks did kobe bryant have when he had 3 assists	number of blocks (over a season) of player kobe bryant whose number of assists (over a season) is 3
which player has the minimum number of steals of kobe bryant	player whose number of steals (over a season) is at least number of steals (over a season) of player kobe bryant
which player has the fewest fouls per season	player that has the smallest number of fouls (over a season)
which player has lesser number of turnovers than kobebryant	player whose number of turnovers (over a season) is smaller than number of turnovers (over a season) of player kobe bryant
how many turnoves has kobe bryant given up in seasons with more than 3 on duty games	number of turnovers (over a season) of player kobe bryant whose number of played games (over a season) is 3
does kobe bryant have more fouls or rebounds per season	number of fouls (over a season) of player kobe bryant whose number of rebounds (over a season) is 3
how many rebounds did player kobe bryant have during the season 2004	number of rebounds (over a season) of player kobe bryant whose season is 2004
what player played the fewest games	player that has the smallest number of played games (over a season)
player with smallest number of fouls over a season	player that has the smallest number of fouls (over a season)
number of turnovers over a season of player kobe bryant	number of turnovers (over a season) of player kobe bryant
which season was kobe bryant	season of player kobe bryant
how many points did kobe bryant score over the season in which he played 3 games	number of points (over a season) of player kobe bryant whose number of played games (over a season) is 3
what teams has kobe played for in his career	team of player kobe bryant whose number of turnovers (over a season) is 3
which team did kobe bryant play for when he had 3 fouls in a season	team of player kobe bryant whose number of fouls (over a season) is 3
what player scored less points than kobe bryant	player whose number of points (over a season) is smaller than number of points (over a season) of player kobe bryant
which players made at 13 rebounds over the season	player whose number of rebounds (over a season) is at most 3
what players have had more than 3 blocks	player whose number of blocks (over a season) is larger than 3
how many rebounds did kobe bryant have when he made three fouls	number of rebounds (over a season) of player kobe bryant whose number of fouls (over a season) is 3
player with lowest jersey number	player that has the least number of team
what is the position of kobe bryant in los angeles lakers team	position of player kobe bryant whose team is los angeles lakers
what player has as much steals as kob bryant made over a season	player whose number of steals (over a season) is number of steals (over a season) of player kobe bryant
how many points did kobe bryant who had three fouls have	number of points (over a season) of player kobe bryant whose number of fouls (over a season) is 3
what position kob bryant played in the season he made 3 rebounds	position of player kobe bryant whose number of rebounds (over a season) is 3
how many steals did kobe bryant have in three played games	number of steals (over a season) of player kobe bryant whose number of played games (over a season) is 3
which player has played the greatest number of positions	player that has the most number of position
how many turnovers did kobe bryant have when he had 3 assists	number of turnovers (over a season) of player kobe bryant whose number of assists (over a season) is 3
which player has as many blocks as kobe bryant	player whose number of blocks (over a season) is number of blocks (over a season) of player kobe bryant
how many steals did kobe bryant have as point guard	number of steals (over a season) of player kobe bryant whose position is point guard
as a laker how many steals has kobe bryant averaged per season	number of steals (over a season) of player kobe bryant whose team is los angeles lakers
players that had three or fewer assists over the season	player whose number of assists (over a season) is at most 3
name those players with rebounds in any one season equalling less than 3	player whose number of rebounds (over a season) is smaller than 3
number of turnovers of kobe bryant who has 3 rebounds	number of turnovers (over a season) of player kobe bryant whose number of rebounds (over a season) is 3
find those players who have participated in less or more than 3 games in a given season	player whose number of played games (over a season) is not 3
which team did kobe bryant make three blocks for	team of player kobe bryant whose number of blocks (over a season) is 3
how many blocks did kobe bryant have when he had three assists	number of blocks (over a season) of player kobe bryant whose number of assists (over a season) is 3
players that have more points than kobe bryant over all seasons	player whose number of points (over a season) is at least number of points (over a season) of player kobe bryant
find the season in which kobe bryant had a total number of 3 steals	number of steals (over a season) of player kobe bryant whose number of steals (over a season) is 3
how many points does  kobe bryant have for the lakers	number of points (over a season) of player kobe bryant whose team is los angeles lakers
what player had more than 3 blocks this season	player whose number of blocks (over a season) is larger than 3
what is the number of the player in this position	number of position
who has more rebounds than kobe bryant	player whose number of rebounds (over a season) is larger than number of rebounds (over a season) of player kobe bryant
how many turnovers does kobe bryant give up as point guard	number of turnovers (over a season) of player kobe bryant whose position is point guard
what player had the least points this season	player that has the smallest number of points (over a season)
what was the complete number of steals in season where kobe bryant had only three points	number of steals (over a season) of player kobe bryant whose number of points (over a season) is 3
find players who have performed blocks in any one season tallying to the same amount as those blocks performed by kobe bryant in any one season	player whose number of blocks (over a season) is at least number of blocks (over a season) of player kobe bryant
which player had the same number of turnovers as kobe bryant	player whose number of turnovers (over a season) is number of turnovers (over a season) of player kobe bryant
players that have more than three steals over a season	player whose number of steals (over a season) is larger than 3
who has had less than 3 fouls	player whose number of fouls (over a season) is smaller than 3
in which position did kobe bryant get 3 steals	position of player kobe bryant whose number of steals (over a season) is 3
how many points did kobe bryant have on the los angeles lakers	number of points (over a season) of player kobe bryant whose team is los angeles lakers
kobe bryants team when he had 3 rebounds for the season	team of player kobe bryant whose number of rebounds (over a season) is 3
how many assists did kobe get after making 3 blocks	number of assists (over a season) of player kobe bryant whose number of blocks (over a season) is 3
what players had same or more rebounds than kobe bryant over all seasons	player whose number of rebounds (over a season) is at least number of rebounds (over a season) of player kobe bryant
in the same season in which kobe bryant had 3 rebounds what was the number of turnovers that he had	number of turnovers (over a season) of player kobe bryant whose number of rebounds (over a season) is 3
player whose number of rebounds over a season are not more than rebounds over a season of player kobe bryant	player whose number of rebounds (over a season) is at most number of rebounds (over a season) of player kobe bryant
which player has made the minimum number of turnovers	player that has the smallest number of turnovers (over a season)
kobe bryant ended up with how many assists last season	number of assists (over a season) of player kobe bryant whose number of points (over a season) is 3
what players number of games played allseason equaled no less than kobe bryants	player whose number of played games (over a season) is at least number of played games (over a season) of player kobe bryant
whos got the record for most rebounds in a season	player that has the largest number of rebounds (over a season)
which player has played as any fouls as kobe bryant	player whose number of fouls (over a season) is at most number of fouls (over a season) of player kobe bryant
player with not more than 3 fouls over a season	player whose number of fouls (over a season) is at most 3
players that played on the same team as kobe bryant	player whose team is team of player kobe bryant
which players have the same position as kobe bryant	player whose position is position of player kobe bryant
how many points did kobe bryant score in the game that he had three steals last season	number of points (over a season) of player kobe bryant whose number of steals (over a season) is 3
what player made 3 blocks over a season	player whose number of blocks (over a season) is at least 3
how man fouls did kobe bryant have in all seasons where he had three rebounds	number of fouls (over a season) of player kobe bryant whose number of rebounds (over a season) is 3
find those players who have game time in no more than 3 games in a given season	player whose number of played games (over a season) is at most 3
what position did kobe bryant get 3 points as	position of player kobe bryant whose number of points (over a season) is 3
how many assists did kobe bryant get after 3 turnovers	number of assists (over a season) of player kobe bryant whose number of turnovers (over a season) is 3
name a player with more than three turnovers in the season	player whose number of turnovers (over a season) is larger than 3
player who has same rebounds over a season as that of player kobe bryant over a season	player whose number of rebounds (over a season) is number of rebounds (over a season) of player kobe bryant
los angeles lakers roster	team of player kobe bryant whose team is los angeles lakers
how many games did kobe bryant play who had turnovers	number of played games (over a season) of player kobe bryant whose number of turnovers (over a season) is 3
name kobe bryants position when he had three turnovers	position of player kobe bryant whose number of turnovers (over a season) is 3
name of a player with no more rebounds each season than kobe bryant	player whose number of rebounds (over a season) is at most number of rebounds (over a season) of player kobe bryant
in what season did kobe only give up 3 fouls	season of player kobe bryant whose number of fouls (over a season) is 3
find the number of points acquired by kobe bryant over the entire season in which his number of fouls was 3	number of points (over a season) of player kobe bryant whose number of fouls (over a season) is 3
which player has been apart of the most teams	player that has the most number of team
who has had the least points	player that has the smallest number of points (over a season)
how many fouls did kobe bryant make allseason playing 3 games	number of fouls (over a season) of player kobe bryant whose number of played games (over a season) is 3
who has gotten more than 3 points	player whose number of points (over a season) is larger than 3
which player leads kobe bryant for rebounds per season	player whose number of rebounds (over a season) is at least number of rebounds (over a season) of player kobe bryant
how many all season steals did kobe bryant have	number of steals (over a season) of player kobe bryant
what seasons did kobe bryant play	season of player kobe bryant
player not with 3 turnovers over a season	player whose number of turnovers (over a season) is not 3
which player is not in the position of point guard	player whose position is not point guard
how many games did kobe bryant play in a season where his number of blocks were over 3	number of played games (over a season) of player kobe bryant whose number of blocks (over a season) is 3
how many steals did kobe bryant make in seasons where he made 3 rebounds	number of steals (over a season) of player kobe bryant whose number of rebounds (over a season) is 3
which player played less than three games	player whose number of played games (over a season) is smaller than 3
what player has had points more or less than 3	player whose number of points (over a season) is not 3
what player played in the same season as kobe bryant	player whose season is season of player kobe bryant
how many games has kobe bryant played and hasnt scored a 3	player whose number of played games (over a season) is not 3
who has had more or equal number of rebounds than kobe bryant	player whose number of rebounds (over a season) is at most number of rebounds (over a season) of player kobe bryant
how many rebounds  kob bryant made in the season he made 3 turnovers	number of rebounds (over a season) of player kobe bryant whose number of turnovers (over a season) is 3
name a player who has played as many games as kobe bryant	player whose number of played games (over a season) is number of played games (over a season) of player kobe bryant
what player has had at least as many games played as kobe bryant over a season	player whose number of played games (over a season) is at least number of played games (over a season) of player kobe bryant
name a player who had at least as many assists as kobe bryant	player whose number of assists (over a season) is at least number of assists (over a season) of player kobe bryant
which player does not belong to the los angeles lakers team	player whose team is not los angeles lakers
which player does not have 3 assists	player whose number of assists (over a season) is not 3
how many turnovers did kobe bryant have when he made three assists	number of turnovers (over a season) of player kobe bryant whose number of assists (over a season) is 3
how many points did kobe bryant score in the season	number of points (over a season) of player kobe bryant whose number of assists (over a season) is 3
how many games did kobe bryant play in during the 2004 season	number of played games (over a season) of player kobe bryant whose season is 2004
which player had the fewest rebounds in one season	player that has the smallest number of rebounds (over a season)
how many rebounds did kobe bryant who had three blocks have	number of rebounds (over a season) of player kobe bryant whose number of blocks (over a season) is 3
how many fouls were committed by kob bryant over a season in which he made 3 steals	number of fouls (over a season) of player kobe bryant whose number of steals (over a season) is 3
which player has made the maximum number of blocks	player that has the largest number of blocks (over a season)
how many fouls does kobe bryant over all seasons	number of fouls (over a season) of player kobe bryant whose number of fouls (over a season) is 3
which player has the most twos by position	player that has at most two position
who has had the same number or less rebounds than kobe bryant	player whose number of rebounds (over a season) is at least number of rebounds (over a season) of player kobe bryant
what position did kobe bryant play on the lakers	position of player kobe bryant whose team is los angeles lakers
name a player who had the same number of steals as kobe bryant	player whose number of steals (over a season) is number of steals (over a season) of player kobe bryant
what players have played at most two positions	player that has at most two position
how many points were scored by kobe bryant when he made 3 blocks	number of points (over a season) of player kobe bryant whose number of blocks (over a season) is 3
how many games did kobe have three steals in over the season	number of played games (over a season) of player kobe bryant whose number of steals (over a season) is 3
number of fouls over a season of player kobe bryant who has played 3 games over a season	number of fouls (over a season) of player kobe bryant whose number of played games (over a season) is 3
what player plays point guard or forward	player whose position is point guard or forward
who has had the least rebounds	player that has the smallest number of rebounds (over a season)
find those players who have a total number of steals in a given season that is less than the total number of steals acquired by kobe bryant in a given season	player whose number of steals (over a season) is smaller than number of steals (over a season) of player kobe bryant
how many games has kobe bryant played each season	number of played games (over a season) of player kobe bryant
name a player with no more points per season than kobe bryant	player whose number of points (over a season) is at most number of points (over a season) of player kobe bryant
how many assists did kobe bryant make in a season of 3 turnovers	number of assists (over a season) of player kobe bryant whose number of turnovers (over a season) is 3
who has played for the least number of teams	player that has the least number of team
what players have had the same number of turnovers as kobe bryant	player whose number of turnovers (over a season) is number of turnovers (over a season) of player kobe bryant
who had the least steals	player that has the smallest number of steals (over a season)
what team did kobe bryant score 3 points for	team of player kobe bryant whose number of points (over a season) is 3
what is the number of games played by kobe bryant who made 3 rebounds over the season	number of played games (over a season) of player kobe bryant whose number of rebounds (over a season) is 3
player whose number of turnovers over a season is same as that of player kobe bryant over a season	player whose number of turnovers (over a season) is number of turnovers (over a season) of player kobe bryant
who had few steals over the season than kobe bryant	player whose number of steals (over a season) is smaller than number of steals (over a season) of player kobe bryant
how many assists kob bryant made in season 2004	number of assists (over a season) of player kobe bryant whose season is 2004
what players made less than 4 fouls	player whose number of fouls (over a season) is at most 3
what player has no more turnovers per season than kobe bryant	player whose number of turnovers (over a season) is at most number of turnovers (over a season) of player kobe bryant
how many assists did kobe bryant have when he had 3 points	number of assists (over a season) of player kobe bryant whose number of points (over a season) is 3
which player has played for only one team	player that has less than two team
what player had the least steals this season	player that has the smallest number of steals (over a season)
number of points over a season of player kobe bryant who has 3 fouls over a season	number of points (over a season) of player kobe bryant whose number of fouls (over a season) is 3
how many points did kobe bryant make in 2004	number of points (over a season) of player kobe bryant whose season is 2004
what player made as much points as kob bryant made over a season	player whose number of points (over a season) is number of points (over a season) of player kobe bryant
player with at most 3 turnovers over a season	player whose number of turnovers (over a season) is at most 3
who has had less than 3 points this season	player whose number of points (over a season) is smaller than 3
either los angeles lakers or cleveland cavaliers	los angeles lakers or cleveland cavaliers
during his season with the los angeles lakers how many points did kobe bryant acquire	number of points (over a season) of player kobe bryant whose team is los angeles lakers
number of teams	number of team
number of points over a season of player kobe bryant who has 3 turnovers over a season	number of points (over a season) of player kobe bryant whose number of turnovers (over a season) is 3
player who has played minimum 3 games over a season	player whose number of played games (over a season) is at least 3
in which seasons kob bryant made 3 assists	season of player kobe bryant whose number of assists (over a season) is 3
number of played games over a season of player kobe bryant with 3 points over a season	number of played games (over a season) of player kobe bryant whose number of points (over a season) is 3
how many turnovers did kobe bryant ahve when he had 3 fouls	number of turnovers (over a season) of player kobe bryant whose number of fouls (over a season) is 3
what is kobe bryants allseason point total	number of points (over a season) of player kobe bryant
number of steals over a season of player kobe bryant with 3 turnovers over a season	number of steals (over a season) of player kobe bryant whose number of turnovers (over a season) is 3
how many blocks kob bryant made in the season he made 3 rebounds	number of blocks (over a season) of player kobe bryant whose number of rebounds (over a season) is 3
who has made more than 3 points this season	player whose number of points (over a season) is larger than 3
which player has the maximum number of steals	player that has the largest number of steals (over a season)
what player had more than 3 turnovers	player whose number of turnovers (over a season) is larger than 3
which players have 3 or more assists over the season	player whose number of assists (over a season) is at least 3
season of player kobe bryant whose has 3 points over a season	season of player kobe bryant whose number of points (over a season) is 3
what team did kobe bryant play 3 games for allseason	team of player kobe bryant whose number of played games (over a season) is 3
how many fouls in a season did kobe bryant have	number of fouls (over a season) of player kobe bryant whose position is point guard
how many blocks with steal over 3 did kobe bryant play in one season	number of blocks (over a season) of player kobe bryant whose number of steals (over a season) is 3
for the season in which he had 3 blocks to his credit how many steals were attributable to kobe bryant	number of steals (over a season) of player kobe bryant whose number of blocks (over a season) is 3
which player has made a minimum of 3 blocks	player whose number of blocks (over a season) is at least 3
how many blocks kob bryant made over a season in which he made 3 assists	number of blocks (over a season) of player kobe bryant whose number of assists (over a season) is 3
how many assists has kobe bryant had with three steals	number of assists (over a season) of player kobe bryant whose number of steals (over a season) is 3
player who has played more games over a season than player kobe bryan over a season	player whose number of played games (over a season) is larger than number of played games (over a season) of player kobe bryant
how many points did la laker kobe bryant score	number of points (over a season) of player kobe bryant whose team is los angeles lakers
which player has the same number of rebounds in any one season as kobe bryant	player whose number of rebounds (over a season) is number of rebounds (over a season) of player kobe bryant
who has fewer steals per season on average than kobe bryant	player whose number of steals (over a season) is at most number of steals (over a season) of player kobe bryant
number of blocks over a season of player kobe bryant with 3 turnovers over a season	number of blocks (over a season) of player kobe bryant whose number of turnovers (over a season) is 3
what was the total number of rebounds for kobe bryant in season where he only had 3 steals	number of rebounds (over a season) of player kobe bryant whose number of steals (over a season) is 3
which team does kobe bryant play point guard for	team of player kobe bryant whose position is point guard
season of player kobe bryant who has 3 turnovers over a season	season of player kobe bryant whose number of turnovers (over a season) is 3
during the season in which kobe bryant had game time in 3 games how many assists was he responsible for	number of assists (over a season) of player kobe bryant whose number of played games (over a season) is 3
how many steals did kobe bryant get in 3 games	number of steals (over a season) of player kobe bryant whose number of played games (over a season) is 3
position of player kobe bryant with 3 steals over a season	position of player kobe bryant whose number of steals (over a season) is 3
which players have had fewer turnovers per season than kobe bryant	player whose number of turnovers (over a season) is at least number of turnovers (over a season) of player kobe bryant
players that have more and less than 3 fouls over all seasons	player whose number of fouls (over a season) is not 3
what player was on the most teams	player that has the most number of team
how many fouls were played by kobe bryant in 2004	number of fouls (over a season) of player kobe bryant whose season is 2004
how many steals did kobe bryant have in the game in which he had three blocks	number of steals (over a season) of player kobe bryant whose number of blocks (over a season) is 3
how many season games did kobe bryant play as an la laker	number of played games (over a season) of player kobe bryant whose team is los angeles lakers
whats the position of kobe bryant	position of player kobe bryant whose number of assists (over a season) is 3
are there players who have a gamesparticipated in tally equalling that of kobe bryant in any one specific season	player whose number of played games (over a season) is number of played games (over a season) of player kobe bryant
how many steals did kobe bryant have for the los angeles lakers	number of steals (over a season) of player kobe bryant whose team is los angeles lakers
kobe bryant playing position	position of player kobe bryant
how many players had game time in at least 3 games over the season	player whose number of played games (over a season) is at least 3
name a player with no more than three fouls	player whose number of fouls (over a season) is at most 3
what players scored at least three points over a season	player whose number of points (over a season) is at least 3
in which position did kobe score 3 points	position of player kobe bryant whose number of points (over a season) is 3
how many games did kobe bryant play with three blocks	number of played games (over a season) of player kobe bryant whose number of blocks (over a season) is 3
which player made as many blocks over the season as kobe bryant	player whose number of blocks (over a season) is at most number of blocks (over a season) of player kobe bryant
which is the team of kobe bryant who has played 3 games	team of player kobe bryant whose number of played games (over a season) is 3
which players have at most 2 positions	player that has at most two position
players who made less than 4 steals	player whose number of steals (over a season) is at most 3
how many fouls in a single season did kobe bryant have that is greater than three turnovers	number of fouls (over a season) of player kobe bryant whose number of turnovers (over a season) is 3
who has had more or less than 3 fouls	player whose number of fouls (over a season) is not 3
how many games did kobe bryant get 3 fouls in	number of played games (over a season) of player kobe bryant whose number of fouls (over a season) is 3
how many games did kobe bryant have three assists in over a season	number of played games (over a season) of player kobe bryant whose number of assists (over a season) is 3
how many season did kobe bryant have no more than three assists	number of assists (over a season) of player kobe bryant whose number of assists (over a season) is 3
how many points did kobe bryant score as the point guard	number of points (over a season) of player kobe bryant whose position is point guard
how many fouls did kobe bryant have when he had 3 points	number of fouls (over a season) of player kobe bryant whose number of points (over a season) is 3
which player has had more points in a season than kobe bryant	player whose number of points (over a season) is larger than number of points (over a season) of player kobe bryant
which played has played on the most teams	player that has the most number of team
during the 2004 season how many turnovers did kobe bryant acquire	number of turnovers (over a season) of player kobe bryant whose season is 2004
what player had 3 or less points this season	player whose number of points (over a season) is at most 3
what player had did not have 3 turnovers	player whose number of turnovers (over a season) is not 3
are there players who have scored a total number of points in one season  larger than the total number of points scored in the same seaon by kobe bryant	player whose number of points (over a season) is larger than number of points (over a season) of player kobe bryant
how many fouls does kobe bryant average over a season	season of player kobe bryant whose number of fouls (over a season) is 3
what players have less than 3 turnovers this season	player whose number of turnovers (over a season) is not 3
which year did kobe bryant play in three games	season of player kobe bryant whose number of played games (over a season) is 3
how many assists kob bryant made in the season in which he made 3 blocks	number of assists (over a season) of player kobe bryant whose number of blocks (over a season) is 3
what player had the same or more rebounds as kobe bryant	player whose number of rebounds (over a season) is at least number of rebounds (over a season) of player kobe bryant
in what position did kobe bryant get 3 turnovers	position of player kobe bryant whose number of turnovers (over a season) is 3
find the season in which kobe bryant committed 3 fouls and note the number of turnovers in the same period	number of turnovers (over a season) of player kobe bryant whose number of fouls (over a season) is 3
player with two positions	player that has at most two position
how many games in a season did kobe bryant have 3 steals	number of played games (over a season) of player kobe bryant whose number of steals (over a season) is 3
player with not more turnovers over a season than player kobe bryant over a season	player whose number of turnovers (over a season) is at most number of turnovers (over a season) of player kobe bryant
what players have made at least as many blocks as kobe bryant	player whose number of blocks (over a season) is at least number of blocks (over a season) of player kobe bryant
which player had three or more blocks	player whose number of blocks (over a season) is at least 3
note those players with a total number of blocks in any one season that is more than the total number of blocks in any one season acquired by kobe bryant	player whose number of blocks (over a season) is larger than number of blocks (over a season) of player kobe bryant
the total number of steals in all seasons for point guard kobe bryant	number of steals (over a season) of player kobe bryant whose position is point guard
name those players with point tallies in any one season either less than or more than 3	player whose number of points (over a season) is not 3
which players have made the same number of fouls as kobe bryant in a season	player whose number of fouls (over a season) is number of fouls (over a season) of player kobe bryant
which player made more than 3 blocks over the season	player whose number of blocks (over a season) is larger than 3
name the number of total turnovers of kobe bryant	number of turnovers (over a season) of player kobe bryant
number of rebounds over a season of player kobe bryant with 3 blocks over a season	number of rebounds (over a season) of player kobe bryant whose number of blocks (over a season) is 3
what seasons did kobe bryant only have three steals	season of player kobe bryant whose number of steals (over a season) is 3
players that have no more than 3 fouls over all seasons	player whose number of fouls (over a season) is at most 3
which player as less than 3 assists	player whose number of assists (over a season) is smaller than 3
how many points did kobe bryant score in a single season where he had exactly three assists	number of points (over a season) of player kobe bryant whose number of assists (over a season) is 3
what team did kobe bryant play for while having only 3 fouls in a season	team of player kobe bryant whose number of fouls (over a season) is 3
how many seasons has kobe bryant played	season of player kobe bryant whose number of rebounds (over a season) is 3
number of steals of point guard kobe bryant	number of steals (over a season) of player kobe bryant whose position is point guard
which player has the smallest number on the team	player that has the least number of team
how many turnovers did kobe bryant have on the los angeles lakers	number of turnovers (over a season) of player kobe bryant whose team is los angeles lakers
what player is on either the los angeles lakers or the cleveland cavaliers	player whose team is los angeles lakers or cleveland cavaliers
what players allseason blocks are no more than kobe bryants allseason blocks	player whose number of blocks (over a season) is at most number of blocks (over a season) of player kobe bryant
is there a player with the same per season point average as kobe bryant	player whose number of points (over a season) is number of points (over a season) of player kobe bryant
player who plays position point guard or forward	point guard or forward
what player had more than 3 rebounds	player whose number of rebounds (over a season) is larger than 3
what player had less fouls than kobe bryant this season	player whose number of fouls (over a season) is smaller than number of fouls (over a season) of player kobe bryant
player with least number of blocks over a season	player that has the smallest number of blocks (over a season)
