what is the highest point in florida ?	_answer ( A , _highest ( A , ( _place ( A ) , _loc ( A , B ) , _const ( B , _stateid ( florida ) ) ) ) )
what are the high points of states surrounding mississippi ?	_answer ( A , ( _high_point ( B , A ) , _loc ( A , B ) , _state ( B ) , _next_to ( B , C ) , _const ( C , _stateid ( mississippi ) ) ) )
what state has the shortest river ?	_answer ( A , ( _state ( A ) , _loc ( B , A ) , _shortest ( B , _river ( B ) ) ) )
what is the tallest mountain in the united states ?	_answer ( A , _highest ( A , ( _mountain ( A ) , _loc ( A , B ) , _const ( B , _countryid ( usa ) ) ) ) )
what is the capital of maine ?	_answer ( A , ( _capital ( A ) , _loc ( A , B ) , _const ( B , _stateid ( maine ) ) ) )
what are the populations of states through which the mississippi river run ?	_answer ( A , ( _population ( B , A ) , _state ( B ) , _const ( C , _riverid ( mississippi ) ) , _river ( C ) , _traverse ( C , B ) ) )
name all the lakes of us ?	_answer ( A , ( _lake ( A ) , _loc ( A , B ) , _const ( B , _countryid ( usa ) ) ) )
which states border states through which the mississippi traverses ?	_answer ( A , ( _state ( A ) , _next_to ( A , B ) , _state ( B ) , _const ( C , _riverid ( mississippi ) ) , _traverse ( C , B ) ) )
what is the highest mountain in alaska ?	_answer ( A , _highest ( A , ( _mountain ( A ) , _loc ( A , B ) , _const ( B , _stateid ( alaska ) ) ) ) )
what is the population of illinois ?	_answer ( A , ( _population ( B , A ) , _const ( B , _stateid ( illinois ) ) ) )
name all the rivers in colorado ?	_answer ( A , ( _river ( A ) , _loc ( A , B ) , _const ( B , _stateid ( colorado ) ) ) )
in which state does the highest point in usa exist ?	_answer ( A , ( _loc ( B , A ) , _state ( A ) , _highest ( B , ( _place ( B ) , _loc ( B , C ) , _const ( C , _countryid ( usa ) ) ) ) ) )
which state is the city denver located in ?	_answer ( A , ( _state ( A ) , _city ( B ) , _const ( B , _cityid ( denver , _ ) ) , _loc ( B , A ) ) )
what is the lowest point in texas ?	_answer ( A , _lowest ( A , ( _place ( A ) , _loc ( A , B ) , _const ( B , _stateid ( texas ) ) ) ) )
how many states have a city called rochester ?	_answer ( A , _count ( B , ( _state ( B ) , _loc ( C , B ) , _const ( C , _cityid ( rochester , _ ) ) ) , A ) )
which capitals are in the states that border texas ?	_answer ( A , ( _capital ( A ) , _loc ( A , B ) , _state ( B ) , _next_to ( B , C ) , _const ( C , _stateid ( texas ) ) ) )
how many people live in austin ?	_answer ( A , ( _population ( B , A ) , _const ( B , _cityid ( austin , _ ) ) ) )
what states have rivers named colorado ?	_answer ( A , ( _state ( A ) , _loc ( B , A ) , _const ( B , _riverid ( colorado ) ) ) )
what is the size of texas ?	_answer ( A , ( _size ( B , A ) , _const ( B , _stateid ( texas ) ) ) )
what is the shortest river in the usa ?	_answer ( A , _shortest ( A , ( _river ( A ) , _loc ( A , B ) , _const ( B , _countryid ( usa ) ) ) ) )
what are the major cities of the us ?	_answer ( A , ( _major ( A ) , _city ( A ) , _loc ( A , B ) , _const ( B , _countryid ( usa ) ) ) )
which state border kentucky ?	_answer ( A , ( _state ( A ) , _next_to ( A , B ) , _const ( B , _stateid ( kentucky ) ) ) )
what is the population of oregon ?	_answer ( A , ( _population ( B , A ) , _const ( B , _stateid ( oregon ) ) ) )
what states have a city named austin ?	_answer ( A , ( _state ( A ) , _loc ( B , A ) , _const ( B , _cityid ( austin , _ ) ) ) )
what is the highest elevation in south carolina ?	_answer ( A , _highest ( A , ( _place ( A ) , _loc ( A , B ) , _const ( B , _stateid ( ' south carolina ' ) ) ) ) )
how many people live in austin texas ?	_answer ( A , ( _population ( B , A ) , _const ( B , _cityid ( austin , tx ) ) ) )
what are the rivers in the state of texas ?	_answer ( A , ( _river ( A ) , _loc ( A , B ) , _state ( B ) , _const ( B , _stateid ( texas ) ) ) )
what is the lowest point of colorado ?	_answer ( A , _lowest ( A , ( _place ( A ) , _loc ( A , B ) , _const ( B , _stateid ( colorado ) ) ) ) )
what is the population of atlanta ?	_answer ( A , ( _population ( B , A ) , _const ( B , _cityid ( atlanta , _ ) ) ) )
what rivers are in utah ?	_answer ( A , ( _river ( A ) , _loc ( A , B ) , _const ( B , _stateid ( utah ) ) ) )
what river runs through the most states ?	_answer ( A , _most ( A , B , ( _river ( A ) , _traverse ( A , B ) , _state ( B ) ) ) )
what is the population of sacramento ?	_answer ( A , ( _population ( B , A ) , _const ( B , _cityid ( sacramento , _ ) ) ) )
could you tell me what is the highest point in the state of oregon ?	_answer ( A , _highest ( A , ( _place ( A ) , _loc ( A , B ) , _state ( B ) , _const ( B , _stateid ( oregon ) ) ) ) )
which states does the mississippi river run through ?	_answer ( A , ( _state ( A ) , _const ( B , _riverid ( mississippi ) ) , _river ( B ) , _traverse ( B , A ) ) )
what are the major cities in the smallest state in the us ?	_answer ( A , ( _major ( A ) , _city ( A ) , _loc ( A , B ) , _smallest ( B , ( _state ( B ) , _loc ( B , C ) , _const ( C , _countryid ( usa ) ) ) ) ) )
how high is guadalupe peak ?	_answer ( A , ( _elevation ( B , A ) , _const ( B , _placeid ( ' guadalupe peak ' ) ) ) )
what river runs through illinois ?	_answer ( A , ( _river ( A ) , _traverse ( A , B ) , _const ( B , _stateid ( illinois ) ) ) )
how long is the mississippi river ?	_answer ( A , ( _len ( B , A ) , _const ( B , _riverid ( mississippi ) ) , _river ( B ) ) )
how high is the highest point in the largest state ?	_answer ( A , ( _elevation ( B , A ) , _highest ( B , ( _place ( B ) , _loc ( B , C ) , _largest ( C , _state ( C ) ) ) ) ) )
what is the area of south carolina ?	_answer ( A , ( _area ( B , A ) , _const ( B , _stateid ( ' south carolina ' ) ) ) )
what are the states through which the longest river runs ?	_answer ( A , ( _state ( A ) , _longest ( B , ( _river ( B ) , _traverse ( B , A ) ) ) ) )
where is new orleans ?	_answer ( A , ( _loc ( B , A ) , _const ( B , _cityid ( ' new orleans ' , _ ) ) ) )
in what state is mount mckinley ?	_answer ( A , ( _loc ( B , A ) , _state ( A ) , _const ( B , _placeid ( ' mount mckinley ' ) ) ) )
what state has highest elevation ?	_answer ( A , ( _state ( A ) , _loc ( B , A ) , _highest ( B , _place ( B ) ) ) )
what is the size of california ?	_answer ( A , ( _size ( B , A ) , _const ( B , _stateid ( california ) ) ) )
what is the smallest state that borders texas ?	_answer ( A , _smallest ( A , ( _state ( A ) , _next_to ( A , B ) , _const ( B , _stateid ( texas ) ) ) ) )
how many citizens in alabama ?	_answer ( A , ( _population ( B , A ) , _const ( B , _stateid ( alabama ) ) ) )
in which state is rochester ?	_answer ( A , ( _loc ( B , A ) , _state ( A ) , _const ( B , _cityid ( rochester , _ ) ) ) )
how many states in the us does the shortest river run through ?	_answer ( A , _count ( B , ( _state ( B ) , _loc ( B , C ) , _const ( C , _countryid ( usa ) ) , _shortest ( D , _river ( D ) ) , _traverse ( D , B ) ) , A ) )
what is the biggest state in continental us ?	_answer ( A , _largest ( A , ( _state ( A ) , _loc ( A , B ) , _const ( B , _countryid ( usa ) ) ) ) )
what is the area of the largest state ?	_answer ( A , ( _area ( B , A ) , _largest ( B , _state ( B ) ) ) )
where is mount whitney ?	_answer ( A , ( _loc ( B , A ) , _const ( B , _placeid ( ' mount whitney ' ) ) ) )
how many states does iowa border ?	_answer ( A , _count ( B , ( _state ( B ) , _const ( C , _stateid ( iowa ) ) , _next_to ( C , B ) ) , A ) )
which states does the longest river cross ?	_answer ( A , ( _state ( A ) , _longest ( B , _river ( B ) ) , _traverse ( B , A ) ) )
what river flows through kansas ?	_answer ( A , ( _river ( A ) , _traverse ( A , B ) , _const ( B , _stateid ( kansas ) ) ) )
what is the population of austin texas ?	_answer ( A , ( _population ( B , A ) , _const ( B , _cityid ( austin , tx ) ) ) )
what is the capital of vermont ?	_answer ( A , ( _capital ( A ) , _loc ( A , B ) , _const ( B , _stateid ( vermont ) ) ) )
which states border colorado ?	_answer ( A , ( _state ( A ) , _next_to ( A , B ) , _const ( B , _stateid ( colorado ) ) ) )
how long is the mississippi ?	_answer ( A , ( _len ( B , A ) , _const ( B , _riverid ( mississippi ) ) ) )
what state has the largest population density ?	_answer ( A , _largest ( B , ( _state ( A ) , _density ( A , B ) ) ) )
what states border georgia ?	_answer ( A , ( _state ( A ) , _next_to ( A , B ) , _const ( B , _stateid ( georgia ) ) ) )
what is the capital of pennsylvania ?	_answer ( A , ( _capital ( A ) , _loc ( A , B ) , _const ( B , _stateid ( pennsylvania ) ) ) )
what are the biggest rivers in texas ?	_answer ( A , _longest ( A , ( _river ( A ) , _loc ( A , B ) , _const ( B , _stateid ( texas ) ) ) ) )
what is the longest river in the united states ?	_answer ( A , _longest ( A , ( _river ( A ) , _loc ( A , B ) , _const ( B , _countryid ( usa ) ) ) ) )
what is the capital of utah ?	_answer ( A , ( _capital ( A ) , _loc ( A , B ) , _const ( B , _stateid ( utah ) ) ) )
what state has the smallest population density ?	_answer ( A , _smallest ( B , ( _state ( A ) , _density ( A , B ) ) ) )
which capitals are not major cities ?	_answer ( A , ( _capital ( A ) , \+ ( _major ( A ) , _city ( A ) ) ) )
what is the biggest city in nebraska ?	_answer ( A , _largest ( A , ( _city ( A ) , _loc ( A , B ) , _const ( B , _stateid ( nebraska ) ) ) ) )
what is the population of texas ?	_answer ( A , ( _population ( B , A ) , _const ( B , _stateid ( texas ) ) ) )
what is the shortest river in the united states ?	_answer ( A , _shortest ( A , ( _river ( A ) , _loc ( A , B ) , _const ( B , _countryid ( usa ) ) ) ) )
what is the population of rhode island ?	_answer ( A , ( _population ( B , A ) , _const ( B , _stateid ( ' rhode island ' ) ) ) )
what is the state with the lowest point ?	_answer ( A , ( _state ( A ) , _loc ( B , A ) , _lowest ( B , _place ( B ) ) ) )
what is the longest river in new york ?	_answer ( A , _longest ( A , ( _river ( A ) , _loc ( A , B ) , _const ( B , _stateid ( ' new york ' ) ) ) ) )
what is the longest river that runs through a state that borders tennessee ?	_answer ( A , _longest ( A , ( _river ( A ) , _traverse ( A , B ) , _state ( B ) , _next_to ( B , C ) , _const ( C , _stateid ( tennessee ) ) ) ) )
how many major cities are in arizona ?	_answer ( A , _count ( B , ( _major ( B ) , _city ( B ) , _loc ( B , C ) , _const ( C , _stateid ( arizona ) ) ) , A ) )
what are the neighboring states for michigan ?	_answer ( A , ( _next_to ( A , B ) , _state ( A ) , _const ( B , _stateid ( michigan ) ) ) )
what state that borders texas is the largest ?	_answer ( A , _largest ( A , ( _state ( A ) , _next_to ( A , B ) , _const ( B , _stateid ( texas ) ) ) ) )
what is the shortest river ?	_answer ( A , _shortest ( A , _river ( A ) ) )
how many states border the state that borders the most states ?	_answer ( A , _count ( B , ( _state ( B ) , _next_to ( B , C ) , _most ( C , D , ( _state ( C ) , _next_to ( C , D ) , _state ( D ) ) ) ) , A ) )
which state is the largest city in montana in ?	_answer ( A , ( _state ( A ) , _largest ( B , ( _city ( B ) , _loc ( B , C ) , _const ( C , _stateid ( montana ) ) ) ) , _loc ( B , A ) ) )
what is the population of washington dc ?	_answer ( A , ( _population ( B , A ) , _const ( B , _cityid ( washington , dc ) ) ) )
what is the most populous city in texas ?	_answer ( B , _largest ( A , ( _population ( B , A ) , _city ( B ) , _loc ( B , C ) , _const ( C , _stateid ( texas ) ) ) ) )
what is the capital of hawaii ?	_answer ( A , ( _capital ( A ) , _loc ( A , B ) , _const ( B , _stateid ( hawaii ) ) ) )
what is capital of iowa ?	_answer ( A , ( _capital ( A ) , _loc ( A , B ) , _const ( B , _stateid ( iowa ) ) ) )
where is san diego ?	_answer ( A , ( _loc ( B , A ) , _const ( B , _cityid ( ' san diego ' , _ ) ) ) )
what are the major cities in delaware ?	_answer ( A , ( _major ( A ) , _city ( A ) , _loc ( A , B ) , _const ( B , _stateid ( delaware ) ) ) )
what is the lowest point in louisiana ?	_answer ( A , _lowest ( A , ( _place ( A ) , _loc ( A , B ) , _const ( B , _stateid ( louisiana ) ) ) ) )
which state has the highest peak in the country ?	_answer ( A , _highest ( B , ( _state ( A ) , _loc ( B , A ) , _mountain ( B ) ) ) )
what texas city has the largest population ?	_answer ( A , _largest ( B , ( _const ( C , _stateid ( texas ) ) , _city ( A ) , _loc ( A , C ) , _population ( A , B ) ) ) )
what capital is the largest in the us ?	_answer ( A , _largest ( A , ( _capital ( A ) , _loc ( A , B ) , _const ( B , _countryid ( usa ) ) ) ) )
what is the population of new york ?	_answer ( A , ( _population ( B , A ) , _const ( B , _stateid ( ' new york ' ) ) ) )
what is the population of the capital of the smallest state ?	_answer ( A , ( _population ( B , A ) , _capital ( B ) , _loc ( B , C ) , _smallest ( C , _state ( C ) ) ) )
what is the area of alaska ?	_answer ( A , ( _area ( B , A ) , _const ( B , _stateid ( alaska ) ) ) )
what is the population of california ?	_answer ( A , ( _population ( B , A ) , _const ( B , _stateid ( california ) ) ) )
which state has the longest river ?	_answer ( A , _longest ( B , ( _state ( A ) , _loc ( B , A ) , _river ( B ) ) ) )
what is the capital of texas ?	_answer ( A , ( _capital ( A ) , _loc ( A , B ) , _const ( B , _stateid ( texas ) ) ) )
give me the cities which are in texas ?	_answer ( A , ( _city ( A ) , _loc ( A , B ) , _const ( B , _stateid ( texas ) ) ) )
what states border kentucky ?	_answer ( A , ( _state ( A ) , _next_to ( A , B ) , _const ( B , _stateid ( kentucky ) ) ) )
how high is the highest point of florida ?	_answer ( A , ( _elevation ( B , A ) , _highest ( B , ( _place ( B ) , _loc ( B , C ) , _const ( C , _stateid ( florida ) ) ) ) ) )
what are the major cities in north carolina ?	_answer ( A , ( _major ( A ) , _city ( A ) , _loc ( A , B ) , _const ( B , _stateid ( ' north carolina ' ) ) ) )
what is the highest point in the state with capital des moines ?	_answer ( A , _highest ( A , ( _place ( A ) , _loc ( A , B ) , _state ( B ) , _loc ( C , B ) , _capital ( C ) , _const ( C , _cityid ( ' des moines ' , _ ) ) ) ) )
what is the lowest point in california ?	_answer ( A , _lowest ( A , ( _place ( A ) , _loc ( A , B ) , _const ( B , _stateid ( california ) ) ) ) )
what is the biggest city in wyoming ?	_answer ( A , _largest ( A , ( _city ( A ) , _loc ( A , B ) , _const ( B , _stateid ( wyoming ) ) ) ) )
what is the largest state bordering texas ?	_answer ( A , _largest ( A , ( _state ( A ) , _next_to ( A , B ) , _const ( B , _stateid ( texas ) ) ) ) )
what is the smallest city in hawaii ?	_answer ( A , _smallest ( A , ( _city ( A ) , _loc ( A , B ) , _const ( B , _stateid ( hawaii ) ) ) ) )
what is the area of the states ?	_answer ( A , ( _area ( B , A ) , _state ( B ) ) )
what is the area of idaho ?	_answer ( A , ( _area ( B , A ) , _const ( B , _stateid ( idaho ) ) ) )
what state has the most rivers running through it ?	_answer ( A , _most ( A , B , ( _state ( A ) , _loc ( B , A ) , _river ( B ) , _traverse ( B , A ) ) ) )
what is the population of springfield missouri ?	_answer ( A , ( _population ( B , A ) , _const ( B , _cityid ( springfield , mo ) ) ) )
what is the most populated state bordering oklahoma ?	_answer ( A , _largest ( B , ( _population ( A , B ) , _state ( A ) , _next_to ( A , C ) , _const ( C , _stateid ( oklahoma ) ) ) ) )
what is the number of neighboring states for kentucky ?	_answer ( A , _count ( B , ( _state ( B ) , _next_to ( B , C ) , _const ( C , _stateid ( kentucky ) ) ) , A ) )
what is the average population per square km in pennsylvania ?	_answer ( A , ( _density ( B , A ) , _const ( B , _stateid ( pennsylvania ) ) ) )
what state has the highest population density ?	_answer ( A , _largest ( B , ( _state ( A ) , _density ( A , B ) ) ) )
what is the tallest mountain in america ?	_answer ( A , _highest ( A , ( _mountain ( A ) , _loc ( A , B ) , _const ( B , _countryid ( usa ) ) ) ) )
what is the highest point of the state with the largest area ?	_answer ( A , _highest ( A , ( _place ( A ) , _loc ( A , B ) , _largest ( C , ( _state ( B ) , _area ( B , C ) ) ) ) ) )
what are the states ?	_answer ( A , _state ( A ) )
how many rivers in washington ?	_answer ( A , _count ( B , ( _river ( B ) , _loc ( B , C ) , _const ( C , _stateid ( washington ) ) ) , A ) )
what are the populations of the states through which the mississippi river run ?	_answer ( A , ( _population ( B , A ) , _state ( B ) , _const ( C , _riverid ( mississippi ) ) , _river ( C ) , _traverse ( C , B ) ) )
what is the biggest river in illinois ?	_answer ( A , _largest ( A , ( _river ( A ) , _loc ( A , B ) , _const ( B , _stateid ( illinois ) ) ) ) )
what is the capital of michigan ?	_answer ( A , ( _capital ( A ) , _loc ( A , B ) , _const ( B , _stateid ( michigan ) ) ) )
what is the total population of the states that border texas ?	_answer ( A , _sum ( C , ( _state ( C ) , _next_to ( D , C ) , _const ( D , _stateid ( texas ) ) ) , _population ( C ) , A ) )
what states border rhode island ?	_answer ( A , ( _state ( A ) , _next_to ( A , B ) , _const ( B , _stateid ( ' rhode island ' ) ) ) )
what is the biggest city in oregon ?	_answer ( A , _largest ( A , ( _city ( A ) , _loc ( A , B ) , _const ( B , _stateid ( oregon ) ) ) ) )
what is the lowest point in wisconsin ?	_answer ( A , _lowest ( A , ( _place ( A ) , _loc ( A , B ) , _const ( B , _stateid ( wisconsin ) ) ) ) )
what are the rivers in the state of indiana ?	_answer ( A , ( _river ( A ) , _loc ( A , B ) , _state ( B ) , _const ( B , _stateid ( indiana ) ) ) )
what is the population of austin ?	_answer ( A , ( _population ( B , A ) , _const ( B , _cityid ( austin , _ ) ) ) )
what is the smallest city in arkansas ?	_answer ( A , _smallest ( A , ( _city ( A ) , _loc ( A , B ) , _const ( B , _stateid ( arkansas ) ) ) ) )
give me the longest river that passes through the us ?	_answer ( A , _longest ( A , ( _river ( A ) , _traverse ( A , B ) , _const ( B , _countryid ( usa ) ) ) ) )
how long is the missouri river ?	_answer ( A , ( _len ( B , A ) , _const ( B , _riverid ( missouri ) ) , _river ( B ) ) )
which state has the largest city ?	_answer ( A , _largest ( B , ( _state ( A ) , _loc ( B , A ) , _city ( B ) ) ) )
what is the lowest elevation in pennsylvania ?	_answer ( A , _lowest ( A , ( _place ( A ) , _loc ( A , B ) , _const ( B , _stateid ( pennsylvania ) ) ) ) )
what is the longest river in the state with the highest point ?	_answer ( A , _longest ( A , ( _river ( A ) , _loc ( A , B ) , _state ( B ) , _loc ( C , B ) , _highest ( C , _place ( C ) ) ) ) )
what states does the colorado river run through ?	_answer ( A , ( _state ( A ) , _const ( B , _riverid ( colorado ) ) , _river ( B ) , _traverse ( B , A ) ) )
what are the states that the potomac run through ?	_answer ( A , ( _state ( A ) , _const ( B , _riverid ( potomac ) ) , _traverse ( B , A ) ) )
what is the biggest city in the usa ?	_answer ( A , _largest ( A , ( _city ( A ) , _loc ( A , B ) , _const ( B , _countryid ( usa ) ) ) ) )
what state has no rivers ?	_answer ( A , ( _state ( A ) , \+ ( _loc ( B , A ) , _river ( B ) ) ) )
what is the highest point in rhode island ?	_answer ( A , _highest ( A , ( _place ( A ) , _loc ( A , B ) , _const ( B , _stateid ( ' rhode island ' ) ) ) ) )
name the states which have no surrounding states ?	_answer ( A , ( _state ( A ) , \+ ( _next_to ( A , B ) , _state ( B ) ) ) )
what is the population of atlanta ga ?	_answer ( A , ( _population ( B , A ) , _const ( B , _cityid ( atlanta , _ ) ) ) )
how many square kilometers in the us ?	_answer ( A , ( _area ( B , A ) , _const ( B , _countryid ( usa ) ) ) )
what is the population of idaho ?	_answer ( A , ( _population ( B , A ) , _const ( B , _stateid ( idaho ) ) ) )
what is the adjacent state of california ?	_answer ( A , ( _next_to ( A , B ) , _state ( A ) , _const ( B , _stateid ( california ) ) ) )
what is the smallest state through which the longest river runs ?	_answer ( A , _smallest ( A , ( _state ( A ) , _longest ( B , _river ( B ) ) , _traverse ( B , A ) ) ) )
what are the names of the major cities in illinois ?	_answer ( A , ( _major ( A ) , _city ( A ) , _loc ( A , B ) , _const ( B , _stateid ( illinois ) ) ) )
how many states does the colorado river run through ?	_answer ( A , _count ( B , ( _state ( B ) , _const ( C , _riverid ( colorado ) ) , _river ( C ) , _traverse ( C , B ) ) , A ) )
how many states does the colorado river flow through ?	_answer ( A , _count ( B , ( _state ( B ) , _const ( C , _riverid ( colorado ) ) , _river ( C ) , _traverse ( C , B ) ) , A ) )
what are the major cities in kansas ?	_answer ( A , ( _major ( A ) , _city ( A ) , _loc ( A , B ) , _const ( B , _stateid ( kansas ) ) ) )
which states border texas ?	_answer ( A , ( _state ( A ) , _next_to ( A , B ) , _const ( B , _stateid ( texas ) ) ) )
how many people live in new york ?	_answer ( A , ( _population ( B , A ) , _const ( B , _stateid ( ' new york ' ) ) ) )
what are the largest cities in the states that border the largest state ?	_answer ( A , _largest ( A , ( _city ( A ) , _loc ( A , B ) , _state ( B ) , _next_to ( B , C ) , _largest ( C , _state ( C ) ) ) ) )
which states have points that are higher than the highest point in texas ?	_answer ( A , ( _state ( A ) , _place ( B ) , _loc ( B , A ) , _higher ( B , C ) , _highest ( C , ( _place ( C ) , _loc ( C , D ) , _const ( D , _stateid ( texas ) ) ) ) ) )
what is the river that cross over ohio ?	_answer ( A , ( _river ( A ) , _traverse ( A , B ) , _const ( B , _stateid ( ohio ) ) ) )
what is the largest city in michigan ?	_answer ( A , _largest ( A , ( _city ( A ) , _loc ( A , B ) , _const ( B , _stateid ( michigan ) ) ) ) )
how many rivers are in the state with the highest point ?	_answer ( A , _count ( B , ( _river ( B ) , _loc ( B , C ) , _state ( C ) , _loc ( D , C ) , _highest ( D , _place ( D ) ) ) , A ) )
what cities are located in pennsylvania ?	_answer ( A , ( _city ( A ) , _loc ( A , B ) , _const ( B , _stateid ( pennsylvania ) ) ) )
what is the state with the lowest population ?	_answer ( A , _smallest ( B , ( _state ( A ) , _population ( A , B ) ) ) )
what is the highest point in each state whose lowest point is sea level ?	_answer ( A , ( _high_point ( B , A ) , _state ( B ) , _low_point ( B , C ) , _elevation ( C , 0.0 ) ) )
give me the cities in usa ?	_answer ( A , ( _city ( A ) , _loc ( A , B ) , _const ( B , _countryid ( usa ) ) ) )
how many states does the missouri river run through ?	_answer ( A , _count ( B , ( _state ( B ) , _const ( C , _riverid ( missouri ) ) , _river ( C ) , _traverse ( C , B ) ) , A ) )
what state has the city with the largest population ?	_answer ( A , ( _state ( A ) , _loc ( B , A ) , _largest ( C , ( _city ( B ) , _population ( B , C ) ) ) ) )
which is the shortest river ?	_answer ( A , _shortest ( A , _river ( A ) ) )
how many states border alaska ?	_answer ( A , _count ( B , ( _state ( B ) , _next_to ( B , C ) , _const ( C , _stateid ( alaska ) ) ) , A ) )
what is the population of dallas ?	_answer ( A , ( _population ( B , A ) , _const ( B , _cityid ( dallas , _ ) ) ) )
where is san jose ?	_answer ( A , ( _loc ( B , A ) , _const ( B , _cityid ( ' san jose ' , _ ) ) ) )
what states border states that border colorado ?	_answer ( A , ( _state ( A ) , _next_to ( A , B ) , _state ( B ) , _next_to ( B , C ) , _const ( C , _stateid ( colorado ) ) ) )
what rivers flow through the state with the largest population ?	_answer ( A , ( _river ( A ) , _traverse ( A , B ) , _largest ( C , ( _state ( B ) , _population ( B , C ) ) ) ) )
whats the largest city ?	_answer ( A , _largest ( A , _city ( A ) ) )
what is the capital of the alabama state ?	_answer ( A , ( _capital ( A ) , _loc ( A , B ) , _const ( B , _stateid ( alabama ) ) , _state ( B ) ) )
what states border arkansas ?	_answer ( A , ( _state ( A ) , _next_to ( A , B ) , _const ( B , _stateid ( arkansas ) ) ) )
what is the population of denver ?	_answer ( A , ( _population ( B , A ) , _const ( B , _cityid ( denver , _ ) ) ) )
what is the longest river in america ?	_answer ( A , _longest ( A , ( _river ( A ) , _loc ( A , B ) , _const ( B , _countryid ( usa ) ) ) ) )
where is massachusetts ?	_answer ( A , ( _loc ( B , A ) , _const ( B , _stateid ( massachusetts ) ) ) )
what state has the smallest area ?	_answer ( A , _smallest ( B , ( _state ( A ) , _area ( A , B ) ) ) )
what major rivers run through illinois ?	_answer ( A , ( _major ( A ) , _river ( A ) , _traverse ( A , B ) , _const ( B , _stateid ( illinois ) ) ) )
how many cities does the usa have ?	_answer ( A , _count ( B , ( _city ( B ) , _const ( C , _countryid ( usa ) ) , _loc ( B , C ) ) , A ) )
how many people live in california ?	_answer ( A , ( _population ( B , A ) , _const ( B , _stateid ( california ) ) ) )
what are the major rivers in the us ?	_answer ( A , ( _major ( A ) , _river ( A ) , _loc ( A , B ) , _const ( B , _countryid ( usa ) ) ) )
how many states does the mississippi river run through ?	_answer ( A , _count ( B , ( _state ( B ) , _const ( C , _riverid ( mississippi ) ) , _river ( C ) , _traverse ( C , B ) ) , A ) )
what is the area of texas ?	_answer ( A , ( _area ( B , A ) , _const ( B , _stateid ( texas ) ) ) )
what is the length of the river that traverses the most states ?	_answer ( A , ( _len ( B , A ) , _most ( B , C , ( _river ( B ) , _traverse ( B , C ) , _state ( C ) ) ) ) )
what is the length of the longest river in the usa ?	_answer ( A , ( _len ( B , A ) , _longest ( B , ( _river ( B ) , _loc ( B , C ) , _const ( C , _countryid ( usa ) ) ) ) ) )
can you tell me the capital of texas ?	_answer ( A , ( _capital ( A ) , _loc ( A , B ) , _const ( B , _stateid ( texas ) ) ) )
what is the largest city in minnesota by population ?	_answer ( A , _largest ( B , ( _city ( A ) , _loc ( A , C ) , _const ( C , _stateid ( minnesota ) ) , _population ( A , B ) ) ) )
what is the smallest state in the usa ?	_answer ( A , _smallest ( A , ( _state ( A ) , _loc ( A , B ) , _const ( B , _countryid ( usa ) ) ) ) )
what states neighbor maine ?	_answer ( A , ( _state ( A ) , _next_to ( A , B ) , _const ( B , _stateid ( maine ) ) ) )
what states high point are higher than that of colorado ?	_answer ( A , ( _state ( A ) , _high_point ( A , B ) , _higher ( B , C ) , _high_point ( D , C ) , _const ( D , _stateid ( colorado ) ) ) )
what is the highest mountain in texas ?	_answer ( A , _highest ( A , ( _mountain ( A ) , _loc ( A , B ) , _const ( B , _stateid ( texas ) ) ) ) )
what are the major cities in texas ?	_answer ( A , ( _major ( A ) , _city ( A ) , _loc ( A , B ) , _const ( B , _stateid ( texas ) ) ) )
what are the states that border the state with the greatest population ?	_answer ( A , ( _state ( A ) , _next_to ( B , A ) , _largest ( C , ( _state ( B ) , _population ( B , C ) ) ) ) )
what rivers run through colorado ?	_answer ( A , ( _river ( A ) , _traverse ( A , B ) , _const ( B , _stateid ( colorado ) ) ) )
how many rivers are there in us ?	_answer ( A , _count ( B , ( _river ( B ) , _loc ( B , C ) , _const ( C , _countryid ( usa ) ) ) , A ) )
how many rivers are in new york ?	_answer ( A , _count ( B , ( _river ( B ) , _loc ( B , C ) , _const ( C , _stateid ( ' new york ' ) ) ) , A ) )
which rivers are in alaska ?	_answer ( A , ( _river ( A ) , _loc ( A , B ) , _const ( B , _stateid ( alaska ) ) ) )
what is the longest river flowing through new york ?	_answer ( A , _longest ( A , ( _river ( A ) , _traverse ( A , B ) , _const ( B , _stateid ( ' new york ' ) ) ) ) )
what rivers run through west virginia ?	_answer ( A , ( _river ( A ) , _traverse ( A , B ) , _const ( B , _stateid ( ' west virginia ' ) ) ) )
what are the capitals of the states that border texas ?	_answer ( A , ( _capital ( A ) , _loc ( A , B ) , _state ( B ) , _next_to ( B , C ) , _const ( C , _stateid ( texas ) ) ) )
what is the area of california ?	_answer ( A , ( _area ( B , A ) , _const ( B , _stateid ( california ) ) ) )
how many states have a city named springfield ?	_answer ( A , _count ( B , ( _state ( B ) , _loc ( C , B ) , _const ( C , _cityid ( springfield , _ ) ) ) , A ) )
what is the biggest city in texas ?	_answer ( A , _largest ( A , ( _city ( A ) , _loc ( A , B ) , _const ( B , _stateid ( texas ) ) ) ) )
how many cities named austin are there in the usa ?	_answer ( A , _count ( B , ( _city ( B ) , _const ( B , _cityid ( austin , _ ) ) , _loc ( B , C ) , _const ( C , _countryid ( usa ) ) ) , A ) )
what is the total population of the states that border state has highest elevation ?	_answer ( A , _sum ( C , ( _state ( C ) , _next_to ( D , C ) , _state ( D ) , _loc ( E , D ) , _highest ( E , _place ( E ) ) ) , _population ( C ) , A ) )
what the states through which the longest river runs city has the largest population ?	_answer ( A , _largest ( B , ( _state ( C ) , _longest ( D , ( _river ( D ) , _traverse ( D , C ) ) ) , _city ( A ) , _loc ( A , C ) , _population ( A , B ) ) ) )
what is the lowest elevation in the smallest state through which the longest river runs ?	_answer ( A , _lowest ( A , ( _place ( A ) , _loc ( A , B ) , _smallest ( B , ( _state ( B ) , _longest ( C , _river ( C ) ) , _traverse ( C , B ) ) ) ) ) )
what river flows through state has the shortest river ?	_answer ( A , ( _river ( A ) , _traverse ( A , B ) , _state ( B ) , _loc ( C , B ) , _shortest ( C , _river ( C ) ) ) )
how many people live in state has no rivers ?	_answer ( A , ( _population ( B , A ) , _state ( B ) , \+ ( _loc ( C , B ) , _river ( C ) ) ) )
what is the capital of states have points that are higher than the highest point in texas ?	_answer ( A , ( _capital ( A ) , _loc ( A , B ) , _state ( B ) , _place ( C ) , _loc ( C , B ) , _higher ( C , D ) , _highest ( D , ( _place ( D ) , _loc ( D , E ) , _const ( E , _stateid ( texas ) ) ) ) ) )
what is the lowest point of the most populated state bordering oklahoma ?	_answer ( A , _lowest ( A , ( _place ( A ) , _loc ( A , B ) , _largest ( C , ( _population ( B , C ) , _state ( B ) , _next_to ( B , D ) , _const ( D , _stateid ( oklahoma ) ) ) ) ) ) )
give me the cities which are in the smallest state that borders texas ?	_answer ( A , ( _city ( A ) , _loc ( A , B ) , _smallest ( B , ( _state ( B ) , _next_to ( B , C ) , _const ( C , _stateid ( texas ) ) ) ) ) )
what are the major cities in the states which have no surrounding states ?	_answer ( A , ( _major ( A ) , _city ( A ) , _loc ( A , B ) , _state ( B ) , \+ ( _next_to ( B , C ) , _state ( C ) ) ) )
what state that borders state does the highest point in usa exist is the largest ?	_answer ( A , _largest ( A , ( _state ( A ) , _next_to ( A , B ) , _loc ( C , B ) , _state ( B ) , _highest ( C , ( _place ( C ) , _loc ( C , D ) , _const ( D , _countryid ( usa ) ) ) ) ) ) )
what states border the smallest state through which the longest river runs ?	_answer ( A , ( _state ( A ) , _next_to ( A , B ) , _smallest ( B , ( _state ( B ) , _longest ( C , _river ( C ) ) , _traverse ( C , B ) ) ) ) )
how many major cities are in state has the smallest population density ?	_answer ( A , _count ( B , ( _major ( B ) , _city ( B ) , _loc ( B , C ) , _smallest ( D , ( _state ( C ) , _density ( C , D ) ) ) ) , A ) )
give me the cities which are in states border georgia ?	_answer ( A , ( _city ( A ) , _loc ( A , B ) , _state ( B ) , _next_to ( B , C ) , _const ( C , _stateid ( georgia ) ) ) )
what rivers run through state has the highest population density ?	_answer ( A , ( _river ( A ) , _traverse ( A , B ) , _largest ( C , ( _state ( B ) , _density ( B , C ) ) ) ) )
what is the most populated state bordering state has the shortest river ?	_answer ( A , _largest ( B , ( _population ( A , B ) , _state ( A ) , _next_to ( A , C ) , _state ( C ) , _loc ( D , C ) , _shortest ( D , _river ( D ) ) ) ) )
what is the highest elevation in the largest state bordering texas ?	_answer ( A , _highest ( A , ( _place ( A ) , _loc ( A , B ) , _largest ( B , ( _state ( B ) , _next_to ( B , C ) , _const ( C , _stateid ( texas ) ) ) ) ) ) )
can you tell me the capital of state does the highest point in usa exist ?	_answer ( A , ( _capital ( A ) , _loc ( A , B ) , _loc ( C , B ) , _state ( B ) , _highest ( C , ( _place ( C ) , _loc ( C , D ) , _const ( D , _countryid ( usa ) ) ) ) ) )
what are the capitals of the states that border state has the longest river ?	_answer ( A , ( _capital ( A ) , _loc ( A , B ) , _state ( B ) , _next_to ( B , C ) , _longest ( D , ( _state ( C ) , _loc ( D , C ) , _river ( D ) ) ) ) )
how many major cities are in the biggest state in continental us ?	_answer ( A , _count ( B , ( _major ( B ) , _city ( B ) , _loc ( B , C ) , _largest ( C , ( _state ( C ) , _loc ( C , D ) , _const ( D , _countryid ( usa ) ) ) ) ) , A ) )
what rivers are in states border states that border colorado ?	_answer ( A , ( _river ( A ) , _loc ( A , B ) , _state ( B ) , _next_to ( B , C ) , _state ( C ) , _next_to ( C , D ) , _const ( D , _stateid ( colorado ) ) ) )
what are the major cities in states border kentucky ?	_answer ( A , ( _major ( A ) , _city ( A ) , _loc ( A , B ) , _state ( B ) , _next_to ( B , C ) , _const ( C , _stateid ( kentucky ) ) ) )
what is the lowest point of states neighbor maine ?	_answer ( A , _lowest ( A , ( _place ( A ) , _loc ( A , B ) , _state ( B ) , _next_to ( B , C ) , _const ( C , _stateid ( maine ) ) ) ) )
what are the capitals of the states that border the largest state bordering texas ?	_answer ( A , ( _capital ( A ) , _loc ( A , B ) , _state ( B ) , _next_to ( B , C ) , _largest ( C , ( _state ( C ) , _next_to ( C , D ) , _const ( D , _stateid ( texas ) ) ) ) ) )
which states border the neighboring states for michigan ?	_answer ( A , ( _state ( A ) , _next_to ( A , B ) , _next_to ( B , C ) , _state ( B ) , _const ( C , _stateid ( michigan ) ) ) )
what are the major cities in states does the mississippi river run through ?	_answer ( A , ( _major ( A ) , _city ( A ) , _loc ( A , B ) , _state ( B ) , _const ( C , _riverid ( mississippi ) ) , _river ( C ) , _traverse ( C , B ) ) )
what is the lowest elevation in state has the longest river ?	_answer ( A , _lowest ( A , ( _place ( A ) , _loc ( A , B ) , _longest ( C , ( _state ( B ) , _loc ( C , B ) , _river ( C ) ) ) ) ) )
what is the area of states have a city named austin ?	_answer ( A , ( _area ( B , A ) , _state ( B ) , _loc ( C , B ) , _const ( C , _cityid ( austin , _ ) ) ) )
what are the major cities in states border arkansas ?	_answer ( A , ( _major ( A ) , _city ( A ) , _loc ( A , B ) , _state ( B ) , _next_to ( B , C ) , _const ( C , _stateid ( arkansas ) ) ) )
what states have points that are higher than the highest point in texas city has the largest population ?	_answer ( A , _largest ( B , ( _state ( C ) , _place ( D ) , _loc ( D , C ) , _higher ( D , E ) , _highest ( E , ( _place ( E ) , _loc ( E , F ) , _const ( F , _stateid ( texas ) ) ) ) , _city ( A ) , _loc ( A , C ) , _population ( A , B ) ) ) )
what states does the the longest river in the united states run through ?	_answer ( A , ( _state ( A ) , _longest ( B , ( _river ( B ) , _loc ( B , C ) , _const ( C , _countryid ( usa ) ) ) ) , _river ( B ) , _traverse ( B , A ) ) )
what is the longest river flowing through states border states that border colorado ?	_answer ( A , _longest ( A , ( _river ( A ) , _traverse ( A , B ) , _state ( B ) , _next_to ( B , C ) , _state ( C ) , _next_to ( C , D ) , _const ( D , _stateid ( colorado ) ) ) ) )
which states does the the rivers in the state of indiana run through ?	_answer ( A , ( _state ( A ) , _river ( B ) , _loc ( B , C ) , _state ( C ) , _const ( C , _stateid ( indiana ) ) , _river ( B ) , _traverse ( B , A ) ) )
what river runs through states does the mississippi river run through ?	_answer ( A , ( _river ( A ) , _traverse ( A , B ) , _state ( B ) , _const ( C , _riverid ( mississippi ) ) , _river ( C ) , _traverse ( C , B ) ) )
what states high point are higher than that of states border states through which the mississippi traverses ?	_answer ( A , ( _state ( A ) , _high_point ( A , B ) , _higher ( B , C ) , _high_point ( D , C ) , _state ( D ) , _next_to ( D , E ) , _state ( E ) , _const ( F , _riverid ( mississippi ) ) , _traverse ( F , E ) ) )
what is the biggest river in states border kentucky ?	_answer ( A , _largest ( A , ( _river ( A ) , _loc ( A , B ) , _state ( B ) , _next_to ( B , C ) , _const ( C , _stateid ( kentucky ) ) ) ) )
how many states does states border texas border ?	_answer ( A , _count ( B , ( _state ( B ) , _state ( C ) , _next_to ( C , D ) , _const ( D , _stateid ( texas ) ) , _next_to ( C , B ) ) , A ) )
what rivers run through state is mount mckinley ?	_answer ( A , ( _river ( A ) , _traverse ( A , B ) , _loc ( C , B ) , _state ( B ) , _const ( C , _placeid ( ' mount mckinley ' ) ) ) )
what rivers run through state has the city with the largest population ?	_answer ( A , ( _river ( A ) , _traverse ( A , B ) , _state ( B ) , _loc ( C , B ) , _largest ( D , ( _city ( C ) , _population ( C , D ) ) ) ) )
how many people live in the adjacent state of california ?	_answer ( A , ( _population ( B , A ) , _next_to ( B , C ) , _state ( B ) , _const ( C , _stateid ( california ) ) ) )
what is the longest river in the most populated state bordering oklahoma ?	_answer ( A , _longest ( A , ( _river ( A ) , _loc ( A , B ) , _largest ( C , ( _population ( B , C ) , _state ( B ) , _next_to ( B , D ) , _const ( D , _stateid ( oklahoma ) ) ) ) ) ) )
what is the longest river flowing through the states which have no surrounding states ?	_answer ( A , _longest ( A , ( _river ( A ) , _traverse ( A , B ) , _state ( B ) , \+ ( _next_to ( B , C ) , _state ( C ) ) ) ) )
how many citizens in the biggest state in continental us ?	_answer ( A , ( _population ( B , A ) , _largest ( B , ( _state ( B ) , _loc ( B , C ) , _const ( C , _countryid ( usa ) ) ) ) ) )
what states does the the longest river that passes through the us run through ?	_answer ( A , ( _state ( A ) , _longest ( B , ( _river ( B ) , _traverse ( B , C ) , _const ( C , _countryid ( usa ) ) ) ) , _river ( B ) , _traverse ( B , A ) ) )
what is the capital of states border states through which the mississippi traverses ?	_answer ( A , ( _capital ( A ) , _loc ( A , B ) , _state ( B ) , _next_to ( B , C ) , _state ( C ) , _const ( D , _riverid ( mississippi ) ) , _traverse ( D , C ) ) )
what is the lowest elevation in the states ?	_answer ( A , _lowest ( A , ( _place ( A ) , _loc ( A , B ) , _state ( B ) ) ) )
which states border states through which the river runs through illinois traverses ?	_answer ( A , ( _state ( A ) , _next_to ( A , B ) , _state ( B ) , _river ( C ) , _traverse ( C , D ) , _const ( D , _stateid ( illinois ) ) , _traverse ( C , B ) ) )
what is the biggest city in the states that the potomac run through ?	_answer ( A , _largest ( A , ( _city ( A ) , _loc ( A , B ) , _state ( B ) , _const ( C , _riverid ( potomac ) ) , _traverse ( C , B ) ) ) )
what states have a city named the cities which are in texas ?	_answer ( A , ( _state ( A ) , _loc ( B , A ) , _city ( B ) , _loc ( B , C ) , _const ( C , _stateid ( texas ) ) ) )
how many rivers are in the state with the lowest population ?	_answer ( A , _count ( B , ( _river ( B ) , _loc ( B , C ) , _smallest ( D , ( _state ( C ) , _population ( C , D ) ) ) ) , A ) )
how many people live in the cities which are in texas ?	_answer ( A , ( _population ( B , A ) , _city ( B ) , _loc ( B , C ) , _const ( C , _stateid ( texas ) ) ) )
what are the populations of states through which the the rivers in the state of indiana run ?	_answer ( A , ( _population ( B , A ) , _state ( B ) , _river ( C ) , _loc ( C , D ) , _state ( D ) , _const ( D , _stateid ( indiana ) ) , _river ( C ) , _traverse ( C , B ) ) )
what is the capital of the states border kentucky state ?	_answer ( A , ( _capital ( A ) , _loc ( A , B ) , _state ( B ) , _next_to ( B , C ) , _const ( C , _stateid ( kentucky ) ) , _state ( B ) ) )
what is the highest elevation in state has the highest population density ?	_answer ( A , _highest ( A , ( _place ( A ) , _loc ( A , B ) , _largest ( C , ( _state ( B ) , _density ( B , C ) ) ) ) ) )
what cities are located in the smallest state through which the longest river runs ?	_answer ( A , ( _city ( A ) , _loc ( A , B ) , _smallest ( B , ( _state ( B ) , _longest ( C , _river ( C ) ) , _traverse ( C , B ) ) ) ) )
which rivers are in states neighbor maine ?	_answer ( A , ( _river ( A ) , _loc ( A , B ) , _state ( B ) , _next_to ( B , C ) , _const ( C , _stateid ( maine ) ) ) )
what the states city has the largest population ?	_answer ( A , _largest ( B , ( _state ( C ) , _city ( A ) , _loc ( A , C ) , _population ( A , B ) ) ) )
what is capital of states does the longest river cross ?	_answer ( A , ( _capital ( A ) , _loc ( A , B ) , _state ( B ) , _longest ( C , _river ( C ) ) , _traverse ( C , B ) ) )
what state that borders states border georgia is the largest ?	_answer ( A , _largest ( A , ( _state ( A ) , _next_to ( A , B ) , _state ( B ) , _next_to ( B , C ) , _const ( C , _stateid ( georgia ) ) ) ) )
what states border state is mount mckinley ?	_answer ( A , ( _state ( A ) , _next_to ( A , B ) , _loc ( C , B ) , _state ( B ) , _const ( C , _placeid ( ' mount mckinley ' ) ) ) )
how many states does states border rhode island border ?	_answer ( A , _count ( B , ( _state ( B ) , _state ( C ) , _next_to ( C , D ) , _const ( D , _stateid ( ' rhode island ' ) ) , _next_to ( C , B ) ) , A ) )
what is the total population of the states that border state has the largest city ?	_answer ( A , _sum ( C , ( _state ( C ) , _next_to ( D , C ) , _largest ( E , ( _state ( D ) , _loc ( E , D ) , _city ( E ) ) ) ) , _population ( C ) , A ) )
where is states does the mississippi river run through ?	_answer ( A , ( _loc ( B , A ) , _state ( B ) , _const ( C , _riverid ( mississippi ) ) , _river ( C ) , _traverse ( C , B ) ) )
what is the lowest elevation in states does the longest river cross ?	_answer ( A , _lowest ( A , ( _place ( A ) , _loc ( A , B ) , _state ( B ) , _longest ( C , _river ( C ) ) , _traverse ( C , B ) ) ) )
what states border states that border the most populated state bordering oklahoma ?	_answer ( A , ( _state ( A ) , _next_to ( A , B ) , _state ( B ) , _next_to ( B , C ) , _largest ( D , ( _population ( C , D ) , _state ( C ) , _next_to ( C , E ) , _const ( E , _stateid ( oklahoma ) ) ) ) ) )
how many people live in the smallest city in hawaii ?	_answer ( A , ( _population ( B , A ) , _smallest ( B , ( _city ( B ) , _loc ( B , C ) , _const ( C , _stateid ( hawaii ) ) ) ) ) )
what is the highest elevation in state is mount mckinley ?	_answer ( A , _highest ( A , ( _place ( A ) , _loc ( A , B ) , _loc ( C , B ) , _state ( B ) , _const ( C , _placeid ( ' mount mckinley ' ) ) ) ) )
what is the average population per square km in states neighbor maine ?	_answer ( A , ( _density ( B , A ) , _state ( B ) , _next_to ( B , C ) , _const ( C , _stateid ( maine ) ) ) )
what is capital of states border kentucky ?	_answer ( A , ( _capital ( A ) , _loc ( A , B ) , _state ( B ) , _next_to ( B , C ) , _const ( C , _stateid ( kentucky ) ) ) )
how many people live in the capital of utah ?	_answer ( A , ( _population ( B , A ) , _capital ( B ) , _loc ( B , C ) , _const ( C , _stateid ( utah ) ) ) )
how high is the highest point of the states that the potomac run through ?	_answer ( A , ( _elevation ( B , A ) , _highest ( B , ( _place ( B ) , _loc ( B , C ) , _state ( C ) , _const ( D , _riverid ( potomac ) ) , _traverse ( D , C ) ) ) ) )
how many states border state has highest elevation ?	_answer ( A , _count ( B , ( _state ( B ) , _next_to ( B , C ) , _state ( C ) , _loc ( D , C ) , _highest ( D , _place ( D ) ) ) , A ) )
what are the states that the the shortest river in the united states run through ?	_answer ( A , ( _state ( A ) , _shortest ( B , ( _river ( B ) , _loc ( B , C ) , _const ( C , _countryid ( usa ) ) ) ) , _traverse ( B , A ) ) )
what is the population of the biggest city in wyoming ga ?	_answer ( A , ( _population ( B , A ) , _largest ( B , ( _city ( B ) , _loc ( B , C ) , _const ( C , _stateid ( wyoming ) ) ) ) ) )
what is the average population per square km in the smallest state through which the longest river runs ?	_answer ( A , ( _density ( B , A ) , _smallest ( B , ( _state ( B ) , _longest ( C , _river ( C ) ) , _traverse ( C , B ) ) ) ) )
how many citizens in states does the longest river cross ?	_answer ( A , ( _population ( B , A ) , _state ( B ) , _longest ( C , _river ( C ) ) , _traverse ( C , B ) ) )
what rivers run through the neighboring states for michigan ?	_answer ( A , ( _river ( A ) , _traverse ( A , B ) , _next_to ( B , C ) , _state ( B ) , _const ( C , _stateid ( michigan ) ) ) )
what is the highest elevation in states border arkansas ?	_answer ( A , _highest ( A , ( _place ( A ) , _loc ( A , B ) , _state ( B ) , _next_to ( B , C ) , _const ( C , _stateid ( arkansas ) ) ) ) )
what is the river that cross over states high point are higher than that of colorado ?	_answer ( A , ( _river ( A ) , _traverse ( A , B ) , _state ( B ) , _high_point ( B , C ) , _higher ( C , D ) , _high_point ( E , D ) , _const ( E , _stateid ( colorado ) ) ) )
what is the smallest city in states does the longest river cross ?	_answer ( A , _smallest ( A , ( _city ( A ) , _loc ( A , B ) , _state ( B ) , _longest ( C , _river ( C ) ) , _traverse ( C , B ) ) ) )
what is the capital of the state border kentucky state ?	_answer ( A , ( _capital ( A ) , _loc ( A , B ) , _state ( B ) , _next_to ( B , C ) , _const ( C , _stateid ( kentucky ) ) , _state ( B ) ) )
how many people live in state has the most rivers running through it ?	_answer ( A , ( _population ( B , A ) , _most ( B , C , ( _state ( B ) , _loc ( C , B ) , _river ( C ) , _traverse ( C , B ) ) ) ) )
what is the average population per square km in the neighboring states for michigan ?	_answer ( A , ( _density ( B , A ) , _next_to ( B , C ) , _state ( B ) , _const ( C , _stateid ( michigan ) ) ) )
what is the lowest point in state border kentucky ?	_answer ( A , _lowest ( A , ( _place ( A ) , _loc ( A , B ) , _state ( B ) , _next_to ( B , C ) , _const ( C , _stateid ( kentucky ) ) ) ) )
how many people live in capital is the largest in the us ?	_answer ( A , ( _population ( B , A ) , _largest ( B , ( _capital ( B ) , _loc ( B , C ) , _const ( C , _countryid ( usa ) ) ) ) ) )
which rivers are in the most populated state bordering oklahoma ?	_answer ( A , ( _river ( A ) , _loc ( A , B ) , _largest ( C , ( _population ( B , C ) , _state ( B ) , _next_to ( B , D ) , _const ( D , _stateid ( oklahoma ) ) ) ) ) )
what is the most populated state bordering state is the largest city in montana in ?	_answer ( A , _largest ( B , ( _population ( A , B ) , _state ( A ) , _next_to ( A , C ) , _state ( C ) , _largest ( D , ( _city ( D ) , _loc ( D , E ) , _const ( E , _stateid ( montana ) ) ) ) , _loc ( D , C ) ) ) )
which rivers are in states border rhode island ?	_answer ( A , ( _river ( A ) , _loc ( A , B ) , _state ( B ) , _next_to ( B , C ) , _const ( C , _stateid ( ' rhode island ' ) ) ) )
what states high point are higher than that of state is mount mckinley ?	_answer ( A , ( _state ( A ) , _high_point ( A , B ) , _higher ( B , C ) , _high_point ( D , C ) , _loc ( E , D ) , _state ( D ) , _const ( E , _placeid ( ' mount mckinley ' ) ) ) )
how many states does the river runs through illinois run through ?	_answer ( A , _count ( B , ( _state ( B ) , _river ( C ) , _traverse ( C , D ) , _const ( D , _stateid ( illinois ) ) , _river ( C ) , _traverse ( C , B ) ) , A ) )
what is the highest point in states does the longest river cross ?	_answer ( A , _highest ( A , ( _place ( A ) , _loc ( A , B ) , _state ( B ) , _longest ( C , _river ( C ) ) , _traverse ( C , B ) ) ) )
what are the major cities in states have points that are higher than the highest point in texas ?	_answer ( A , ( _major ( A ) , _city ( A ) , _loc ( A , B ) , _state ( B ) , _place ( C ) , _loc ( C , B ) , _higher ( C , D ) , _highest ( D , ( _place ( D ) , _loc ( D , E ) , _const ( E , _stateid ( texas ) ) ) ) ) )
how many cities named the biggest city in nebraska are there in the usa ?	_answer ( A , _count ( B , ( _city ( B ) , _largest ( B , ( _city ( B ) , _loc ( B , D ) , _const ( D , _stateid ( nebraska ) ) ) ) , _loc ( B , C ) , _const ( C , _countryid ( usa ) ) ) , A ) )
what cities are located in states high point are higher than that of colorado ?	_answer ( A , ( _city ( A ) , _loc ( A , B ) , _state ( B ) , _high_point ( B , C ) , _higher ( C , D ) , _high_point ( E , D ) , _const ( E , _stateid ( colorado ) ) ) )
what is the capital of state is the city denver located in ?	_answer ( A , ( _capital ( A ) , _loc ( A , B ) , _state ( B ) , _city ( C ) , _const ( C , _cityid ( denver , _ ) ) , _loc ( C , B ) ) )
what major rivers run through states does the colorado river run through ?	_answer ( A , ( _major ( A ) , _river ( A ) , _traverse ( A , B ) , _state ( B ) , _const ( C , _riverid ( colorado ) ) , _river ( C ) , _traverse ( C , B ) ) )
how many citizens in state has the longest river ?	_answer ( A , ( _population ( B , A ) , _longest ( C , ( _state ( B ) , _loc ( C , B ) , _river ( C ) ) ) ) )
which rivers are in state has the largest population density ?	_answer ( A , ( _river ( A ) , _loc ( A , B ) , _largest ( C , ( _state ( B ) , _density ( B , C ) ) ) ) )
what states border states that border state is the city denver located in ?	_answer ( A , ( _state ( A ) , _next_to ( A , B ) , _state ( B ) , _next_to ( B , C ) , _state ( C ) , _city ( D ) , _const ( D , _cityid ( denver , _ ) ) , _loc ( D , C ) ) )
how many citizens in states have a city named austin ?	_answer ( A , ( _population ( B , A ) , _state ( B ) , _loc ( C , B ) , _const ( C , _cityid ( austin , _ ) ) ) )
what states border states that border state that borders texas is the largest ?	_answer ( A , ( _state ( A ) , _next_to ( A , B ) , _state ( B ) , _next_to ( B , C ) , _largest ( C , ( _state ( C ) , _next_to ( C , D ) , _const ( D , _stateid ( texas ) ) ) ) ) )
what states neighbor the states that border the state with the greatest population ?	_answer ( A , ( _state ( A ) , _next_to ( A , B ) , _state ( B ) , _next_to ( C , B ) , _largest ( D , ( _state ( C ) , _population ( C , D ) ) ) ) )
what states have rivers named rivers run through west virginia ?	_answer ( A , ( _state ( A ) , _loc ( B , A ) , _river ( B ) , _traverse ( B , C ) , _const ( C , _stateid ( ' west virginia ' ) ) ) )
what is the total population of the states that border the smallest state through which the longest river runs ?	_answer ( A , _sum ( C , ( _state ( C ) , _next_to ( D , C ) , _smallest ( D , ( _state ( D ) , _longest ( E , _river ( E ) ) , _traverse ( E , D ) ) ) ) , _population ( C ) , A ) )
what are the rivers in the state of state has no rivers ?	_answer ( A , ( _river ( A ) , _loc ( A , B ) , _state ( B ) , _state ( B ) , \+ ( _loc ( C , B ) , _river ( C ) ) ) )
where is the biggest city in oregon ?	_answer ( A , ( _loc ( B , A ) , _largest ( B , ( _city ( B ) , _loc ( B , C ) , _const ( C , _stateid ( oregon ) ) ) ) ) )
what is the total population of the states that border states does the colorado river run through ?	_answer ( A , _sum ( C , ( _state ( C ) , _next_to ( D , C ) , _state ( D ) , _const ( E , _riverid ( colorado ) ) , _river ( E ) , _traverse ( E , D ) ) , _population ( C ) , A ) )
what is the area of the states that the potomac run through ?	_answer ( A , ( _area ( B , A ) , _state ( B ) , _const ( C , _riverid ( potomac ) ) , _traverse ( C , B ) ) )
what is the smallest state that borders state has highest elevation ?	_answer ( A , _smallest ( A , ( _state ( A ) , _next_to ( A , B ) , _state ( B ) , _loc ( C , B ) , _highest ( C , _place ( C ) ) ) ) )
what is the highest point in the state with capital the major cities in kansas ?	_answer ( A , _highest ( A , ( _place ( A ) , _loc ( A , B ) , _state ( B ) , _loc ( C , B ) , _capital ( C ) , _major ( C ) , _city ( C ) , _loc ( C , D ) , _const ( D , _stateid ( kansas ) ) ) ) )
what rivers run through the biggest state in continental us ?	_answer ( A , ( _river ( A ) , _traverse ( A , B ) , _largest ( B , ( _state ( B ) , _loc ( B , C ) , _const ( C , _countryid ( usa ) ) ) ) ) )
which state border state has the smallest population density ?	_answer ( A , ( _state ( A ) , _next_to ( A , B ) , _smallest ( C , ( _state ( B ) , _density ( B , C ) ) ) ) )
which states border states through which the the longest river that runs through a state that borders tennessee traverses ?	_answer ( A , ( _state ( A ) , _next_to ( A , B ) , _state ( B ) , _longest ( C , ( _river ( C ) , _traverse ( C , D ) , _state ( D ) , _next_to ( D , E ) , _const ( E , _stateid ( tennessee ) ) ) ) , _traverse ( C , B ) ) )
which states have points that are higher than the highest point in state that borders texas is the largest ?	_answer ( A , ( _state ( A ) , _place ( B ) , _loc ( B , A ) , _higher ( B , C ) , _highest ( C , ( _place ( C ) , _loc ( C , D ) , _largest ( D , ( _state ( D ) , _next_to ( D , E ) , _const ( E , _stateid ( texas ) ) ) ) ) ) ) )
what is the capital of state has the smallest population density ?	_answer ( A , ( _capital ( A ) , _loc ( A , B ) , _smallest ( C , ( _state ( B ) , _density ( B , C ) ) ) ) )
what is the largest city in states does the colorado river run through ?	_answer ( A , _largest ( A , ( _city ( A ) , _loc ( A , B ) , _state ( B ) , _const ( C , _riverid ( colorado ) ) , _river ( C ) , _traverse ( C , B ) ) ) )
what is the lowest point in states border georgia ?	_answer ( A , _lowest ( A , ( _place ( A ) , _loc ( A , B ) , _state ( B ) , _next_to ( B , C ) , _const ( C , _stateid ( georgia ) ) ) ) )
how many rivers in state is the largest city in montana in ?	_answer ( A , _count ( B , ( _river ( B ) , _loc ( B , C ) , _state ( C ) , _largest ( D , ( _city ( D ) , _loc ( D , E ) , _const ( E , _stateid ( montana ) ) ) ) , _loc ( D , C ) ) , A ) )
what are the capitals of the states that border state that borders texas is the largest ?	_answer ( A , ( _capital ( A ) , _loc ( A , B ) , _state ( B ) , _next_to ( B , C ) , _largest ( C , ( _state ( C ) , _next_to ( C , D ) , _const ( D , _stateid ( texas ) ) ) ) ) )
what is the largest state bordering states border texas ?	_answer ( A , _largest ( A , ( _state ( A ) , _next_to ( A , B ) , _state ( B ) , _next_to ( B , C ) , _const ( C , _stateid ( texas ) ) ) ) )
what are the capitals of the states that border state does the highest point in usa exist ?	_answer ( A , ( _capital ( A ) , _loc ( A , B ) , _state ( B ) , _next_to ( B , C ) , _loc ( D , C ) , _state ( C ) , _highest ( D , ( _place ( D ) , _loc ( D , E ) , _const ( E , _countryid ( usa ) ) ) ) ) )
what rivers are in state that borders texas is the largest ?	_answer ( A , ( _river ( A ) , _loc ( A , B ) , _largest ( B , ( _state ( B ) , _next_to ( B , C ) , _const ( C , _stateid ( texas ) ) ) ) ) )
what are the populations of states through which the the longest river that runs through a state that borders tennessee run ?	_answer ( A , ( _population ( B , A ) , _state ( B ) , _longest ( C , ( _river ( C ) , _traverse ( C , D ) , _state ( D ) , _next_to ( D , E ) , _const ( E , _stateid ( tennessee ) ) ) ) , _river ( C ) , _traverse ( C , B ) ) )
which rivers are in state has the highest population density ?	_answer ( A , ( _river ( A ) , _loc ( A , B ) , _largest ( C , ( _state ( B ) , _density ( B , C ) ) ) ) )
how many states border the smallest state in the usa ?	_answer ( A , _count ( B , ( _state ( B ) , _next_to ( B , C ) , _smallest ( C , ( _state ( C ) , _loc ( C , D ) , _const ( D , _countryid ( usa ) ) ) ) ) , A ) )
where is the cities which are in texas ?	_answer ( A , ( _loc ( B , A ) , _city ( B ) , _loc ( B , C ) , _const ( C , _stateid ( texas ) ) ) )
what is the capital of the state that borders texas is the largest state ?	_answer ( A , ( _capital ( A ) , _loc ( A , B ) , _largest ( B , ( _state ( B ) , _next_to ( B , C ) , _const ( C , _stateid ( texas ) ) ) ) , _state ( B ) ) )
name all the rivers in the state with the lowest population ?	_answer ( A , ( _river ( A ) , _loc ( A , B ) , _smallest ( C , ( _state ( B ) , _population ( B , C ) ) ) ) )
what are the biggest rivers in the state with the lowest population ?	_answer ( A , _longest ( A , ( _river ( A ) , _loc ( A , B ) , _smallest ( C , ( _state ( B ) , _population ( B , C ) ) ) ) ) )
what is the longest river that runs through a state that borders the smallest state that borders texas ?	_answer ( A , _longest ( A , ( _river ( A ) , _traverse ( A , B ) , _state ( B ) , _next_to ( B , C ) , _smallest ( C , ( _state ( C ) , _next_to ( C , D ) , _const ( D , _stateid ( texas ) ) ) ) ) ) )
how many states have a city called the largest cities in the states that border the largest state ?	_answer ( A , _count ( B , ( _state ( B ) , _loc ( C , B ) , _largest ( C , ( _city ( C ) , _loc ( C , D ) , _state ( D ) , _next_to ( D , E ) , _largest ( E , _state ( E ) ) ) ) ) , A ) )
what is the most populous city in the biggest state in continental us ?	_answer ( B , _largest ( A , ( _population ( B , A ) , _city ( B ) , _loc ( B , C ) , _largest ( C , ( _state ( C ) , _loc ( C , D ) , _const ( D , _countryid ( usa ) ) ) ) ) ) )
which states have points that are higher than the highest point in the smallest state in the usa ?	_answer ( A , ( _state ( A ) , _place ( B ) , _loc ( B , A ) , _higher ( B , C ) , _highest ( C , ( _place ( C ) , _loc ( C , D ) , _smallest ( D , ( _state ( D ) , _loc ( D , E ) , _const ( E , _countryid ( usa ) ) ) ) ) ) ) )
what are the high points of states surrounding states does the colorado river run through ?	_answer ( A , ( _high_point ( B , A ) , _loc ( A , B ) , _state ( B ) , _next_to ( B , C ) , _state ( C ) , _const ( D , _riverid ( colorado ) ) , _river ( D ) , _traverse ( D , C ) ) )
how many rivers in the smallest state through which the longest river runs ?	_answer ( A , _count ( B , ( _river ( B ) , _loc ( B , C ) , _smallest ( C , ( _state ( C ) , _longest ( D , _river ( D ) ) , _traverse ( D , C ) ) ) ) , A ) )
what is the largest state bordering the adjacent state of california ?	_answer ( A , _largest ( A , ( _state ( A ) , _next_to ( A , B ) , _next_to ( B , C ) , _state ( B ) , _const ( C , _stateid ( california ) ) ) ) )
what is the longest river that runs through a state that borders state that borders texas is the largest ?	_answer ( A , _longest ( A , ( _river ( A ) , _traverse ( A , B ) , _state ( B ) , _next_to ( B , C ) , _largest ( C , ( _state ( C ) , _next_to ( C , D ) , _const ( D , _stateid ( texas ) ) ) ) ) ) )
how many states have a city called the capital of the alabama state ?	_answer ( A , _count ( B , ( _state ( B ) , _loc ( C , B ) , _capital ( C ) , _loc ( C , D ) , _const ( D , _stateid ( alabama ) ) , _state ( D ) ) , A ) )
what states border states that border the states that the potomac run through ?	_answer ( A , ( _state ( A ) , _next_to ( A , B ) , _state ( B ) , _next_to ( B , C ) , _state ( C ) , _const ( D , _riverid ( potomac ) ) , _traverse ( D , C ) ) )
what states high point are higher than that of the state with the lowest population ?	_answer ( A , ( _state ( A ) , _high_point ( A , B ) , _higher ( B , C ) , _high_point ( D , C ) , _smallest ( E , ( _state ( D ) , _population ( D , E ) ) ) ) )
could you tell me what is the highest point in the state of the smallest state through which the longest river runs ?	_answer ( A , _highest ( A , ( _place ( A ) , _loc ( A , B ) , _state ( B ) , _smallest ( B , ( _state ( B ) , _longest ( C , _river ( C ) ) , _traverse ( C , B ) ) ) ) ) )
which states have points that are higher than the highest point in the states ?	_answer ( A , ( _state ( A ) , _place ( B ) , _loc ( B , A ) , _higher ( B , C ) , _highest ( C , ( _place ( C ) , _loc ( C , D ) , _state ( D ) ) ) ) )
what is the number of neighboring states for state has highest elevation ?	_answer ( A , _count ( B , ( _state ( B ) , _next_to ( B , C ) , _state ( C ) , _loc ( D , C ) , _highest ( D , _place ( D ) ) ) , A ) )
what is the longest river that runs through a state that borders state has the largest city ?	_answer ( A , _longest ( A , ( _river ( A ) , _traverse ( A , B ) , _state ( B ) , _next_to ( B , C ) , _largest ( D , ( _state ( C ) , _loc ( D , C ) , _city ( D ) ) ) ) ) )
what is the most populated state bordering states border kentucky ?	_answer ( A , _largest ( B , ( _population ( A , B ) , _state ( A ) , _next_to ( A , C ) , _state ( C ) , _next_to ( C , D ) , _const ( D , _stateid ( kentucky ) ) ) ) )
how many states does the state with the lowest point border ?	_answer ( A , _count ( B , ( _state ( B ) , _state ( C ) , _loc ( D , C ) , _lowest ( D , _place ( D ) ) , _next_to ( C , B ) ) , A ) )
what are the rivers in the state of the neighboring states for michigan ?	_answer ( A , ( _river ( A ) , _loc ( A , B ) , _state ( B ) , _next_to ( B , C ) , _state ( B ) , _const ( C , _stateid ( michigan ) ) ) )
which capitals are in the states that border state has the smallest population density ?	_answer ( A , ( _capital ( A ) , _loc ( A , B ) , _state ( B ) , _next_to ( B , C ) , _smallest ( D , ( _state ( C ) , _density ( C , D ) ) ) ) )
what is the biggest city in state is the city denver located in ?	_answer ( A , _largest ( A , ( _city ( A ) , _loc ( A , B ) , _state ( B ) , _city ( C ) , _const ( C , _cityid ( denver , _ ) ) , _loc ( C , B ) ) ) )
what is the total population of the states that border the state with the lowest population ?	_answer ( A , _sum ( C , ( _state ( C ) , _next_to ( D , C ) , _smallest ( E , ( _state ( D ) , _population ( D , E ) ) ) ) , _population ( C ) , A ) )
what is the population of the cities which are in texas ga ?	_answer ( A , ( _population ( B , A ) , _city ( B ) , _loc ( B , C ) , _const ( C , _stateid ( texas ) ) ) )
name all the rivers in state is mount mckinley ?	_answer ( A , ( _river ( A ) , _loc ( A , B ) , _loc ( C , B ) , _state ( B ) , _const ( C , _placeid ( ' mount mckinley ' ) ) ) )
what is the average population per square km in state is the city denver located in ?	_answer ( A , ( _density ( B , A ) , _state ( B ) , _city ( C ) , _const ( C , _cityid ( denver , _ ) ) , _loc ( C , B ) ) )
in which state is the capital of the alabama state ?	_answer ( A , ( _loc ( B , A ) , _state ( A ) , _capital ( B ) , _loc ( B , C ) , _const ( C , _stateid ( alabama ) ) , _state ( C ) ) )
how many rivers in state has the smallest area ?	_answer ( A , _count ( B , ( _river ( B ) , _loc ( B , C ) , _smallest ( D , ( _state ( C ) , _area ( C , D ) ) ) ) , A ) )
how many states border the state with the lowest population ?	_answer ( A , _count ( B , ( _state ( B ) , _next_to ( B , C ) , _smallest ( D , ( _state ( C ) , _population ( C , D ) ) ) ) , A ) )
what state is mount mckinley city has the largest population ?	_answer ( A , _largest ( B , ( _loc ( D , C ) , _state ( C ) , _const ( D , _placeid ( ' mount mckinley ' ) ) , _city ( A ) , _loc ( A , C ) , _population ( A , B ) ) ) )
how many major cities are in state has the smallest area ?	_answer ( A , _count ( B , ( _major ( B ) , _city ( B ) , _loc ( B , C ) , _smallest ( D , ( _state ( C ) , _area ( C , D ) ) ) ) , A ) )
what is the total population of the states that border the neighboring states for michigan ?	_answer ( A , _sum ( C , ( _state ( C ) , _next_to ( D , C ) , _next_to ( D , E ) , _state ( D ) , _const ( E , _stateid ( michigan ) ) ) , _population ( C ) , A ) )
what is the longest river in the smallest state in the usa ?	_answer ( A , _longest ( A , ( _river ( A ) , _loc ( A , B ) , _smallest ( B , ( _state ( B ) , _loc ( B , C ) , _const ( C , _countryid ( usa ) ) ) ) ) ) )
what are the populations of states through which the rivers are in alaska run ?	_answer ( A , ( _population ( B , A ) , _state ( B ) , _river ( C ) , _loc ( C , D ) , _const ( D , _stateid ( alaska ) ) , _river ( C ) , _traverse ( C , B ) ) )
what is the adjacent state of the states through which the longest river runs ?	_answer ( A , ( _next_to ( A , B ) , _state ( A ) , _state ( B ) , _longest ( C , ( _river ( C ) , _traverse ( C , B ) ) ) ) )
what is the total population of the states that border the states which have no surrounding states ?	_answer ( A , _sum ( C , ( _state ( C ) , _next_to ( D , C ) , _state ( D ) , \+ ( _next_to ( D , E ) , _state ( E ) ) ) , _population ( C ) , A ) )
what is the capital of the states high point are higher than that of colorado state ?	_answer ( A , ( _capital ( A ) , _loc ( A , B ) , _state ( B ) , _high_point ( B , C ) , _higher ( C , D ) , _high_point ( E , D ) , _const ( E , _stateid ( colorado ) ) , _state ( B ) ) )
what river flows through the states ?	_answer ( A , ( _river ( A ) , _traverse ( A , B ) , _state ( B ) ) )
what is the largest city in state has the highest peak in the country by population ?	_answer ( A , _largest ( B , ( _city ( A ) , _loc ( A , C ) , _highest ( D , ( _state ( C ) , _loc ( D , C ) , _mountain ( D ) ) ) , _population ( A , B ) ) ) )
how many rivers are in the biggest state in continental us ?	_answer ( A , _count ( B , ( _river ( B ) , _loc ( B , C ) , _largest ( C , ( _state ( C ) , _loc ( C , D ) , _const ( D , _countryid ( usa ) ) ) ) ) , A ) )
what is the most populated state bordering state border kentucky ?	_answer ( A , _largest ( B , ( _population ( A , B ) , _state ( A ) , _next_to ( A , C ) , _state ( C ) , _next_to ( C , D ) , _const ( D , _stateid ( kentucky ) ) ) ) )
what is the population of state has the smallest area ?	_answer ( A , ( _population ( B , A ) , _smallest ( C , ( _state ( B ) , _area ( B , C ) ) ) ) )
what is the smallest state that borders states does the mississippi river run through ?	_answer ( A , _smallest ( A , ( _state ( A ) , _next_to ( A , B ) , _state ( B ) , _const ( C , _riverid ( mississippi ) ) , _river ( C ) , _traverse ( C , B ) ) ) )
what are the names of the major cities in state has no rivers ?	_answer ( A , ( _major ( A ) , _city ( A ) , _loc ( A , B ) , _state ( B ) , \+ ( _loc ( C , B ) , _river ( C ) ) ) )
what is the longest river flowing through state has no rivers ?	_answer ( A , _longest ( A , ( _river ( A ) , _traverse ( A , B ) , _state ( B ) , \+ ( _loc ( C , B ) , _river ( C ) ) ) ) )
what is the river that cross over the states that border the state with the greatest population ?	_answer ( A , ( _river ( A ) , _traverse ( A , B ) , _state ( B ) , _next_to ( C , B ) , _largest ( D , ( _state ( C ) , _population ( C , D ) ) ) ) )
what is the smallest city in state has the longest river ?	_answer ( A , _smallest ( A , ( _city ( A ) , _loc ( A , B ) , _longest ( C , ( _state ( B ) , _loc ( C , B ) , _river ( C ) ) ) ) ) )
how long is the the longest river in america ?	_answer ( A , ( _len ( B , A ) , _longest ( B , ( _river ( B ) , _loc ( B , C ) , _const ( C , _countryid ( usa ) ) ) ) , _river ( B ) ) )
what river runs through states border colorado ?	_answer ( A , ( _river ( A ) , _traverse ( A , B ) , _state ( B ) , _next_to ( B , C ) , _const ( C , _stateid ( colorado ) ) ) )
what is the area of state has the highest peak in the country ?	_answer ( A , ( _area ( B , A ) , _highest ( C , ( _state ( B ) , _loc ( C , B ) , _mountain ( C ) ) ) ) )
what rivers run through states does the colorado river run through ?	_answer ( A , ( _river ( A ) , _traverse ( A , B ) , _state ( B ) , _const ( C , _riverid ( colorado ) ) , _river ( C ) , _traverse ( C , B ) ) )
which state border states border states that border colorado ?	_answer ( A , ( _state ( A ) , _next_to ( A , B ) , _state ( B ) , _next_to ( B , C ) , _state ( C ) , _next_to ( C , D ) , _const ( D , _stateid ( colorado ) ) ) )
which states does the the shortest river run through ?	_answer ( A , ( _state ( A ) , _shortest ( B , _river ( B ) ) , _river ( B ) , _traverse ( B , A ) ) )
which states does the the shortest river in the united states run through ?	_answer ( A , ( _state ( A ) , _shortest ( B , ( _river ( B ) , _loc ( B , C ) , _const ( C , _countryid ( usa ) ) ) ) , _river ( B ) , _traverse ( B , A ) ) )
what is the biggest city in states border arkansas ?	_answer ( A , _largest ( A , ( _city ( A ) , _loc ( A , B ) , _state ( B ) , _next_to ( B , C ) , _const ( C , _stateid ( arkansas ) ) ) ) )
what is the population of the states through which the longest river runs ?	_answer ( A , ( _population ( B , A ) , _state ( B ) , _longest ( C , ( _river ( C ) , _traverse ( C , B ) ) ) ) )
can you tell me the capital of the adjacent state of california ?	_answer ( A , ( _capital ( A ) , _loc ( A , B ) , _next_to ( B , C ) , _state ( B ) , _const ( C , _stateid ( california ) ) ) )
what is the highest point in the state with capital the biggest city in oregon ?	_answer ( A , _highest ( A , ( _place ( A ) , _loc ( A , B ) , _state ( B ) , _loc ( C , B ) , _capital ( C ) , _largest ( C , ( _city ( C ) , _loc ( C , D ) , _const ( D , _stateid ( oregon ) ) ) ) ) ) )
what is the smallest city in the state with the lowest population ?	_answer ( A , _smallest ( A , ( _city ( A ) , _loc ( A , B ) , _smallest ( C , ( _state ( B ) , _population ( B , C ) ) ) ) ) )
what is the biggest city in the most populated state bordering oklahoma ?	_answer ( A , _largest ( A , ( _city ( A ) , _loc ( A , B ) , _largest ( C , ( _population ( B , C ) , _state ( B ) , _next_to ( B , D ) , _const ( D , _stateid ( oklahoma ) ) ) ) ) ) )
give me the cities which are in the adjacent state of california ?	_answer ( A , ( _city ( A ) , _loc ( A , B ) , _next_to ( B , C ) , _state ( B ) , _const ( C , _stateid ( california ) ) ) )
what is the number of neighboring states for state that borders texas is the largest ?	_answer ( A , _count ( B , ( _state ( B ) , _next_to ( B , C ) , _largest ( C , ( _state ( C ) , _next_to ( C , D ) , _const ( D , _stateid ( texas ) ) ) ) ) , A ) )
what is the longest river that runs through a state that borders the adjacent state of california ?	_answer ( A , _longest ( A , ( _river ( A ) , _traverse ( A , B ) , _state ( B ) , _next_to ( B , C ) , _next_to ( C , D ) , _state ( C ) , _const ( D , _stateid ( california ) ) ) ) )
how high is the highest point of the states which have no surrounding states ?	_answer ( A , ( _elevation ( B , A ) , _highest ( B , ( _place ( B ) , _loc ( B , C ) , _state ( C ) , \+ ( _next_to ( C , D ) , _state ( D ) ) ) ) ) )
what are the neighboring states for state is the city denver located in ?	_answer ( A , ( _next_to ( A , B ) , _state ( A ) , _state ( B ) , _city ( C ) , _const ( C , _cityid ( denver , _ ) ) , _loc ( C , B ) ) )
what is the adjacent state of state has the largest city ?	_answer ( A , ( _next_to ( A , B ) , _state ( A ) , _largest ( C , ( _state ( B ) , _loc ( C , B ) , _city ( C ) ) ) ) )
what is the area of states have rivers named colorado ?	_answer ( A , ( _area ( B , A ) , _state ( B ) , _loc ( C , B ) , _const ( C , _riverid ( colorado ) ) ) )
what states border states border georgia ?	_answer ( A , ( _state ( A ) , _next_to ( A , B ) , _state ( B ) , _next_to ( B , C ) , _const ( C , _stateid ( georgia ) ) ) )
which states have points that are higher than the highest point in state has the smallest population density ?	_answer ( A , ( _state ( A ) , _place ( B ) , _loc ( B , A ) , _higher ( B , C ) , _highest ( C , ( _place ( C ) , _loc ( C , D ) , _smallest ( E , ( _state ( D ) , _density ( D , E ) ) ) ) ) ) )
what is the population of the biggest city in the usa ga ?	_answer ( A , ( _population ( B , A ) , _largest ( B , ( _city ( B ) , _loc ( B , C ) , _const ( C , _countryid ( usa ) ) ) ) ) )
what are the names of the major cities in states neighbor maine ?	_answer ( A , ( _major ( A ) , _city ( A ) , _loc ( A , B ) , _state ( B ) , _next_to ( B , C ) , _const ( C , _stateid ( maine ) ) ) )
what is the lowest elevation in states high point are higher than that of colorado ?	_answer ( A , _lowest ( A , ( _place ( A ) , _loc ( A , B ) , _state ( B ) , _high_point ( B , C ) , _higher ( C , D ) , _high_point ( E , D ) , _const ( E , _stateid ( colorado ) ) ) ) )
how many people live in state does the highest point in usa exist ?	_answer ( A , ( _population ( B , A ) , _loc ( C , B ) , _state ( B ) , _highest ( C , ( _place ( C ) , _loc ( C , D ) , _const ( D , _countryid ( usa ) ) ) ) ) )
what is the most populated state bordering the states through which the longest river runs ?	_answer ( A , _largest ( B , ( _population ( A , B ) , _state ( A ) , _next_to ( A , C ) , _state ( C ) , _longest ( D , ( _river ( D ) , _traverse ( D , C ) ) ) ) ) )
what states have a city named the major cities of the us ?	_answer ( A , ( _state ( A ) , _loc ( B , A ) , _major ( B ) , _city ( B ) , _loc ( B , C ) , _const ( C , _countryid ( usa ) ) ) )
what are the biggest rivers in the states through which the longest river runs ?	_answer ( A , _longest ( A , ( _river ( A ) , _loc ( A , B ) , _state ( B ) , _longest ( C , ( _river ( C ) , _traverse ( C , B ) ) ) ) ) )
which state border the states which have no surrounding states ?	_answer ( A , ( _state ( A ) , _next_to ( A , B ) , _state ( B ) , \+ ( _next_to ( B , C ) , _state ( C ) ) ) )
what is the highest point in states have a city named austin ?	_answer ( A , _highest ( A , ( _place ( A ) , _loc ( A , B ) , _state ( B ) , _loc ( C , B ) , _const ( C , _cityid ( austin , _ ) ) ) ) )
what is the longest river in the states which have no surrounding states ?	_answer ( A , _longest ( A , ( _river ( A ) , _loc ( A , B ) , _state ( B ) , \+ ( _next_to ( B , C ) , _state ( C ) ) ) ) )
what river runs through states high point are higher than that of colorado ?	_answer ( A , ( _river ( A ) , _traverse ( A , B ) , _state ( B ) , _high_point ( B , C ) , _higher ( C , D ) , _high_point ( E , D ) , _const ( E , _stateid ( colorado ) ) ) )
what states high point are higher than that of state is rochester ?	_answer ( A , ( _state ( A ) , _high_point ( A , B ) , _higher ( B , C ) , _high_point ( D , C ) , _loc ( E , D ) , _state ( D ) , _const ( E , _cityid ( rochester , _ ) ) ) )
what is the biggest city in states have a city named austin ?	_answer ( A , _largest ( A , ( _city ( A ) , _loc ( A , B ) , _state ( B ) , _loc ( C , B ) , _const ( C , _cityid ( austin , _ ) ) ) ) )
what is the highest elevation in states border kentucky ?	_answer ( A , _highest ( A , ( _place ( A ) , _loc ( A , B ) , _state ( B ) , _next_to ( B , C ) , _const ( C , _stateid ( kentucky ) ) ) ) )
what river flows through the largest state bordering texas ?	_answer ( A , ( _river ( A ) , _traverse ( A , B ) , _largest ( B , ( _state ( B ) , _next_to ( B , C ) , _const ( C , _stateid ( texas ) ) ) ) ) )
what is the smallest city in the smallest state through which the longest river runs ?	_answer ( A , _smallest ( A , ( _city ( A ) , _loc ( A , B ) , _smallest ( B , ( _state ( B ) , _longest ( C , _river ( C ) ) , _traverse ( C , B ) ) ) ) ) )
what is the population of the largest cities in the states that border the largest state ga ?	_answer ( A , ( _population ( B , A ) , _largest ( B , ( _city ( B ) , _loc ( B , C ) , _state ( C ) , _next_to ( C , D ) , _largest ( D , _state ( D ) ) ) ) ) )
could you tell me what is the highest point in the state of states border texas ?	_answer ( A , _highest ( A , ( _place ( A ) , _loc ( A , B ) , _state ( B ) , _state ( B ) , _next_to ( B , C ) , _const ( C , _stateid ( texas ) ) ) ) )
what is the highest mountain in the states through which the longest river runs ?	_answer ( A , _highest ( A , ( _mountain ( A ) , _loc ( A , B ) , _state ( B ) , _longest ( C , ( _river ( C ) , _traverse ( C , B ) ) ) ) ) )
can you tell me the capital of states does the mississippi river run through ?	_answer ( A , ( _capital ( A ) , _loc ( A , B ) , _state ( B ) , _const ( C , _riverid ( mississippi ) ) , _river ( C ) , _traverse ( C , B ) ) )
which state is the city the capital of texas located in ?	_answer ( A , ( _state ( A ) , _city ( B ) , _capital ( B ) , _loc ( B , C ) , _const ( C , _stateid ( texas ) ) , _loc ( B , A ) ) )
what is the average population per square km in states have rivers named colorado ?	_answer ( A , ( _density ( B , A ) , _state ( B ) , _loc ( C , B ) , _const ( C , _riverid ( colorado ) ) ) )
which states have points that are higher than the highest point in the state with the lowest population ?	_answer ( A , ( _state ( A ) , _place ( B ) , _loc ( B , A ) , _higher ( B , C ) , _highest ( C , ( _place ( C ) , _loc ( C , D ) , _smallest ( E , ( _state ( D ) , _population ( D , E ) ) ) ) ) ) )
what states high point are higher than that of states have a city named austin ?	_answer ( A , ( _state ( A ) , _high_point ( A , B ) , _higher ( B , C ) , _high_point ( D , C ) , _state ( D ) , _loc ( E , D ) , _const ( E , _cityid ( austin , _ ) ) ) )
which rivers are in states high point are higher than that of colorado ?	_answer ( A , ( _river ( A ) , _loc ( A , B ) , _state ( B ) , _high_point ( B , C ) , _higher ( C , D ) , _high_point ( E , D ) , _const ( E , _stateid ( colorado ) ) ) )
how many rivers are in states neighbor maine ?	_answer ( A , _count ( B , ( _river ( B ) , _loc ( B , C ) , _state ( C ) , _next_to ( C , D ) , _const ( D , _stateid ( maine ) ) ) , A ) )
what are the names of the major cities in the states that the potomac run through ?	_answer ( A , ( _major ( A ) , _city ( A ) , _loc ( A , B ) , _state ( B ) , _const ( C , _riverid ( potomac ) ) , _traverse ( C , B ) ) )
what is the highest mountain in states have rivers named colorado ?	_answer ( A , _highest ( A , ( _mountain ( A ) , _loc ( A , B ) , _state ( B ) , _loc ( C , B ) , _const ( C , _riverid ( colorado ) ) ) ) )
what are the biggest rivers in state has the largest city ?	_answer ( A , _longest ( A , ( _river ( A ) , _loc ( A , B ) , _largest ( C , ( _state ( B ) , _loc ( C , B ) , _city ( C ) ) ) ) ) )
what is the average population per square km in states border kentucky ?	_answer ( A , ( _density ( B , A ) , _state ( B ) , _next_to ( B , C ) , _const ( C , _stateid ( kentucky ) ) ) )
what is the largest city in state has the smallest area by population ?	_answer ( A , _largest ( B , ( _city ( A ) , _loc ( A , C ) , _smallest ( D , ( _state ( C ) , _area ( C , D ) ) ) , _population ( A , B ) ) ) )
what rivers are in the biggest state in continental us ?	_answer ( A , ( _river ( A ) , _loc ( A , B ) , _largest ( B , ( _state ( B ) , _loc ( B , C ) , _const ( C , _countryid ( usa ) ) ) ) ) )
which state is the city the major cities in the smallest state in the us located in ?	_answer ( A , ( _state ( A ) , _city ( B ) , _major ( B ) , _city ( B ) , _loc ( B , C ) , _smallest ( C , ( _state ( C ) , _loc ( C , D ) , _const ( D , _countryid ( usa ) ) ) ) , _loc ( B , A ) ) )
what is the area of state has the longest river ?	_answer ( A , ( _area ( B , A ) , _longest ( C , ( _state ( B ) , _loc ( C , B ) , _river ( C ) ) ) ) )
what states border state has the highest peak in the country ?	_answer ( A , ( _state ( A ) , _next_to ( A , B ) , _highest ( C , ( _state ( B ) , _loc ( C , B ) , _mountain ( C ) ) ) ) )
in which state is the largest city in minnesota by population ?	_answer ( A , ( _loc ( B , A ) , _state ( A ) , _largest ( C , ( _city ( B ) , _loc ( B , D ) , _const ( D , _stateid ( minnesota ) ) , _population ( B , C ) ) ) ) )
what is the highest elevation in states does the colorado river run through ?	_answer ( A , _highest ( A , ( _place ( A ) , _loc ( A , B ) , _state ( B ) , _const ( C , _riverid ( colorado ) ) , _river ( C ) , _traverse ( C , B ) ) ) )
what are the neighboring states for the smallest state that borders texas ?	_answer ( A , ( _next_to ( A , B ) , _state ( A ) , _smallest ( B , ( _state ( B ) , _next_to ( B , C ) , _const ( C , _stateid ( texas ) ) ) ) ) )
what is the longest river in the state with the lowest point ?	_answer ( A , _longest ( A , ( _river ( A ) , _loc ( A , B ) , _state ( B ) , _loc ( C , B ) , _lowest ( C , _place ( C ) ) ) ) )
what is capital of state is the largest city in montana in ?	_answer ( A , ( _capital ( A ) , _loc ( A , B ) , _state ( B ) , _largest ( C , ( _city ( C ) , _loc ( C , D ) , _const ( D , _stateid ( montana ) ) ) ) , _loc ( C , B ) ) )
what are the capitals of the states that border state is the city denver located in ?	_answer ( A , ( _capital ( A ) , _loc ( A , B ) , _state ( B ) , _next_to ( B , C ) , _state ( C ) , _city ( D ) , _const ( D , _cityid ( denver , _ ) ) , _loc ( D , C ) ) )
how many major cities are in states border kentucky ?	_answer ( A , _count ( B , ( _major ( B ) , _city ( B ) , _loc ( B , C ) , _state ( C ) , _next_to ( C , D ) , _const ( D , _stateid ( kentucky ) ) ) , A ) )
what is the biggest city in state has the highest population density ?	_answer ( A , _largest ( A , ( _city ( A ) , _loc ( A , B ) , _largest ( C , ( _state ( B ) , _density ( B , C ) ) ) ) ) )
what rivers are in states high point are higher than that of colorado ?	_answer ( A , ( _river ( A ) , _loc ( A , B ) , _state ( B ) , _high_point ( B , C ) , _higher ( C , D ) , _high_point ( E , D ) , _const ( E , _stateid ( colorado ) ) ) )
which state is the largest city in states does the colorado river run through in ?	_answer ( A , ( _state ( A ) , _largest ( B , ( _city ( B ) , _loc ( B , C ) , _state ( C ) , _const ( D , _riverid ( colorado ) ) , _river ( D ) , _traverse ( D , C ) ) ) , _loc ( B , A ) ) )
how many people live in the major cities in delaware ?	_answer ( A , ( _population ( B , A ) , _major ( B ) , _city ( B ) , _loc ( B , C ) , _const ( C , _stateid ( delaware ) ) ) )
what are the states that the rivers are in utah run through ?	_answer ( A , ( _state ( A ) , _river ( B ) , _loc ( B , C ) , _const ( C , _stateid ( utah ) ) , _traverse ( B , A ) ) )
what are the states that the rivers run through colorado run through ?	_answer ( A , ( _state ( A ) , _river ( B ) , _traverse ( B , C ) , _const ( C , _stateid ( colorado ) ) , _traverse ( B , A ) ) )
what are the neighboring states for state is rochester ?	_answer ( A , ( _next_to ( A , B ) , _state ( A ) , _loc ( C , B ) , _state ( B ) , _const ( C , _cityid ( rochester , _ ) ) ) )
what states does the major rivers run through illinois run through ?	_answer ( A , ( _state ( A ) , _major ( B ) , _river ( B ) , _traverse ( B , C ) , _const ( C , _stateid ( illinois ) ) , _river ( B ) , _traverse ( B , A ) ) )
what rivers are in state is rochester ?	_answer ( A , ( _river ( A ) , _loc ( A , B ) , _loc ( C , B ) , _state ( B ) , _const ( C , _cityid ( rochester , _ ) ) ) )
how long is the the biggest river in illinois ?	_answer ( A , ( _len ( B , A ) , _largest ( B , ( _river ( B ) , _loc ( B , C ) , _const ( C , _stateid ( illinois ) ) ) ) , _river ( B ) ) )
which state border state has the shortest river ?	_answer ( A , ( _state ( A ) , _next_to ( A , B ) , _state ( B ) , _loc ( C , B ) , _shortest ( C , _river ( C ) ) ) )
what is the highest mountain in the states that border the state with the greatest population ?	_answer ( A , _highest ( A , ( _mountain ( A ) , _loc ( A , B ) , _state ( B ) , _next_to ( C , B ) , _largest ( D , ( _state ( C ) , _population ( C , D ) ) ) ) ) )
what is the smallest city in state is mount mckinley ?	_answer ( A , _smallest ( A , ( _city ( A ) , _loc ( A , B ) , _loc ( C , B ) , _state ( B ) , _const ( C , _placeid ( ' mount mckinley ' ) ) ) ) )
what are the capitals of the states that border states border arkansas ?	_answer ( A , ( _capital ( A ) , _loc ( A , B ) , _state ( B ) , _next_to ( B , C ) , _state ( C ) , _next_to ( C , D ) , _const ( D , _stateid ( arkansas ) ) ) )
what states border the state with the lowest point ?	_answer ( A , ( _state ( A ) , _next_to ( A , B ) , _state ( B ) , _loc ( C , B ) , _lowest ( C , _place ( C ) ) ) )
what rivers are in state has the largest population density ?	_answer ( A , ( _river ( A ) , _loc ( A , B ) , _largest ( C , ( _state ( B ) , _density ( B , C ) ) ) ) )
what rivers are in the states that border the state with the greatest population ?	_answer ( A , ( _river ( A ) , _loc ( A , B ) , _state ( B ) , _next_to ( C , B ) , _largest ( D , ( _state ( C ) , _population ( C , D ) ) ) ) )
where is state border kentucky ?	_answer ( A , ( _loc ( B , A ) , _state ( B ) , _next_to ( B , C ) , _const ( C , _stateid ( kentucky ) ) ) )
what states border the biggest state in continental us ?	_answer ( A , ( _state ( A ) , _next_to ( A , B ) , _largest ( B , ( _state ( B ) , _loc ( B , C ) , _const ( C , _countryid ( usa ) ) ) ) ) )
what is the size of state has the smallest area ?	_answer ( A , ( _size ( B , A ) , _smallest ( C , ( _state ( B ) , _area ( B , C ) ) ) ) )
could you tell me what is the highest point in the state of states have a city named austin ?	_answer ( A , _highest ( A , ( _place ( A ) , _loc ( A , B ) , _state ( B ) , _state ( B ) , _loc ( C , B ) , _const ( C , _cityid ( austin , _ ) ) ) ) )
what states border states have a city named austin ?	_answer ( A , ( _state ( A ) , _next_to ( A , B ) , _state ( B ) , _loc ( C , B ) , _const ( C , _cityid ( austin , _ ) ) ) )
how many rivers are in states border rhode island ?	_answer ( A , _count ( B , ( _river ( B ) , _loc ( B , C ) , _state ( C ) , _next_to ( C , D ) , _const ( D , _stateid ( ' rhode island ' ) ) ) , A ) )
what are the populations of the states through which the the shortest river in the usa run ?	_answer ( A , ( _population ( B , A ) , _state ( B ) , _shortest ( C , ( _river ( C ) , _loc ( C , D ) , _const ( D , _countryid ( usa ) ) ) ) , _river ( C ) , _traverse ( C , B ) ) )
what is the longest river that runs through a state that borders the states which have no surrounding states ?	_answer ( A , _longest ( A , ( _river ( A ) , _traverse ( A , B ) , _state ( B ) , _next_to ( B , C ) , _state ( C ) , \+ ( _next_to ( C , D ) , _state ( D ) ) ) ) )
which states border state has the largest city ?	_answer ( A , ( _state ( A ) , _next_to ( A , B ) , _largest ( C , ( _state ( B ) , _loc ( C , B ) , _city ( C ) ) ) ) )
what state has the city with the largest population city has the largest population ?	_answer ( A , _largest ( B , ( _state ( C ) , _loc ( D , C ) , _largest ( E , ( _city ( D ) , _population ( D , E ) ) ) , _city ( A ) , _loc ( A , C ) , _population ( A , B ) ) ) )
how many people live in state has the largest population density ?	_answer ( A , ( _population ( B , A ) , _largest ( C , ( _state ( B ) , _density ( B , C ) ) ) ) )
what are the high points of states surrounding state has no rivers ?	_answer ( A , ( _high_point ( B , A ) , _loc ( A , B ) , _state ( B ) , _next_to ( B , C ) , _state ( C ) , \+ ( _loc ( D , C ) , _river ( D ) ) ) )
what is the capital of the state has the shortest river state ?	_answer ( A , ( _capital ( A ) , _loc ( A , B ) , _state ( B ) , _loc ( C , B ) , _shortest ( C , _river ( C ) ) , _state ( B ) ) )
what river runs through the biggest state in continental us ?	_answer ( A , ( _river ( A ) , _traverse ( A , B ) , _largest ( B , ( _state ( B ) , _loc ( B , C ) , _const ( C , _countryid ( usa ) ) ) ) ) )
can you tell me the capital of state has the largest population density ?	_answer ( A , ( _capital ( A ) , _loc ( A , B ) , _largest ( C , ( _state ( B ) , _density ( B , C ) ) ) ) )
in which state is the biggest city in nebraska ?	_answer ( A , ( _loc ( B , A ) , _state ( A ) , _largest ( B , ( _city ( B ) , _loc ( B , C ) , _const ( C , _stateid ( nebraska ) ) ) ) ) )
how many rivers in state has the city with the largest population ?	_answer ( A , _count ( B , ( _river ( B ) , _loc ( B , C ) , _state ( C ) , _loc ( D , C ) , _largest ( E , ( _city ( D ) , _population ( D , E ) ) ) ) , A ) )
which state is the largest city in states border arkansas in ?	_answer ( A , ( _state ( A ) , _largest ( B , ( _city ( B ) , _loc ( B , C ) , _state ( C ) , _next_to ( C , D ) , _const ( D , _stateid ( arkansas ) ) ) ) , _loc ( B , A ) ) )
how many states does states does the longest river cross border ?	_answer ( A , _count ( B , ( _state ( B ) , _state ( C ) , _longest ( D , _river ( D ) ) , _traverse ( D , C ) , _next_to ( C , B ) ) , A ) )
what states high point are higher than that of state has the highest peak in the country ?	_answer ( A , ( _state ( A ) , _high_point ( A , B ) , _higher ( B , C ) , _high_point ( D , C ) , _highest ( E , ( _state ( D ) , _loc ( E , D ) , _mountain ( E ) ) ) ) )
what are the biggest rivers in states border colorado ?	_answer ( A , _longest ( A , ( _river ( A ) , _loc ( A , B ) , _state ( B ) , _next_to ( B , C ) , _const ( C , _stateid ( colorado ) ) ) ) )
what is the size of state does the highest point in usa exist ?	_answer ( A , ( _size ( B , A ) , _loc ( C , B ) , _state ( B ) , _highest ( C , ( _place ( C ) , _loc ( C , D ) , _const ( D , _countryid ( usa ) ) ) ) ) )
how many states border states border colorado ?	_answer ( A , _count ( B , ( _state ( B ) , _next_to ( B , C ) , _state ( C ) , _next_to ( C , D ) , _const ( D , _stateid ( colorado ) ) ) , A ) )
what is the highest mountain in the neighboring states for michigan ?	_answer ( A , _highest ( A , ( _mountain ( A ) , _loc ( A , B ) , _next_to ( B , C ) , _state ( B ) , _const ( C , _stateid ( michigan ) ) ) ) )
what are the capitals of the states that border states does the colorado river run through ?	_answer ( A , ( _capital ( A ) , _loc ( A , B ) , _state ( B ) , _next_to ( B , C ) , _state ( C ) , _const ( D , _riverid ( colorado ) ) , _river ( D ) , _traverse ( D , C ) ) )
what is the area of states border states through which the mississippi traverses ?	_answer ( A , ( _area ( B , A ) , _state ( B ) , _next_to ( B , C ) , _state ( C ) , _const ( D , _riverid ( mississippi ) ) , _traverse ( D , C ) ) )
what is the adjacent state of the state with the lowest point ?	_answer ( A , ( _next_to ( A , B ) , _state ( A ) , _state ( B ) , _loc ( C , B ) , _lowest ( C , _place ( C ) ) ) )
what is the capital of the state has the largest population density state ?	_answer ( A , ( _capital ( A ) , _loc ( A , B ) , _largest ( C , ( _state ( B ) , _density ( B , C ) ) ) , _state ( B ) ) )
what is the highest mountain in state that borders texas is the largest ?	_answer ( A , _highest ( A , ( _mountain ( A ) , _loc ( A , B ) , _largest ( B , ( _state ( B ) , _next_to ( B , C ) , _const ( C , _stateid ( texas ) ) ) ) ) ) )
name all the rivers in the neighboring states for michigan ?	_answer ( A , ( _river ( A ) , _loc ( A , B ) , _next_to ( B , C ) , _state ( B ) , _const ( C , _stateid ( michigan ) ) ) )
what is the longest river flowing through the biggest state in continental us ?	_answer ( A , _longest ( A , ( _river ( A ) , _traverse ( A , B ) , _largest ( B , ( _state ( B ) , _loc ( B , C ) , _const ( C , _countryid ( usa ) ) ) ) ) ) )
what is the capital of the the smallest state through which the longest river runs state ?	_answer ( A , ( _capital ( A ) , _loc ( A , B ) , _smallest ( B , ( _state ( B ) , _longest ( C , _river ( C ) ) , _traverse ( C , B ) ) ) , _state ( B ) ) )
what is the number of neighboring states for state has the smallest area ?	_answer ( A , _count ( B , ( _state ( B ) , _next_to ( B , C ) , _smallest ( D , ( _state ( C ) , _area ( C , D ) ) ) ) , A ) )
what is capital of states neighbor maine ?	_answer ( A , ( _capital ( A ) , _loc ( A , B ) , _state ( B ) , _next_to ( B , C ) , _const ( C , _stateid ( maine ) ) ) )
how many citizens in state is mount mckinley ?	_answer ( A , ( _population ( B , A ) , _loc ( C , B ) , _state ( B ) , _const ( C , _placeid ( ' mount mckinley ' ) ) ) )
what are the high points of states surrounding state has the largest population density ?	_answer ( A , ( _high_point ( B , A ) , _loc ( A , B ) , _state ( B ) , _next_to ( B , C ) , _largest ( D , ( _state ( C ) , _density ( C , D ) ) ) ) )
what cities are located in state is rochester ?	_answer ( A , ( _city ( A ) , _loc ( A , B ) , _loc ( C , B ) , _state ( B ) , _const ( C , _cityid ( rochester , _ ) ) ) )
what are the names of the major cities in the adjacent state of california ?	_answer ( A , ( _major ( A ) , _city ( A ) , _loc ( A , B ) , _next_to ( B , C ) , _state ( B ) , _const ( C , _stateid ( california ) ) ) )
what is the longest river that runs through a state that borders state has the highest peak in the country ?	_answer ( A , _longest ( A , ( _river ( A ) , _traverse ( A , B ) , _state ( B ) , _next_to ( B , C ) , _highest ( D , ( _state ( C ) , _loc ( D , C ) , _mountain ( D ) ) ) ) ) )
how many major cities are in the smallest state through which the longest river runs ?	_answer ( A , _count ( B , ( _major ( B ) , _city ( B ) , _loc ( B , C ) , _smallest ( C , ( _state ( C ) , _longest ( D , _river ( D ) ) , _traverse ( D , C ) ) ) ) , A ) )
give me the cities which are in state has the highest population density ?	_answer ( A , ( _city ( A ) , _loc ( A , B ) , _largest ( C , ( _state ( B ) , _density ( B , C ) ) ) ) )
what is the population of the biggest state in continental us ?	_answer ( A , ( _population ( B , A ) , _largest ( B , ( _state ( B ) , _loc ( B , C ) , _const ( C , _countryid ( usa ) ) ) ) ) )
which states border states through which the rivers run through colorado traverses ?	_answer ( A , ( _state ( A ) , _next_to ( A , B ) , _state ( B ) , _river ( C ) , _traverse ( C , D ) , _const ( D , _stateid ( colorado ) ) , _traverse ( C , B ) ) )
what is the highest mountain in state has the longest river ?	_answer ( A , _highest ( A , ( _mountain ( A ) , _loc ( A , B ) , _longest ( C , ( _state ( B ) , _loc ( C , B ) , _river ( C ) ) ) ) ) )
what is the lowest point in state has the city with the largest population ?	_answer ( A , _lowest ( A , ( _place ( A ) , _loc ( A , B ) , _state ( B ) , _loc ( C , B ) , _largest ( D , ( _city ( C ) , _population ( C , D ) ) ) ) ) )
which state border states border arkansas ?	_answer ( A , ( _state ( A ) , _next_to ( A , B ) , _state ( B ) , _next_to ( B , C ) , _const ( C , _stateid ( arkansas ) ) ) )
what is the size of states border states through which the mississippi traverses ?	_answer ( A , ( _size ( B , A ) , _state ( B ) , _next_to ( B , C ) , _state ( C ) , _const ( D , _riverid ( mississippi ) ) , _traverse ( D , C ) ) )
what states border the states ?	_answer ( A , ( _state ( A ) , _next_to ( A , B ) , _state ( B ) ) )
what states border state has the smallest population density ?	_answer ( A , ( _state ( A ) , _next_to ( A , B ) , _smallest ( C , ( _state ( B ) , _density ( B , C ) ) ) ) )
which state is the largest city in states neighbor maine in ?	_answer ( A , ( _state ( A ) , _largest ( B , ( _city ( B ) , _loc ( B , C ) , _state ( C ) , _next_to ( C , D ) , _const ( D , _stateid ( maine ) ) ) ) , _loc ( B , A ) ) )
what is the lowest point in state has the largest population density ?	_answer ( A , _lowest ( A , ( _place ( A ) , _loc ( A , B ) , _largest ( C , ( _state ( B ) , _density ( B , C ) ) ) ) ) )
how many rivers in the biggest state in continental us ?	_answer ( A , _count ( B , ( _river ( B ) , _loc ( B , C ) , _largest ( C , ( _state ( C ) , _loc ( C , D ) , _const ( D , _countryid ( usa ) ) ) ) ) , A ) )
how many rivers are in the smallest state through which the longest river runs ?	_answer ( A , _count ( B , ( _river ( B ) , _loc ( B , C ) , _smallest ( C , ( _state ( C ) , _longest ( D , _river ( D ) ) , _traverse ( D , C ) ) ) ) , A ) )
name all the rivers in the states that border the state with the greatest population ?	_answer ( A , ( _river ( A ) , _loc ( A , B ) , _state ( B ) , _next_to ( C , B ) , _largest ( D , ( _state ( C ) , _population ( C , D ) ) ) ) )
how many rivers are in state has the largest city ?	_answer ( A , _count ( B , ( _river ( B ) , _loc ( B , C ) , _largest ( D , ( _state ( C ) , _loc ( D , C ) , _city ( D ) ) ) ) , A ) )
what is the area of the states which have no surrounding states ?	_answer ( A , ( _area ( B , A ) , _state ( B ) , \+ ( _next_to ( B , C ) , _state ( C ) ) ) )
what is the number of neighboring states for states border states through which the mississippi traverses ?	_answer ( A , _count ( B , ( _state ( B ) , _next_to ( B , C ) , _state ( C ) , _next_to ( C , D ) , _state ( D ) , _const ( E , _riverid ( mississippi ) ) , _traverse ( E , D ) ) , A ) )
how many states border state has the most rivers running through it ?	_answer ( A , _count ( B , ( _state ( B ) , _next_to ( B , C ) , _most ( C , D , ( _state ( C ) , _loc ( D , C ) , _river ( D ) , _traverse ( D , C ) ) ) ) , A ) )
what cities are located in the adjacent state of california ?	_answer ( A , ( _city ( A ) , _loc ( A , B ) , _next_to ( B , C ) , _state ( B ) , _const ( C , _stateid ( california ) ) ) )
what is the capital of the state is mount mckinley state ?	_answer ( A , ( _capital ( A ) , _loc ( A , B ) , _loc ( C , B ) , _state ( B ) , _const ( C , _placeid ( ' mount mckinley ' ) ) , _state ( B ) ) )
what is the longest river in state has the longest river ?	_answer ( A , _longest ( A , ( _river ( A ) , _loc ( A , B ) , _longest ( C , ( _state ( B ) , _loc ( C , B ) , _river ( C ) ) ) ) ) )
what are the rivers in the state of state has the largest population density ?	_answer ( A , ( _river ( A ) , _loc ( A , B ) , _state ( B ) , _largest ( C , ( _state ( B ) , _density ( B , C ) ) ) ) )
what is the population of s the largest city ?	_answer ( A , ( _population ( B , A ) , _largest ( B , _city ( B ) ) ) )
what are the populations of the states through which the rivers run through colorado run ?	_answer ( A , ( _population ( B , A ) , _state ( B ) , _river ( C ) , _traverse ( C , D ) , _const ( D , _stateid ( colorado ) ) , _river ( C ) , _traverse ( C , B ) ) )
where is the major cities in delaware ?	_answer ( A , ( _loc ( B , A ) , _major ( B ) , _city ( B ) , _loc ( B , C ) , _const ( C , _stateid ( delaware ) ) ) )
what river runs through state has the smallest area ?	_answer ( A , ( _river ( A ) , _traverse ( A , B ) , _smallest ( C , ( _state ( B ) , _area ( B , C ) ) ) ) )
how many people live in cities are located in pennsylvania ?	_answer ( A , ( _population ( B , A ) , _city ( B ) , _loc ( B , C ) , _const ( C , _stateid ( pennsylvania ) ) ) )
which state is the largest city in the states that the potomac run through in ?	_answer ( A , ( _state ( A ) , _largest ( B , ( _city ( B ) , _loc ( B , C ) , _state ( C ) , _const ( D , _riverid ( potomac ) ) , _traverse ( D , C ) ) ) , _loc ( B , A ) ) )
what is the highest mountain in state has the city with the largest population ?	_answer ( A , _highest ( A , ( _mountain ( A ) , _loc ( A , B ) , _state ( B ) , _loc ( C , B ) , _largest ( D , ( _city ( C ) , _population ( C , D ) ) ) ) ) )
what is the lowest point of states border rhode island ?	_answer ( A , _lowest ( A , ( _place ( A ) , _loc ( A , B ) , _state ( B ) , _next_to ( B , C ) , _const ( C , _stateid ( ' rhode island ' ) ) ) ) )
what are the biggest rivers in states have a city named austin ?	_answer ( A , _longest ( A , ( _river ( A ) , _loc ( A , B ) , _state ( B ) , _loc ( C , B ) , _const ( C , _cityid ( austin , _ ) ) ) ) )
what is the adjacent state of the state with the lowest population ?	_answer ( A , ( _next_to ( A , B ) , _state ( A ) , _smallest ( C , ( _state ( B ) , _population ( B , C ) ) ) ) )
how many rivers are in state does the highest point in usa exist ?	_answer ( A , _count ( B , ( _river ( B ) , _loc ( B , C ) , _loc ( D , C ) , _state ( C ) , _highest ( D , ( _place ( D ) , _loc ( D , E ) , _const ( E , _countryid ( usa ) ) ) ) ) , A ) )
where is the major cities of the us ?	_answer ( A , ( _loc ( B , A ) , _major ( B ) , _city ( B ) , _loc ( B , C ) , _const ( C , _countryid ( usa ) ) ) )
what states border states that border states border georgia ?	_answer ( A , ( _state ( A ) , _next_to ( A , B ) , _state ( B ) , _next_to ( B , C ) , _state ( C ) , _next_to ( C , D ) , _const ( D , _stateid ( georgia ) ) ) )
what is the capital of the the smallest state in the usa state ?	_answer ( A , ( _capital ( A ) , _loc ( A , B ) , _smallest ( B , ( _state ( B ) , _loc ( B , C ) , _const ( C , _countryid ( usa ) ) ) ) , _state ( B ) ) )
what are the populations of the states through which the the longest river flowing through new york run ?	_answer ( A , ( _population ( B , A ) , _state ( B ) , _longest ( C , ( _river ( C ) , _traverse ( C , D ) , _const ( D , _stateid ( ' new york ' ) ) ) ) , _river ( C ) , _traverse ( C , B ) ) )
what is the largest city in states have rivers named colorado by population ?	_answer ( A , _largest ( B , ( _city ( A ) , _loc ( A , C ) , _state ( C ) , _loc ( D , C ) , _const ( D , _riverid ( colorado ) ) , _population ( A , B ) ) ) )
what river flows through state is mount mckinley ?	_answer ( A , ( _river ( A ) , _traverse ( A , B ) , _loc ( C , B ) , _state ( B ) , _const ( C , _placeid ( ' mount mckinley ' ) ) ) )
how many states have a city named the smallest city in arkansas ?	_answer ( A , _count ( B , ( _state ( B ) , _loc ( C , B ) , _smallest ( C , ( _city ( C ) , _loc ( C , D ) , _const ( D , _stateid ( arkansas ) ) ) ) ) , A ) )
what is the average population per square km in state has the longest river ?	_answer ( A , ( _density ( B , A ) , _longest ( C , ( _state ( B ) , _loc ( C , B ) , _river ( C ) ) ) ) )
what is the area of the smallest state through which the longest river runs ?	_answer ( A , ( _area ( B , A ) , _smallest ( B , ( _state ( B ) , _longest ( C , _river ( C ) ) , _traverse ( C , B ) ) ) ) )
what are the capitals of the states that border the states that the potomac run through ?	_answer ( A , ( _capital ( A ) , _loc ( A , B ) , _state ( B ) , _next_to ( B , C ) , _state ( C ) , _const ( D , _riverid ( potomac ) ) , _traverse ( D , C ) ) )
what is the number of neighboring states for the most populated state bordering oklahoma ?	_answer ( A , _count ( B , ( _state ( B ) , _next_to ( B , C ) , _largest ( D , ( _population ( C , D ) , _state ( C ) , _next_to ( C , E ) , _const ( E , _stateid ( oklahoma ) ) ) ) ) , A ) )
where is the neighboring states for michigan ?	_answer ( A , ( _loc ( B , A ) , _next_to ( B , C ) , _state ( B ) , _const ( C , _stateid ( michigan ) ) ) )
what is the largest city in the states which have no surrounding states ?	_answer ( A , _largest ( A , ( _city ( A ) , _loc ( A , B ) , _state ( B ) , \+ ( _next_to ( B , C ) , _state ( C ) ) ) ) )
how many rivers are in state has highest elevation ?	_answer ( A , _count ( B , ( _river ( B ) , _loc ( B , C ) , _state ( C ) , _loc ( D , C ) , _highest ( D , _place ( D ) ) ) , A ) )
what is the most populous city in the state with the lowest point ?	_answer ( B , _largest ( A , ( _population ( B , A ) , _city ( B ) , _loc ( B , C ) , _state ( C ) , _loc ( D , C ) , _lowest ( D , _place ( D ) ) ) ) )
what is the highest point in the state with capital the major cities in texas ?	_answer ( A , _highest ( A , ( _place ( A ) , _loc ( A , B ) , _state ( B ) , _loc ( C , B ) , _capital ( C ) , _major ( C ) , _city ( C ) , _loc ( C , D ) , _const ( D , _stateid ( texas ) ) ) ) )
which state border state has the most rivers running through it ?	_answer ( A , ( _state ( A ) , _next_to ( A , B ) , _most ( B , C , ( _state ( B ) , _loc ( C , B ) , _river ( C ) , _traverse ( C , B ) ) ) ) )
how many states border state has the longest river ?	_answer ( A , _count ( B , ( _state ( B ) , _next_to ( B , C ) , _longest ( D , ( _state ( C ) , _loc ( D , C ) , _river ( D ) ) ) ) , A ) )
how many people live in the biggest city in the usa ?	_answer ( A , ( _population ( B , A ) , _largest ( B , ( _city ( B ) , _loc ( B , C ) , _const ( C , _countryid ( usa ) ) ) ) ) )
what is the longest river in states does the colorado river run through ?	_answer ( A , _longest ( A , ( _river ( A ) , _loc ( A , B ) , _state ( B ) , _const ( C , _riverid ( colorado ) ) , _river ( C ) , _traverse ( C , B ) ) ) )
how long is the the shortest river ?	_answer ( A , ( _len ( B , A ) , _shortest ( B , _river ( B ) ) , _river ( B ) ) )
what is the adjacent state of state is the largest city in montana in ?	_answer ( A , ( _next_to ( A , B ) , _state ( A ) , _state ( B ) , _largest ( C , ( _city ( C ) , _loc ( C , D ) , _const ( D , _stateid ( montana ) ) ) ) , _loc ( C , B ) ) )
what is the number of neighboring states for state is the city denver located in ?	_answer ( A , _count ( B , ( _state ( B ) , _next_to ( B , C ) , _state ( C ) , _city ( D ) , _const ( D , _cityid ( denver , _ ) ) , _loc ( D , C ) ) , A ) )
what is the longest river that runs through a state that borders state has the longest river ?	_answer ( A , _longest ( A , ( _river ( A ) , _traverse ( A , B ) , _state ( B ) , _next_to ( B , C ) , _longest ( D , ( _state ( C ) , _loc ( D , C ) , _river ( D ) ) ) ) ) )
how many people live in s the largest city ?	_answer ( A , ( _population ( B , A ) , _largest ( B , _city ( B ) ) ) )
what is the lowest point in states high point are higher than that of colorado ?	_answer ( A , _lowest ( A , ( _place ( A ) , _loc ( A , B ) , _state ( B ) , _high_point ( B , C ) , _higher ( C , D ) , _high_point ( E , D ) , _const ( E , _stateid ( colorado ) ) ) ) )
what are the capitals of the states that border state has no rivers ?	_answer ( A , ( _capital ( A ) , _loc ( A , B ) , _state ( B ) , _next_to ( B , C ) , _state ( C ) , \+ ( _loc ( D , C ) , _river ( D ) ) ) )
what are the populations of states through which the rivers run through west virginia run ?	_answer ( A , ( _population ( B , A ) , _state ( B ) , _river ( C ) , _traverse ( C , D ) , _const ( D , _stateid ( ' west virginia ' ) ) , _river ( C ) , _traverse ( C , B ) ) )
what is the smallest city in states border kentucky ?	_answer ( A , _smallest ( A , ( _city ( A ) , _loc ( A , B ) , _state ( B ) , _next_to ( B , C ) , _const ( C , _stateid ( kentucky ) ) ) ) )
which states have points that are higher than the highest point in states border colorado ?	_answer ( A , ( _state ( A ) , _place ( B ) , _loc ( B , A ) , _higher ( B , C ) , _highest ( C , ( _place ( C ) , _loc ( C , D ) , _state ( D ) , _next_to ( D , E ) , _const ( E , _stateid ( colorado ) ) ) ) ) )
name all the rivers in state has the smallest population density ?	_answer ( A , ( _river ( A ) , _loc ( A , B ) , _smallest ( C , ( _state ( B ) , _density ( B , C ) ) ) ) )
which states border states through which the the rivers in the state of texas traverses ?	_answer ( A , ( _state ( A ) , _next_to ( A , B ) , _state ( B ) , _river ( C ) , _loc ( C , D ) , _state ( D ) , _const ( D , _stateid ( texas ) ) , _traverse ( C , B ) ) )
what is the river that cross over states border states that border colorado ?	_answer ( A , ( _river ( A ) , _traverse ( A , B ) , _state ( B ) , _next_to ( B , C ) , _state ( C ) , _next_to ( C , D ) , _const ( D , _stateid ( colorado ) ) ) )
in which state is the smallest city in hawaii ?	_answer ( A , ( _loc ( B , A ) , _state ( A ) , _smallest ( B , ( _city ( B ) , _loc ( B , C ) , _const ( C , _stateid ( hawaii ) ) ) ) ) )
what river flows through state has the most rivers running through it ?	_answer ( A , ( _river ( A ) , _traverse ( A , B ) , _most ( B , C , ( _state ( B ) , _loc ( C , B ) , _river ( C ) , _traverse ( C , B ) ) ) ) )
what states border states that border the states that border the state with the greatest population ?	_answer ( A , ( _state ( A ) , _next_to ( A , B ) , _state ( B ) , _next_to ( B , C ) , _state ( C ) , _next_to ( D , C ) , _largest ( E , ( _state ( D ) , _population ( D , E ) ) ) ) )
what are the biggest rivers in states high point are higher than that of colorado ?	_answer ( A , _longest ( A , ( _river ( A ) , _loc ( A , B ) , _state ( B ) , _high_point ( B , C ) , _higher ( C , D ) , _high_point ( E , D ) , _const ( E , _stateid ( colorado ) ) ) ) )
what states does the the shortest river run through ?	_answer ( A , ( _state ( A ) , _shortest ( B , _river ( B ) ) , _river ( B ) , _traverse ( B , A ) ) )
what states border states that border the states which have no surrounding states ?	_answer ( A , ( _state ( A ) , _next_to ( A , B ) , _state ( B ) , _next_to ( B , C ) , _state ( C ) , \+ ( _next_to ( C , D ) , _state ( D ) ) ) )
what is the total population of the states that border states does the mississippi river run through ?	_answer ( A , _sum ( C , ( _state ( C ) , _next_to ( D , C ) , _state ( D ) , _const ( E , _riverid ( mississippi ) ) , _river ( E ) , _traverse ( E , D ) ) , _population ( C ) , A ) )
what is the size of state has the city with the largest population ?	_answer ( A , ( _size ( B , A ) , _state ( B ) , _loc ( C , B ) , _largest ( D , ( _city ( C ) , _population ( C , D ) ) ) ) )
which state is the city the capital of hawaii located in ?	_answer ( A , ( _state ( A ) , _city ( B ) , _capital ( B ) , _loc ( B , C ) , _const ( C , _stateid ( hawaii ) ) , _loc ( B , A ) ) )
what is the highest elevation in states border colorado ?	_answer ( A , _highest ( A , ( _place ( A ) , _loc ( A , B ) , _state ( B ) , _next_to ( B , C ) , _const ( C , _stateid ( colorado ) ) ) ) )
what is the lowest point in state has no rivers ?	_answer ( A , _lowest ( A , ( _place ( A ) , _loc ( A , B ) , _state ( B ) , \+ ( _loc ( C , B ) , _river ( C ) ) ) ) )
what is the lowest point of states border texas ?	_answer ( A , _lowest ( A , ( _place ( A ) , _loc ( A , B ) , _state ( B ) , _next_to ( B , C ) , _const ( C , _stateid ( texas ) ) ) ) )
how many states have a city named capitals are in the states that border texas ?	_answer ( A , _count ( B , ( _state ( B ) , _loc ( C , B ) , _capital ( C ) , _loc ( C , D ) , _state ( D ) , _next_to ( D , E ) , _const ( E , _stateid ( texas ) ) ) , A ) )
what is the total population of the states that border state has no rivers ?	_answer ( A , _sum ( C , ( _state ( C ) , _next_to ( D , C ) , _state ( D ) , \+ ( _loc ( E , D ) , _river ( E ) ) ) , _population ( C ) , A ) )
what is the longest river flowing through state has the most rivers running through it ?	_answer ( A , _longest ( A , ( _river ( A ) , _traverse ( A , B ) , _most ( B , C , ( _state ( B ) , _loc ( C , B ) , _river ( C ) , _traverse ( C , B ) ) ) ) ) )
what are the neighboring states for state is mount mckinley ?	_answer ( A , ( _next_to ( A , B ) , _state ( A ) , _loc ( C , B ) , _state ( B ) , _const ( C , _placeid ( ' mount mckinley ' ) ) ) )
what cities are located in the states that the potomac run through ?	_answer ( A , ( _city ( A ) , _loc ( A , B ) , _state ( B ) , _const ( C , _riverid ( potomac ) ) , _traverse ( C , B ) ) )
what is the largest city in state has the highest population density ?	_answer ( A , _largest ( A , ( _city ( A ) , _loc ( A , B ) , _largest ( C , ( _state ( B ) , _density ( B , C ) ) ) ) ) )
what is the biggest city in state has the shortest river ?	_answer ( A , _largest ( A , ( _city ( A ) , _loc ( A , B ) , _state ( B ) , _loc ( C , B ) , _shortest ( C , _river ( C ) ) ) ) )
what state has highest elevation city has the largest population ?	_answer ( A , _largest ( B , ( _state ( C ) , _loc ( D , C ) , _highest ( D , _place ( D ) ) , _city ( A ) , _loc ( A , C ) , _population ( A , B ) ) ) )
what states does the the biggest rivers in texas run through ?	_answer ( A , ( _state ( A ) , _longest ( B , ( _river ( B ) , _loc ( B , C ) , _const ( C , _stateid ( texas ) ) ) ) , _river ( B ) , _traverse ( B , A ) ) )
what is the number of neighboring states for state is mount mckinley ?	_answer ( A , _count ( B , ( _state ( B ) , _next_to ( B , C ) , _loc ( D , C ) , _state ( C ) , _const ( D , _placeid ( ' mount mckinley ' ) ) ) , A ) )
how many states does the the longest river that runs through a state that borders tennessee flow through ?	_answer ( A , _count ( B , ( _state ( B ) , _longest ( C , ( _river ( C ) , _traverse ( C , D ) , _state ( D ) , _next_to ( D , E ) , _const ( E , _stateid ( tennessee ) ) ) ) , _river ( C ) , _traverse ( C , B ) ) , A ) )
how high is the highest point of states have rivers named colorado ?	_answer ( A , ( _elevation ( B , A ) , _highest ( B , ( _place ( B ) , _loc ( B , C ) , _state ( C ) , _loc ( D , C ) , _const ( D , _riverid ( colorado ) ) ) ) ) )
what states border states that border the adjacent state of california ?	_answer ( A , ( _state ( A ) , _next_to ( A , B ) , _state ( B ) , _next_to ( B , C ) , _next_to ( C , D ) , _state ( C ) , _const ( D , _stateid ( california ) ) ) )
what cities are located in state is the city denver located in ?	_answer ( A , ( _city ( A ) , _loc ( A , B ) , _state ( B ) , _city ( C ) , _const ( C , _cityid ( denver , _ ) ) , _loc ( C , B ) ) )
how high is the highest point of state has the smallest population density ?	_answer ( A , ( _elevation ( B , A ) , _highest ( B , ( _place ( B ) , _loc ( B , C ) , _smallest ( D , ( _state ( C ) , _density ( C , D ) ) ) ) ) ) )
how many people live in the cities in usa ?	_answer ( A , ( _population ( B , A ) , _city ( B ) , _loc ( B , C ) , _const ( C , _countryid ( usa ) ) ) )
what states have a city named the largest cities in the states that border the largest state ?	_answer ( A , ( _state ( A ) , _loc ( B , A ) , _largest ( B , ( _city ( B ) , _loc ( B , C ) , _state ( C ) , _next_to ( C , D ) , _largest ( D , _state ( D ) ) ) ) ) )
how many states have a city called the capital of vermont ?	_answer ( A , _count ( B , ( _state ( B ) , _loc ( C , B ) , _capital ( C ) , _loc ( C , D ) , _const ( D , _stateid ( vermont ) ) ) , A ) )
what are the biggest rivers in the smallest state that borders texas ?	_answer ( A , _longest ( A , ( _river ( A ) , _loc ( A , B ) , _smallest ( B , ( _state ( B ) , _next_to ( B , C ) , _const ( C , _stateid ( texas ) ) ) ) ) ) )
what is the largest city in state has the most rivers running through it ?	_answer ( A , _largest ( A , ( _city ( A ) , _loc ( A , B ) , _most ( B , C , ( _state ( B ) , _loc ( C , B ) , _river ( C ) , _traverse ( C , B ) ) ) ) ) )
what is the highest mountain in state has no rivers ?	_answer ( A , _highest ( A , ( _mountain ( A ) , _loc ( A , B ) , _state ( B ) , \+ ( _loc ( C , B ) , _river ( C ) ) ) ) )
what is the most populated state bordering the biggest state in continental us ?	_answer ( A , _largest ( B , ( _population ( A , B ) , _state ( A ) , _next_to ( A , C ) , _largest ( C , ( _state ( C ) , _loc ( C , D ) , _const ( D , _countryid ( usa ) ) ) ) ) ) )
what is the population of the major cities in delaware ga ?	_answer ( A , ( _population ( B , A ) , _major ( B ) , _city ( B ) , _loc ( B , C ) , _const ( C , _stateid ( delaware ) ) ) )
what is the lowest point in the states through which the longest river runs ?	_answer ( A , _lowest ( A , ( _place ( A ) , _loc ( A , B ) , _state ( B ) , _longest ( C , ( _river ( C ) , _traverse ( C , B ) ) ) ) ) )
what major rivers run through states neighbor maine ?	_answer ( A , ( _major ( A ) , _river ( A ) , _traverse ( A , B ) , _state ( B ) , _next_to ( B , C ) , _const ( C , _stateid ( maine ) ) ) )
what is the lowest point of state has the smallest population density ?	_answer ( A , _lowest ( A , ( _place ( A ) , _loc ( A , B ) , _smallest ( C , ( _state ( B ) , _density ( B , C ) ) ) ) ) )
what is the size of the state with the lowest point ?	_answer ( A , ( _size ( B , A ) , _state ( B ) , _loc ( C , B ) , _lowest ( C , _place ( C ) ) ) )
what is the longest river in the neighboring states for michigan ?	_answer ( A , _longest ( A , ( _river ( A ) , _loc ( A , B ) , _next_to ( B , C ) , _state ( B ) , _const ( C , _stateid ( michigan ) ) ) ) )
what is the longest river flowing through state does the highest point in usa exist ?	_answer ( A , _longest ( A , ( _river ( A ) , _traverse ( A , B ) , _loc ( C , B ) , _state ( B ) , _highest ( C , ( _place ( C ) , _loc ( C , D ) , _const ( D , _countryid ( usa ) ) ) ) ) ) )
what state is the largest city in montana in city has the largest population ?	_answer ( A , _largest ( B , ( _state ( C ) , _largest ( D , ( _city ( D ) , _loc ( D , E ) , _const ( E , _stateid ( montana ) ) ) ) , _loc ( D , C ) , _city ( A ) , _loc ( A , C ) , _population ( A , B ) ) ) )
which state is the largest city in states border states through which the mississippi traverses in ?	_answer ( A , ( _state ( A ) , _largest ( B , ( _city ( B ) , _loc ( B , C ) , _state ( C ) , _next_to ( C , D ) , _state ( D ) , _const ( E , _riverid ( mississippi ) ) , _traverse ( E , D ) ) ) , _loc ( B , A ) ) )
what states have a city named the major cities in texas ?	_answer ( A , ( _state ( A ) , _loc ( B , A ) , _major ( B ) , _city ( B ) , _loc ( B , C ) , _const ( C , _stateid ( texas ) ) ) )
what is the smallest state that borders states high point are higher than that of colorado ?	_answer ( A , _smallest ( A , ( _state ( A ) , _next_to ( A , B ) , _state ( B ) , _high_point ( B , C ) , _higher ( C , D ) , _high_point ( E , D ) , _const ( E , _stateid ( colorado ) ) ) ) )
can you tell me the capital of states have points that are higher than the highest point in texas ?	_answer ( A , ( _capital ( A ) , _loc ( A , B ) , _state ( B ) , _place ( C ) , _loc ( C , B ) , _higher ( C , D ) , _highest ( D , ( _place ( D ) , _loc ( D , E ) , _const ( E , _stateid ( texas ) ) ) ) ) )
which states border states neighbor maine ?	_answer ( A , ( _state ( A ) , _next_to ( A , B ) , _state ( B ) , _next_to ( B , C ) , _const ( C , _stateid ( maine ) ) ) )
how long is the the longest river in new york ?	_answer ( A , ( _len ( B , A ) , _longest ( B , ( _river ( B ) , _loc ( B , C ) , _const ( C , _stateid ( ' new york ' ) ) ) ) ) )
what is the highest mountain in the most populated state bordering oklahoma ?	_answer ( A , _highest ( A , ( _mountain ( A ) , _loc ( A , B ) , _largest ( C , ( _population ( B , C ) , _state ( B ) , _next_to ( B , D ) , _const ( D , _stateid ( oklahoma ) ) ) ) ) ) )
which capitals are in the states that border the largest state bordering texas ?	_answer ( A , ( _capital ( A ) , _loc ( A , B ) , _state ( B ) , _next_to ( B , C ) , _largest ( C , ( _state ( C ) , _next_to ( C , D ) , _const ( D , _stateid ( texas ) ) ) ) ) )
what states border states that border the state with the lowest population ?	_answer ( A , ( _state ( A ) , _next_to ( A , B ) , _state ( B ) , _next_to ( B , C ) , _smallest ( D , ( _state ( C ) , _population ( C , D ) ) ) ) )
what is the biggest river in the smallest state in the usa ?	_answer ( A , _largest ( A , ( _river ( A ) , _loc ( A , B ) , _smallest ( B , ( _state ( B ) , _loc ( B , C ) , _const ( C , _countryid ( usa ) ) ) ) ) ) )
what major rivers run through the state with the lowest population ?	_answer ( A , ( _major ( A ) , _river ( A ) , _traverse ( A , B ) , _smallest ( C , ( _state ( B ) , _population ( B , C ) ) ) ) )
how many rivers are in the states that the potomac run through ?	_answer ( A , _count ( B , ( _river ( B ) , _loc ( B , C ) , _state ( C ) , _const ( D , _riverid ( potomac ) ) , _traverse ( D , C ) ) , A ) )
what are the states that the the longest river in the united states run through ?	_answer ( A , ( _state ( A ) , _longest ( B , ( _river ( B ) , _loc ( B , C ) , _const ( C , _countryid ( usa ) ) ) ) , _traverse ( B , A ) ) )
what is the biggest city in state has the smallest area ?	_answer ( A , _largest ( A , ( _city ( A ) , _loc ( A , B ) , _smallest ( C , ( _state ( B ) , _area ( B , C ) ) ) ) ) )
which rivers are in state has the most rivers running through it ?	_answer ( A , ( _river ( A ) , _loc ( A , B ) , _most ( B , C , ( _state ( B ) , _loc ( C , B ) , _river ( C ) , _traverse ( C , B ) ) ) ) )
what states high point are higher than that of states border kentucky ?	_answer ( A , ( _state ( A ) , _high_point ( A , B ) , _higher ( B , C ) , _high_point ( D , C ) , _state ( D ) , _next_to ( D , E ) , _const ( E , _stateid ( kentucky ) ) ) )
what rivers run through state is the largest city in montana in ?	_answer ( A , ( _river ( A ) , _traverse ( A , B ) , _state ( B ) , _largest ( C , ( _city ( C ) , _loc ( C , D ) , _const ( D , _stateid ( montana ) ) ) ) , _loc ( C , B ) ) )
what is the adjacent state of state has the highest peak in the country ?	_answer ( A , ( _next_to ( A , B ) , _state ( A ) , _highest ( C , ( _state ( B ) , _loc ( C , B ) , _mountain ( C ) ) ) ) )
where is state is mount mckinley ?	_answer ( A , ( _loc ( B , A ) , _loc ( C , B ) , _state ( B ) , _const ( C , _placeid ( ' mount mckinley ' ) ) ) )
how many states does the the rivers in the state of indiana run through ?	_answer ( A , _count ( B , ( _state ( B ) , _river ( C ) , _loc ( C , D ) , _state ( D ) , _const ( D , _stateid ( indiana ) ) , _river ( C ) , _traverse ( C , B ) ) , A ) )
what are the biggest rivers in state has the city with the largest population ?	_answer ( A , _longest ( A , ( _river ( A ) , _loc ( A , B ) , _state ( B ) , _loc ( C , B ) , _largest ( D , ( _city ( C ) , _population ( C , D ) ) ) ) ) )
what is the highest elevation in the states which have no surrounding states ?	_answer ( A , _highest ( A , ( _place ( A ) , _loc ( A , B ) , _state ( B ) , \+ ( _next_to ( B , C ) , _state ( C ) ) ) ) )
what is the capital of the the states that border the state with the greatest population state ?	_answer ( A , ( _capital ( A ) , _loc ( A , B ) , _state ( B ) , _next_to ( C , B ) , _largest ( D , ( _state ( C ) , _population ( C , D ) ) ) , _state ( B ) ) )
where is state has the smallest area ?	_answer ( A , ( _loc ( B , A ) , _smallest ( C , ( _state ( B ) , _area ( B , C ) ) ) ) )
what is the adjacent state of state does the highest point in usa exist ?	_answer ( A , ( _next_to ( A , B ) , _state ( A ) , _loc ( C , B ) , _state ( B ) , _highest ( C , ( _place ( C ) , _loc ( C , D ) , _const ( D , _countryid ( usa ) ) ) ) ) )
could you tell me what is the highest point in the state of states does the longest river cross ?	_answer ( A , _highest ( A , ( _place ( A ) , _loc ( A , B ) , _state ( B ) , _state ( B ) , _longest ( C , _river ( C ) ) , _traverse ( C , B ) ) ) )
how many rivers in states high point are higher than that of colorado ?	_answer ( A , _count ( B , ( _river ( B ) , _loc ( B , C ) , _state ( C ) , _high_point ( C , D ) , _higher ( D , E ) , _high_point ( F , E ) , _const ( F , _stateid ( colorado ) ) ) , A ) )
what is the average population per square km in the smallest state that borders texas ?	_answer ( A , ( _density ( B , A ) , _smallest ( B , ( _state ( B ) , _next_to ( B , C ) , _const ( C , _stateid ( texas ) ) ) ) ) )
what is the capital of state does the highest point in usa exist ?	_answer ( A , ( _capital ( A ) , _loc ( A , B ) , _loc ( C , B ) , _state ( B ) , _highest ( C , ( _place ( C ) , _loc ( C , D ) , _const ( D , _countryid ( usa ) ) ) ) ) )
where is the largest cities in the states that border the largest state ?	_answer ( A , ( _loc ( B , A ) , _largest ( B , ( _city ( B ) , _loc ( B , C ) , _state ( C ) , _next_to ( C , D ) , _largest ( D , _state ( D ) ) ) ) ) )
what is the highest elevation in state that borders texas is the largest ?	_answer ( A , _highest ( A , ( _place ( A ) , _loc ( A , B ) , _largest ( B , ( _state ( B ) , _next_to ( B , C ) , _const ( C , _stateid ( texas ) ) ) ) ) ) )
what is the smallest state that borders states border texas ?	_answer ( A , _smallest ( A , ( _state ( A ) , _next_to ( A , B ) , _state ( B ) , _next_to ( B , C ) , _const ( C , _stateid ( texas ) ) ) ) )
what is the population of states high point are higher than that of colorado ?	_answer ( A , ( _population ( B , A ) , _state ( B ) , _high_point ( B , C ) , _higher ( C , D ) , _high_point ( E , D ) , _const ( E , _stateid ( colorado ) ) ) )
what are the high points of states surrounding states border texas ?	_answer ( A , ( _high_point ( B , A ) , _loc ( A , B ) , _state ( B ) , _next_to ( B , C ) , _state ( C ) , _next_to ( C , D ) , _const ( D , _stateid ( texas ) ) ) )
what is the highest point in state has no rivers ?	_answer ( A , _highest ( A , ( _place ( A ) , _loc ( A , B ) , _state ( B ) , \+ ( _loc ( C , B ) , _river ( C ) ) ) ) )
what states border states does the mississippi river run through ?	_answer ( A , ( _state ( A ) , _next_to ( A , B ) , _state ( B ) , _const ( C , _riverid ( mississippi ) ) , _river ( C ) , _traverse ( C , B ) ) )
what states neighbor state has the longest river ?	_answer ( A , ( _state ( A ) , _next_to ( A , B ) , _longest ( C , ( _state ( B ) , _loc ( C , B ) , _river ( C ) ) ) ) )
what are the major cities in the states through which the longest river runs ?	_answer ( A , ( _major ( A ) , _city ( A ) , _loc ( A , B ) , _state ( B ) , _longest ( C , ( _river ( C ) , _traverse ( C , B ) ) ) ) )
what states border states that border states does the mississippi river run through ?	_answer ( A , ( _state ( A ) , _next_to ( A , B ) , _state ( B ) , _next_to ( B , C ) , _state ( C ) , _const ( D , _riverid ( mississippi ) ) , _river ( D ) , _traverse ( D , C ) ) )
what is the number of neighboring states for state has the most rivers running through it ?	_answer ( A , _count ( B , ( _state ( B ) , _next_to ( B , C ) , _most ( C , D , ( _state ( C ) , _loc ( D , C ) , _river ( D ) , _traverse ( D , C ) ) ) ) , A ) )
what is the highest point in state has the highest peak in the country ?	_answer ( A , _highest ( A , ( _place ( A ) , _loc ( A , B ) , _highest ( C , ( _state ( B ) , _loc ( C , B ) , _mountain ( C ) ) ) ) ) )
what is the river that cross over state that borders texas is the largest ?	_answer ( A , ( _river ( A ) , _traverse ( A , B ) , _largest ( B , ( _state ( B ) , _next_to ( B , C ) , _const ( C , _stateid ( texas ) ) ) ) ) )
what is the longest river flowing through state has the shortest river ?	_answer ( A , _longest ( A , ( _river ( A ) , _traverse ( A , B ) , _state ( B ) , _loc ( C , B ) , _shortest ( C , _river ( C ) ) ) ) )
what is the largest city in state is mount mckinley by population ?	_answer ( A , _largest ( B , ( _city ( A ) , _loc ( A , C ) , _loc ( D , C ) , _state ( C ) , _const ( D , _placeid ( ' mount mckinley ' ) ) , _population ( A , B ) ) ) )
can you tell me the capital of state is the city denver located in ?	_answer ( A , ( _capital ( A ) , _loc ( A , B ) , _state ( B ) , _city ( C ) , _const ( C , _cityid ( denver , _ ) ) , _loc ( C , B ) ) )
what is the most populous city in states border states through which the mississippi traverses ?	_answer ( B , _largest ( A , ( _population ( B , A ) , _city ( B ) , _loc ( B , C ) , _state ( C ) , _next_to ( C , D ) , _state ( D ) , _const ( E , _riverid ( mississippi ) ) , _traverse ( E , D ) ) ) )
how many citizens in state has the shortest river ?	_answer ( A , ( _population ( B , A ) , _state ( B ) , _loc ( C , B ) , _shortest ( C , _river ( C ) ) ) )
what is the smallest state that borders the states which have no surrounding states ?	_answer ( A , _smallest ( A , ( _state ( A ) , _next_to ( A , B ) , _state ( B ) , \+ ( _next_to ( B , C ) , _state ( C ) ) ) ) )
how many states have a city called the largest city in minnesota by population ?	_answer ( A , _count ( B , ( _state ( B ) , _loc ( C , B ) , _largest ( D , ( _city ( C ) , _loc ( C , E ) , _const ( E , _stateid ( minnesota ) ) , _population ( C , D ) ) ) ) , A ) )
what major rivers run through states border kentucky ?	_answer ( A , ( _major ( A ) , _river ( A ) , _traverse ( A , B ) , _state ( B ) , _next_to ( B , C ) , _const ( C , _stateid ( kentucky ) ) ) )
which state border the most populated state bordering oklahoma ?	_answer ( A , ( _state ( A ) , _next_to ( A , B ) , _largest ( C , ( _population ( B , C ) , _state ( B ) , _next_to ( B , D ) , _const ( D , _stateid ( oklahoma ) ) ) ) ) )
what is the smallest state that borders state has the smallest population density ?	_answer ( A , _smallest ( A , ( _state ( A ) , _next_to ( A , B ) , _smallest ( C , ( _state ( B ) , _density ( B , C ) ) ) ) ) )
could you tell me what is the highest point in the state of the smallest state that borders texas ?	_answer ( A , _highest ( A , ( _place ( A ) , _loc ( A , B ) , _state ( B ) , _smallest ( B , ( _state ( B ) , _next_to ( B , C ) , _const ( C , _stateid ( texas ) ) ) ) ) ) )
what is the highest point in the state with capital the cities in usa ?	_answer ( A , _highest ( A , ( _place ( A ) , _loc ( A , B ) , _state ( B ) , _loc ( C , B ) , _capital ( C ) , _city ( C ) , _loc ( C , D ) , _const ( D , _countryid ( usa ) ) ) ) )
give me the cities which are in state is rochester ?	_answer ( A , ( _city ( A ) , _loc ( A , B ) , _loc ( C , B ) , _state ( B ) , _const ( C , _cityid ( rochester , _ ) ) ) )
what cities are located in the smallest state that borders texas ?	_answer ( A , ( _city ( A ) , _loc ( A , B ) , _smallest ( B , ( _state ( B ) , _next_to ( B , C ) , _const ( C , _stateid ( texas ) ) ) ) ) )
what is the highest point in states border georgia ?	_answer ( A , _highest ( A , ( _place ( A ) , _loc ( A , B ) , _state ( B ) , _next_to ( B , C ) , _const ( C , _stateid ( georgia ) ) ) ) )
what states have rivers named the longest river that runs through a state that borders tennessee ?	_answer ( A , ( _state ( A ) , _loc ( B , A ) , _longest ( B , ( _river ( B ) , _traverse ( B , C ) , _state ( C ) , _next_to ( C , D ) , _const ( D , _stateid ( tennessee ) ) ) ) ) )
name all the rivers in states border colorado ?	_answer ( A , ( _river ( A ) , _loc ( A , B ) , _state ( B ) , _next_to ( B , C ) , _const ( C , _stateid ( colorado ) ) ) )
what is the population of state has no rivers ?	_answer ( A , ( _population ( B , A ) , _state ( B ) , \+ ( _loc ( C , B ) , _river ( C ) ) ) )
what is the highest elevation in the smallest state that borders texas ?	_answer ( A , _highest ( A , ( _place ( A ) , _loc ( A , B ) , _smallest ( B , ( _state ( B ) , _next_to ( B , C ) , _const ( C , _stateid ( texas ) ) ) ) ) ) )
what rivers run through states have rivers named colorado ?	_answer ( A , ( _river ( A ) , _traverse ( A , B ) , _state ( B ) , _loc ( C , B ) , _const ( C , _riverid ( colorado ) ) ) )
what are the high points of states surrounding the state with the lowest population ?	_answer ( A , ( _high_point ( B , A ) , _loc ( A , B ) , _state ( B ) , _next_to ( B , C ) , _smallest ( D , ( _state ( C ) , _population ( C , D ) ) ) ) )
how long is the major rivers run through illinois ?	_answer ( A , ( _len ( B , A ) , _major ( B ) , _river ( B ) , _traverse ( B , C ) , _const ( C , _stateid ( illinois ) ) , _river ( B ) ) )
what is the largest city in states border states that border colorado ?	_answer ( A , _largest ( A , ( _city ( A ) , _loc ( A , B ) , _state ( B ) , _next_to ( B , C ) , _state ( C ) , _next_to ( C , D ) , _const ( D , _stateid ( colorado ) ) ) ) )
what are the rivers in the state of state has the most rivers running through it ?	_answer ( A , ( _river ( A ) , _loc ( A , B ) , _state ( B ) , _most ( B , C , ( _state ( B ) , _loc ( C , B ) , _river ( C ) , _traverse ( C , B ) ) ) ) )
what are the rivers in the state of the states that the potomac run through ?	_answer ( A , ( _river ( A ) , _loc ( A , B ) , _state ( B ) , _state ( B ) , _const ( C , _riverid ( potomac ) ) , _traverse ( C , B ) ) )
what is the biggest river in the states which have no surrounding states ?	_answer ( A , _largest ( A , ( _river ( A ) , _loc ( A , B ) , _state ( B ) , \+ ( _next_to ( B , C ) , _state ( C ) ) ) ) )
how many states does the states that the potomac run through border ?	_answer ( A , _count ( B , ( _state ( B ) , _state ( C ) , _const ( D , _riverid ( potomac ) ) , _traverse ( D , C ) , _next_to ( C , B ) ) , A ) )
what is the capital of the adjacent state of california ?	_answer ( A , ( _capital ( A ) , _loc ( A , B ) , _next_to ( B , C ) , _state ( B ) , _const ( C , _stateid ( california ) ) ) )
where is states border colorado ?	_answer ( A , ( _loc ( B , A ) , _state ( B ) , _next_to ( B , C ) , _const ( C , _stateid ( colorado ) ) ) )
what is the highest elevation in the most populated state bordering oklahoma ?	_answer ( A , _highest ( A , ( _place ( A ) , _loc ( A , B ) , _largest ( C , ( _population ( B , C ) , _state ( B ) , _next_to ( B , D ) , _const ( D , _stateid ( oklahoma ) ) ) ) ) ) )
what is the area of state has the most rivers running through it ?	_answer ( A , ( _area ( B , A ) , _most ( B , C , ( _state ( B ) , _loc ( C , B ) , _river ( C ) , _traverse ( C , B ) ) ) ) )
what is the largest city in the state with the lowest population ?	_answer ( A , _largest ( A , ( _city ( A ) , _loc ( A , B ) , _smallest ( C , ( _state ( B ) , _population ( B , C ) ) ) ) ) )
what is the size of states have rivers named colorado ?	_answer ( A , ( _size ( B , A ) , _state ( B ) , _loc ( C , B ) , _const ( C , _riverid ( colorado ) ) ) )
how many states does the river runs through illinois flow through ?	_answer ( A , _count ( B , ( _state ( B ) , _river ( C ) , _traverse ( C , D ) , _const ( D , _stateid ( illinois ) ) , _river ( C ) , _traverse ( C , B ) ) , A ) )
what is the longest river flowing through the states that border the state with the greatest population ?	_answer ( A , _longest ( A , ( _river ( A ) , _traverse ( A , B ) , _state ( B ) , _next_to ( C , B ) , _largest ( D , ( _state ( C ) , _population ( C , D ) ) ) ) ) )
what are the neighboring states for states have a city named austin ?	_answer ( A , ( _next_to ( A , B ) , _state ( A ) , _state ( B ) , _loc ( C , B ) , _const ( C , _cityid ( austin , _ ) ) ) )
how many states does the the longest river in new york flow through ?	_answer ( A , _count ( B , ( _state ( B ) , _longest ( C , ( _river ( C ) , _loc ( C , D ) , _const ( D , _stateid ( ' new york ' ) ) ) ) , _river ( C ) , _traverse ( C , B ) ) , A ) )
what are the capitals of the states that border the states through which the longest river runs ?	_answer ( A , ( _capital ( A ) , _loc ( A , B ) , _state ( B ) , _next_to ( B , C ) , _state ( C ) , _longest ( D , ( _river ( D ) , _traverse ( D , C ) ) ) ) )
what states have a city named the largest city in michigan ?	_answer ( A , ( _state ( A ) , _loc ( B , A ) , _largest ( B , ( _city ( B ) , _loc ( B , C ) , _const ( C , _stateid ( michigan ) ) ) ) ) )
what states have rivers named the longest river in new york ?	_answer ( A , ( _state ( A ) , _loc ( B , A ) , _longest ( B , ( _river ( B ) , _loc ( B , C ) , _const ( C , _stateid ( ' new york ' ) ) ) ) ) )
which state is the largest city in states does the longest river cross in ?	_answer ( A , ( _state ( A ) , _largest ( B , ( _city ( B ) , _loc ( B , C ) , _state ( C ) , _longest ( D , _river ( D ) ) , _traverse ( D , C ) ) ) , _loc ( B , A ) ) )
what major rivers run through the largest state bordering texas ?	_answer ( A , ( _major ( A ) , _river ( A ) , _traverse ( A , B ) , _largest ( B , ( _state ( B ) , _next_to ( B , C ) , _const ( C , _stateid ( texas ) ) ) ) ) )
what is the highest elevation in state has no rivers ?	_answer ( A , _highest ( A , ( _place ( A ) , _loc ( A , B ) , _state ( B ) , \+ ( _loc ( C , B ) , _river ( C ) ) ) ) )
where is capitals are not major cities ?	_answer ( A , ( _loc ( B , A ) , _capital ( B ) , \+ ( _major ( B ) , _city ( B ) ) ) )
which rivers are in the states that the potomac run through ?	_answer ( A , ( _river ( A ) , _loc ( A , B ) , _state ( B ) , _const ( C , _riverid ( potomac ) ) , _traverse ( C , B ) ) )
name all the rivers in the states that the potomac run through ?	_answer ( A , ( _river ( A ) , _loc ( A , B ) , _state ( B ) , _const ( C , _riverid ( potomac ) ) , _traverse ( C , B ) ) )
what is the river that cross over state border kentucky ?	_answer ( A , ( _river ( A ) , _traverse ( A , B ) , _state ( B ) , _next_to ( B , C ) , _const ( C , _stateid ( kentucky ) ) ) )
what is the lowest point of state has the city with the largest population ?	_answer ( A , _lowest ( A , ( _place ( A ) , _loc ( A , B ) , _state ( B ) , _loc ( C , B ) , _largest ( D , ( _city ( C ) , _population ( C , D ) ) ) ) ) )
what major rivers run through state is mount mckinley ?	_answer ( A , ( _major ( A ) , _river ( A ) , _traverse ( A , B ) , _loc ( C , B ) , _state ( B ) , _const ( C , _placeid ( ' mount mckinley ' ) ) ) )
what rivers run through state has the longest river ?	_answer ( A , ( _river ( A ) , _traverse ( A , B ) , _longest ( C , ( _state ( B ) , _loc ( C , B ) , _river ( C ) ) ) ) )
what is the smallest city in states border states that border colorado ?	_answer ( A , _smallest ( A , ( _city ( A ) , _loc ( A , B ) , _state ( B ) , _next_to ( B , C ) , _state ( C ) , _next_to ( C , D ) , _const ( D , _stateid ( colorado ) ) ) ) )
what state that borders state has the longest river is the largest ?	_answer ( A , _largest ( A , ( _state ( A ) , _next_to ( A , B ) , _longest ( C , ( _state ( B ) , _loc ( C , B ) , _river ( C ) ) ) ) ) )
what are the rivers in the state of states does the longest river cross ?	_answer ( A , ( _river ( A ) , _loc ( A , B ) , _state ( B ) , _state ( B ) , _longest ( C , _river ( C ) ) , _traverse ( C , B ) ) )
how many rivers are in the most populated state bordering oklahoma ?	_answer ( A , _count ( B , ( _river ( B ) , _loc ( B , C ) , _largest ( D , ( _population ( C , D ) , _state ( C ) , _next_to ( C , E ) , _const ( E , _stateid ( oklahoma ) ) ) ) ) , A ) )
could you tell me what is the highest point in the state of the neighboring states for michigan ?	_answer ( A , _highest ( A , ( _place ( A ) , _loc ( A , B ) , _state ( B ) , _next_to ( B , C ) , _state ( B ) , _const ( C , _stateid ( michigan ) ) ) ) )
where is the names of the major cities in illinois ?	_answer ( A , ( _loc ( B , A ) , _major ( B ) , _city ( B ) , _loc ( B , C ) , _const ( C , _stateid ( illinois ) ) ) )
how many people live in state has the highest population density ?	_answer ( A , ( _population ( B , A ) , _largest ( C , ( _state ( B ) , _density ( B , C ) ) ) ) )
what are the names of the major cities in states border kentucky ?	_answer ( A , ( _major ( A ) , _city ( A ) , _loc ( A , B ) , _state ( B ) , _next_to ( B , C ) , _const ( C , _stateid ( kentucky ) ) ) )
what cities are located in states neighbor maine ?	_answer ( A , ( _city ( A ) , _loc ( A , B ) , _state ( B ) , _next_to ( B , C ) , _const ( C , _stateid ( maine ) ) ) )
what are the names of the major cities in states border states through which the mississippi traverses ?	_answer ( A , ( _major ( A ) , _city ( A ) , _loc ( A , B ) , _state ( B ) , _next_to ( B , C ) , _state ( C ) , _const ( D , _riverid ( mississippi ) ) , _traverse ( D , C ) ) )
what is the largest city in state has the highest population density by population ?	_answer ( A , _largest ( B , ( _city ( A ) , _loc ( A , C ) , _largest ( D , ( _state ( C ) , _density ( C , D ) ) ) , _population ( A , B ) ) ) )
what states border the state with the lowest population ?	_answer ( A , ( _state ( A ) , _next_to ( A , B ) , _smallest ( C , ( _state ( B ) , _population ( B , C ) ) ) ) )
what is the capital of the states border states through which the mississippi traverses state ?	_answer ( A , ( _capital ( A ) , _loc ( A , B ) , _state ( B ) , _next_to ( B , C ) , _state ( C ) , _const ( D , _riverid ( mississippi ) ) , _traverse ( D , C ) , _state ( B ) ) )
what is the smallest state that borders the largest state bordering texas ?	_answer ( A , _smallest ( A , ( _state ( A ) , _next_to ( A , B ) , _largest ( B , ( _state ( B ) , _next_to ( B , C ) , _const ( C , _stateid ( texas ) ) ) ) ) ) )
what is capital of the smallest state through which the longest river runs ?	_answer ( A , ( _capital ( A ) , _loc ( A , B ) , _smallest ( B , ( _state ( B ) , _longest ( C , _river ( C ) ) , _traverse ( C , B ) ) ) ) )
what states border state has the largest population density ?	_answer ( A , ( _state ( A ) , _next_to ( A , B ) , _largest ( C , ( _state ( B ) , _density ( B , C ) ) ) ) )
how many people live in the states that the potomac run through ?	_answer ( A , ( _population ( B , A ) , _state ( B ) , _const ( C , _riverid ( potomac ) ) , _traverse ( C , B ) ) )
how many rivers are in states have points that are higher than the highest point in texas ?	_answer ( A , _count ( B , ( _river ( B ) , _loc ( B , C ) , _state ( C ) , _place ( D ) , _loc ( D , C ) , _higher ( D , E ) , _highest ( E , ( _place ( E ) , _loc ( E , F ) , _const ( F , _stateid ( texas ) ) ) ) ) , A ) )
what is the adjacent state of the states that the potomac run through ?	_answer ( A , ( _next_to ( A , B ) , _state ( A ) , _state ( B ) , _const ( C , _riverid ( potomac ) ) , _traverse ( C , B ) ) )
which capitals are in the states that border state has the smallest area ?	_answer ( A , ( _capital ( A ) , _loc ( A , B ) , _state ( B ) , _next_to ( B , C ) , _smallest ( D , ( _state ( C ) , _area ( C , D ) ) ) ) )
what is the longest river in state has the most rivers running through it ?	_answer ( A , _longest ( A , ( _river ( A ) , _loc ( A , B ) , _most ( B , C , ( _state ( B ) , _loc ( C , B ) , _river ( C ) , _traverse ( C , B ) ) ) ) ) )
what is the lowest point of state that borders texas is the largest ?	_answer ( A , _lowest ( A , ( _place ( A ) , _loc ( A , B ) , _largest ( B , ( _state ( B ) , _next_to ( B , C ) , _const ( C , _stateid ( texas ) ) ) ) ) ) )
what cities are located in state has the longest river ?	_answer ( A , ( _city ( A ) , _loc ( A , B ) , _longest ( C , ( _state ( B ) , _loc ( C , B ) , _river ( C ) ) ) ) )
where is the biggest city in wyoming ?	_answer ( A , ( _loc ( B , A ) , _largest ( B , ( _city ( B ) , _loc ( B , C ) , _const ( C , _stateid ( wyoming ) ) ) ) ) )
what is the longest river in state has highest elevation ?	_answer ( A , _longest ( A , ( _river ( A ) , _loc ( A , B ) , _state ( B ) , _loc ( C , B ) , _highest ( C , _place ( C ) ) ) ) )
what is the lowest point in state has the highest population density ?	_answer ( A , _lowest ( A , ( _place ( A ) , _loc ( A , B ) , _largest ( C , ( _state ( B ) , _density ( B , C ) ) ) ) ) )
which state is the largest city in states border rhode island in ?	_answer ( A , ( _state ( A ) , _largest ( B , ( _city ( B ) , _loc ( B , C ) , _state ( C ) , _next_to ( C , D ) , _const ( D , _stateid ( ' rhode island ' ) ) ) ) , _loc ( B , A ) ) )
which states have points that are higher than the highest point in states does the colorado river run through ?	_answer ( A , ( _state ( A ) , _place ( B ) , _loc ( B , A ) , _higher ( B , C ) , _highest ( C , ( _place ( C ) , _loc ( C , D ) , _state ( D ) , _const ( E , _riverid ( colorado ) ) , _river ( E ) , _traverse ( E , D ) ) ) ) )
how many rivers in states border rhode island ?	_answer ( A , _count ( B , ( _river ( B ) , _loc ( B , C ) , _state ( C ) , _next_to ( C , D ) , _const ( D , _stateid ( ' rhode island ' ) ) ) , A ) )
what is the capital of the states border texas state ?	_answer ( A , ( _capital ( A ) , _loc ( A , B ) , _state ( B ) , _next_to ( B , C ) , _const ( C , _stateid ( texas ) ) , _state ( B ) ) )
what are the capitals of the states that border state border kentucky ?	_answer ( A , ( _capital ( A ) , _loc ( A , B ) , _state ( B ) , _next_to ( B , C ) , _state ( C ) , _next_to ( C , D ) , _const ( D , _stateid ( kentucky ) ) ) )
what states does the rivers flow through the state with the largest population run through ?	_answer ( A , ( _state ( A ) , _river ( B ) , _traverse ( B , C ) , _largest ( D , ( _state ( C ) , _population ( C , D ) ) ) , _river ( B ) , _traverse ( B , A ) ) )
which states does the the longest river flowing through new york run through ?	_answer ( A , ( _state ( A ) , _longest ( B , ( _river ( B ) , _traverse ( B , C ) , _const ( C , _stateid ( ' new york ' ) ) ) ) , _river ( B ) , _traverse ( B , A ) ) )
what is the largest city in states does the mississippi river run through by population ?	_answer ( A , _largest ( B , ( _city ( A ) , _loc ( A , C ) , _state ( C ) , _const ( D , _riverid ( mississippi ) ) , _river ( D ) , _traverse ( D , C ) , _population ( A , B ) ) ) )
what states border states that border the smallest state that borders texas ?	_answer ( A , ( _state ( A ) , _next_to ( A , B ) , _state ( B ) , _next_to ( B , C ) , _smallest ( C , ( _state ( C ) , _next_to ( C , D ) , _const ( D , _stateid ( texas ) ) ) ) ) )
what are the names of the major cities in state has the largest population density ?	_answer ( A , ( _major ( A ) , _city ( A ) , _loc ( A , B ) , _largest ( C , ( _state ( B ) , _density ( B , C ) ) ) ) )
what states have rivers named the longest river that passes through the us ?	_answer ( A , ( _state ( A ) , _loc ( B , A ) , _longest ( B , ( _river ( B ) , _traverse ( B , C ) , _const ( C , _countryid ( usa ) ) ) ) ) )
what is the biggest city in state has the largest city ?	_answer ( A , _largest ( A , ( _city ( A ) , _loc ( A , B ) , _largest ( C , ( _state ( B ) , _loc ( C , B ) , _city ( C ) ) ) ) ) )
what are the high points of states surrounding state has the most rivers running through it ?	_answer ( A , ( _high_point ( B , A ) , _loc ( A , B ) , _state ( B ) , _next_to ( B , C ) , _most ( C , D , ( _state ( C ) , _loc ( D , C ) , _river ( D ) , _traverse ( D , C ) ) ) ) )
what states neighbor state is the city denver located in ?	_answer ( A , ( _state ( A ) , _next_to ( A , B ) , _state ( B ) , _city ( C ) , _const ( C , _cityid ( denver , _ ) ) , _loc ( C , B ) ) )
what is capital of states does the mississippi river run through ?	_answer ( A , ( _capital ( A ) , _loc ( A , B ) , _state ( B ) , _const ( C , _riverid ( mississippi ) ) , _river ( C ) , _traverse ( C , B ) ) )
what river runs through state has highest elevation ?	_answer ( A , ( _river ( A ) , _traverse ( A , B ) , _state ( B ) , _loc ( C , B ) , _highest ( C , _place ( C ) ) ) )
what is the smallest city in states does the colorado river run through ?	_answer ( A , _smallest ( A , ( _city ( A ) , _loc ( A , B ) , _state ( B ) , _const ( C , _riverid ( colorado ) ) , _river ( C ) , _traverse ( C , B ) ) ) )
what are the major cities in state has the largest population density ?	_answer ( A , ( _major ( A ) , _city ( A ) , _loc ( A , B ) , _largest ( C , ( _state ( B ) , _density ( B , C ) ) ) ) )
how many rivers in the states ?	_answer ( A , _count ( B , ( _river ( B ) , _loc ( B , C ) , _state ( C ) ) , A ) )
what is capital of state is mount mckinley ?	_answer ( A , ( _capital ( A ) , _loc ( A , B ) , _loc ( C , B ) , _state ( B ) , _const ( C , _placeid ( ' mount mckinley ' ) ) ) )
name all the rivers in states have points that are higher than the highest point in texas ?	_answer ( A , ( _river ( A ) , _loc ( A , B ) , _state ( B ) , _place ( C ) , _loc ( C , B ) , _higher ( C , D ) , _highest ( D , ( _place ( D ) , _loc ( D , E ) , _const ( E , _stateid ( texas ) ) ) ) ) )
where is states high point are higher than that of colorado ?	_answer ( A , ( _loc ( B , A ) , _state ( B ) , _high_point ( B , C ) , _higher ( C , D ) , _high_point ( E , D ) , _const ( E , _stateid ( colorado ) ) ) )
what river runs through states have a city named austin ?	_answer ( A , ( _river ( A ) , _traverse ( A , B ) , _state ( B ) , _loc ( C , B ) , _const ( C , _cityid ( austin , _ ) ) ) )
what is the smallest state that borders the states through which the longest river runs ?	_answer ( A , _smallest ( A , ( _state ( A ) , _next_to ( A , B ) , _state ( B ) , _longest ( C , ( _river ( C ) , _traverse ( C , B ) ) ) ) ) )
how many states border states border georgia ?	_answer ( A , _count ( B , ( _state ( B ) , _next_to ( B , C ) , _state ( C ) , _next_to ( C , D ) , _const ( D , _stateid ( georgia ) ) ) , A ) )
what are the rivers in the state of states border georgia ?	_answer ( A , ( _river ( A ) , _loc ( A , B ) , _state ( B ) , _state ( B ) , _next_to ( B , C ) , _const ( C , _stateid ( georgia ) ) ) )
what is the biggest river in state has the highest population density ?	_answer ( A , _largest ( A , ( _river ( A ) , _loc ( A , B ) , _largest ( C , ( _state ( B ) , _density ( B , C ) ) ) ) ) )
what state has the highest population density city has the largest population ?	_answer ( A , _largest ( B , ( _largest ( D , ( _state ( C ) , _density ( C , D ) ) ) , _city ( A ) , _loc ( A , C ) , _population ( A , B ) ) ) )
what states border states that border state has the shortest river ?	_answer ( A , ( _state ( A ) , _next_to ( A , B ) , _state ( B ) , _next_to ( B , C ) , _state ( C ) , _loc ( D , C ) , _shortest ( D , _river ( D ) ) ) )
what is the population of the capital of pennsylvania ?	_answer ( A , ( _population ( B , A ) , _capital ( B ) , _loc ( B , C ) , _const ( C , _stateid ( pennsylvania ) ) ) )
could you tell me what is the highest point in the state of state has highest elevation ?	_answer ( A , _highest ( A , ( _place ( A ) , _loc ( A , B ) , _state ( B ) , _state ( B ) , _loc ( C , B ) , _highest ( C , _place ( C ) ) ) ) )
how many cities named the major cities in texas are there in the usa ?	_answer ( A , _count ( B , ( _city ( B ) , _major ( B ) , _city ( B ) , _loc ( B , D ) , _const ( D , _stateid ( texas ) ) , _loc ( B , C ) , _const ( C , _countryid ( usa ) ) ) , A ) )
how many cities named capital is the largest in the us are there in the usa ?	_answer ( A , _count ( B , ( _city ( B ) , _largest ( B , ( _capital ( B ) , _loc ( B , D ) , _const ( D , _countryid ( usa ) ) ) ) , _loc ( B , C ) , _const ( C , _countryid ( usa ) ) ) , A ) )
how high is the highest point of state is the largest city in montana in ?	_answer ( A , ( _elevation ( B , A ) , _highest ( B , ( _place ( B ) , _loc ( B , C ) , _state ( C ) , _largest ( D , ( _city ( D ) , _loc ( D , E ) , _const ( E , _stateid ( montana ) ) ) ) , _loc ( D , C ) ) ) ) )
what is the highest elevation in states does the longest river cross ?	_answer ( A , _highest ( A , ( _place ( A ) , _loc ( A , B ) , _state ( B ) , _longest ( C , _river ( C ) ) , _traverse ( C , B ) ) ) )
what is the size of state is mount mckinley ?	_answer ( A , ( _size ( B , A ) , _loc ( C , B ) , _state ( B ) , _const ( C , _placeid ( ' mount mckinley ' ) ) ) )
which state is the city the major cities in north carolina located in ?	_answer ( A , ( _state ( A ) , _city ( B ) , _major ( B ) , _city ( B ) , _loc ( B , C ) , _const ( C , _stateid ( ' north carolina ' ) ) , _loc ( B , A ) ) )
what is the adjacent state of the adjacent state of california ?	_answer ( A , ( _next_to ( A , B ) , _state ( A ) , _next_to ( B , C ) , _state ( B ) , _const ( C , _stateid ( california ) ) ) )
what is the average population per square km in the largest state bordering texas ?	_answer ( A , ( _density ( B , A ) , _largest ( B , ( _state ( B ) , _next_to ( B , C ) , _const ( C , _stateid ( texas ) ) ) ) ) )
how many rivers are in states does the colorado river run through ?	_answer ( A , _count ( B , ( _river ( B ) , _loc ( B , C ) , _state ( C ) , _const ( D , _riverid ( colorado ) ) , _river ( D ) , _traverse ( D , C ) ) , A ) )
can you tell me the capital of state has highest elevation ?	_answer ( A , ( _capital ( A ) , _loc ( A , B ) , _state ( B ) , _loc ( C , B ) , _highest ( C , _place ( C ) ) ) )
what is the highest mountain in the states which have no surrounding states ?	_answer ( A , _highest ( A , ( _mountain ( A ) , _loc ( A , B ) , _state ( B ) , \+ ( _next_to ( B , C ) , _state ( C ) ) ) ) )
how many cities named the major cities in delaware are there in the usa ?	_answer ( A , _count ( B , ( _city ( B ) , _major ( B ) , _city ( B ) , _loc ( B , D ) , _const ( D , _stateid ( delaware ) ) , _loc ( B , C ) , _const ( C , _countryid ( usa ) ) ) , A ) )
what is the most populated state bordering the neighboring states for michigan ?	_answer ( A , _largest ( B , ( _population ( A , B ) , _state ( A ) , _next_to ( A , C ) , _next_to ( C , D ) , _state ( C ) , _const ( D , _stateid ( michigan ) ) ) ) )
how many states does the river flows through kansas run through ?	_answer ( A , _count ( B , ( _state ( B ) , _river ( C ) , _traverse ( C , D ) , _const ( D , _stateid ( kansas ) ) , _river ( C ) , _traverse ( C , B ) ) , A ) )
which capitals are in the states that border state has highest elevation ?	_answer ( A , ( _capital ( A ) , _loc ( A , B ) , _state ( B ) , _next_to ( B , C ) , _state ( C ) , _loc ( D , C ) , _highest ( D , _place ( D ) ) ) )
what rivers are in states border rhode island ?	_answer ( A , ( _river ( A ) , _loc ( A , B ) , _state ( B ) , _next_to ( B , C ) , _const ( C , _stateid ( ' rhode island ' ) ) ) )
what the most populated state bordering oklahoma city has the largest population ?	_answer ( A , _largest ( B , ( _largest ( D , ( _population ( C , D ) , _state ( C ) , _next_to ( C , E ) , _const ( E , _stateid ( oklahoma ) ) ) ) , _city ( A ) , _loc ( A , C ) , _population ( A , B ) ) ) )
what are the capitals of the states that border the state with the lowest population ?	_answer ( A , ( _capital ( A ) , _loc ( A , B ) , _state ( B ) , _next_to ( B , C ) , _smallest ( D , ( _state ( C ) , _population ( C , D ) ) ) ) )
what is the biggest river in state has the longest river ?	_answer ( A , _largest ( A , ( _river ( A ) , _loc ( A , B ) , _longest ( C , ( _state ( B ) , _loc ( C , B ) , _river ( C ) ) ) ) ) )
how high is the highest point of the most populated state bordering oklahoma ?	_answer ( A , ( _elevation ( B , A ) , _highest ( B , ( _place ( B ) , _loc ( B , C ) , _largest ( D , ( _population ( C , D ) , _state ( C ) , _next_to ( C , E ) , _const ( E , _stateid ( oklahoma ) ) ) ) ) ) ) )
what rivers are in the states ?	_answer ( A , ( _river ( A ) , _loc ( A , B ) , _state ( B ) ) )
what is the biggest river in states have rivers named colorado ?	_answer ( A , _largest ( A , ( _river ( A ) , _loc ( A , B ) , _state ( B ) , _loc ( C , B ) , _const ( C , _riverid ( colorado ) ) ) ) )
what rivers run through state is the city denver located in ?	_answer ( A , ( _river ( A ) , _traverse ( A , B ) , _state ( B ) , _city ( C ) , _const ( C , _cityid ( denver , _ ) ) , _loc ( C , B ) ) )
what rivers run through the most populated state bordering oklahoma ?	_answer ( A , ( _river ( A ) , _traverse ( A , B ) , _largest ( C , ( _population ( B , C ) , _state ( B ) , _next_to ( B , D ) , _const ( D , _stateid ( oklahoma ) ) ) ) ) )
what is the most populous city in states border georgia ?	_answer ( B , _largest ( A , ( _population ( B , A ) , _city ( B ) , _loc ( B , C ) , _state ( C ) , _next_to ( C , D ) , _const ( D , _stateid ( georgia ) ) ) ) )
what is the average population per square km in the adjacent state of california ?	_answer ( A , ( _density ( B , A ) , _next_to ( B , C ) , _state ( B ) , _const ( C , _stateid ( california ) ) ) )
what is the most populated state bordering states border georgia ?	_answer ( A , _largest ( B , ( _population ( A , B ) , _state ( A ) , _next_to ( A , C ) , _state ( C ) , _next_to ( C , D ) , _const ( D , _stateid ( georgia ) ) ) ) )
what is the lowest point in states border texas ?	_answer ( A , _lowest ( A , ( _place ( A ) , _loc ( A , B ) , _state ( B ) , _next_to ( B , C ) , _const ( C , _stateid ( texas ) ) ) ) )
which state is the largest city in the state with the lowest point in ?	_answer ( A , ( _state ( A ) , _largest ( B , ( _city ( B ) , _loc ( B , C ) , _state ( C ) , _loc ( D , C ) , _lowest ( D , _place ( D ) ) ) ) , _loc ( B , A ) ) )
how many people live in state that borders texas is the largest ?	_answer ( A , ( _population ( B , A ) , _largest ( B , ( _state ( B ) , _next_to ( B , C ) , _const ( C , _stateid ( texas ) ) ) ) ) )
what is the biggest river in the state with the lowest point ?	_answer ( A , _largest ( A , ( _river ( A ) , _loc ( A , B ) , _state ( B ) , _loc ( C , B ) , _lowest ( C , _place ( C ) ) ) ) )
how many states does states have rivers named colorado border ?	_answer ( A , _count ( B , ( _state ( B ) , _state ( C ) , _loc ( D , C ) , _const ( D , _riverid ( colorado ) ) , _next_to ( C , B ) ) , A ) )
what is the size of state has the largest city ?	_answer ( A , ( _size ( B , A ) , _largest ( C , ( _state ( B ) , _loc ( C , B ) , _city ( C ) ) ) ) )
give me the cities which are in the states which have no surrounding states ?	_answer ( A , ( _city ( A ) , _loc ( A , B ) , _state ( B ) , \+ ( _next_to ( B , C ) , _state ( C ) ) ) )
how many states have a city called the biggest city in texas ?	_answer ( A , _count ( B , ( _state ( B ) , _loc ( C , B ) , _largest ( C , ( _city ( C ) , _loc ( C , D ) , _const ( D , _stateid ( texas ) ) ) ) ) , A ) )
what is the capital of states does the colorado river run through ?	_answer ( A , ( _capital ( A ) , _loc ( A , B ) , _state ( B ) , _const ( C , _riverid ( colorado ) ) , _river ( C ) , _traverse ( C , B ) ) )
how many major cities are in state has the highest population density ?	_answer ( A , _count ( B , ( _major ( B ) , _city ( B ) , _loc ( B , C ) , _largest ( D , ( _state ( C ) , _density ( C , D ) ) ) ) , A ) )
what is the river that cross over state has the city with the largest population ?	_answer ( A , ( _river ( A ) , _traverse ( A , B ) , _state ( B ) , _loc ( C , B ) , _largest ( D , ( _city ( C ) , _population ( C , D ) ) ) ) )
which state is the largest city in state has the smallest area in ?	_answer ( A , ( _state ( A ) , _largest ( B , ( _city ( B ) , _loc ( B , C ) , _smallest ( D , ( _state ( C ) , _area ( C , D ) ) ) ) ) , _loc ( B , A ) ) )
can you tell me the capital of states border kentucky ?	_answer ( A , ( _capital ( A ) , _loc ( A , B ) , _state ( B ) , _next_to ( B , C ) , _const ( C , _stateid ( kentucky ) ) ) )
what are the populations of states through which the the shortest river in the united states run ?	_answer ( A , ( _population ( B , A ) , _state ( B ) , _shortest ( C , ( _river ( C ) , _loc ( C , D ) , _const ( D , _countryid ( usa ) ) ) ) , _river ( C ) , _traverse ( C , B ) ) )
what states neighbor states have rivers named colorado ?	_answer ( A , ( _state ( A ) , _next_to ( A , B ) , _state ( B ) , _loc ( C , B ) , _const ( C , _riverid ( colorado ) ) ) )
what is the total population of the states that border state has the most rivers running through it ?	_answer ( A , _sum ( C , ( _state ( C ) , _next_to ( D , C ) , _most ( D , E , ( _state ( D ) , _loc ( E , D ) , _river ( E ) , _traverse ( E , D ) ) ) ) , _population ( C ) , A ) )
what is the capital of the states which have no surrounding states ?	_answer ( A , ( _capital ( A ) , _loc ( A , B ) , _state ( B ) , \+ ( _next_to ( B , C ) , _state ( C ) ) ) )
what is the capital of states does the longest river cross ?	_answer ( A , ( _capital ( A ) , _loc ( A , B ) , _state ( B ) , _longest ( C , _river ( C ) ) , _traverse ( C , B ) ) )
what states border states that border the biggest state in continental us ?	_answer ( A , ( _state ( A ) , _next_to ( A , B ) , _state ( B ) , _next_to ( B , C ) , _largest ( C , ( _state ( C ) , _loc ( C , D ) , _const ( D , _countryid ( usa ) ) ) ) ) )
what is the capital of the states ?	_answer ( A , ( _capital ( A ) , _loc ( A , B ) , _state ( B ) ) )
what is the largest city in the adjacent state of california ?	_answer ( A , _largest ( A , ( _city ( A ) , _loc ( A , B ) , _next_to ( B , C ) , _state ( B ) , _const ( C , _stateid ( california ) ) ) ) )
what is the smallest state that borders state is the city denver located in ?	_answer ( A , _smallest ( A , ( _state ( A ) , _next_to ( A , B ) , _state ( B ) , _city ( C ) , _const ( C , _cityid ( denver , _ ) ) , _loc ( C , B ) ) ) )
what is the highest elevation in state has highest elevation ?	_answer ( A , _highest ( A , ( _place ( A ) , _loc ( A , B ) , _state ( B ) , _loc ( C , B ) , _highest ( C , _place ( C ) ) ) ) )
what is the number of neighboring states for the adjacent state of california ?	_answer ( A , _count ( B , ( _state ( B ) , _next_to ( B , C ) , _next_to ( C , D ) , _state ( C ) , _const ( D , _stateid ( california ) ) ) , A ) )
what are the high points of states surrounding states high point are higher than that of colorado ?	_answer ( A , ( _high_point ( B , A ) , _loc ( A , B ) , _state ( B ) , _next_to ( B , C ) , _state ( C ) , _high_point ( C , D ) , _higher ( D , E ) , _high_point ( F , E ) , _const ( F , _stateid ( colorado ) ) ) )
what states border states that border states border states that border colorado ?	_answer ( A , ( _state ( A ) , _next_to ( A , B ) , _state ( B ) , _next_to ( B , C ) , _state ( C ) , _next_to ( C , D ) , _state ( D ) , _next_to ( D , E ) , _const ( E , _stateid ( colorado ) ) ) )
what state that borders states border kentucky is the largest ?	_answer ( A , _largest ( A , ( _state ( A ) , _next_to ( A , B ) , _state ( B ) , _next_to ( B , C ) , _const ( C , _stateid ( kentucky ) ) ) ) )
what the state with the lowest population city has the largest population ?	_answer ( A , _largest ( B , ( _smallest ( D , ( _state ( C ) , _population ( C , D ) ) ) , _city ( A ) , _loc ( A , C ) , _population ( A , B ) ) ) )
what is the highest point in the state with capital capital is the largest in the us ?	_answer ( A , _highest ( A , ( _place ( A ) , _loc ( A , B ) , _state ( B ) , _loc ( C , B ) , _capital ( C ) , _largest ( C , ( _capital ( C ) , _loc ( C , D ) , _const ( D , _countryid ( usa ) ) ) ) ) ) )
what states have rivers named river runs through the most states ?	_answer ( A , ( _state ( A ) , _loc ( B , A ) , _most ( B , C , ( _river ( B ) , _traverse ( B , C ) , _state ( C ) ) ) ) )
what are the biggest rivers in state is mount mckinley ?	_answer ( A , _longest ( A , ( _river ( A ) , _loc ( A , B ) , _loc ( C , B ) , _state ( B ) , _const ( C , _placeid ( ' mount mckinley ' ) ) ) ) )
what is the most populated state bordering state has the largest city ?	_answer ( A , _largest ( B , ( _population ( A , B ) , _state ( A ) , _next_to ( A , C ) , _largest ( D , ( _state ( C ) , _loc ( D , C ) , _city ( D ) ) ) ) ) )
what are the high points of states surrounding state has the shortest river ?	_answer ( A , ( _high_point ( B , A ) , _loc ( A , B ) , _state ( B ) , _next_to ( B , C ) , _state ( C ) , _loc ( D , C ) , _shortest ( D , _river ( D ) ) ) )
can you tell me the capital of the smallest state through which the longest river runs ?	_answer ( A , ( _capital ( A ) , _loc ( A , B ) , _smallest ( B , ( _state ( B ) , _longest ( C , _river ( C ) ) , _traverse ( C , B ) ) ) ) )
what is the capital of the the state with the lowest population state ?	_answer ( A , ( _capital ( A ) , _loc ( A , B ) , _smallest ( C , ( _state ( B ) , _population ( B , C ) ) ) , _state ( B ) ) )
what states border the smallest state that borders texas ?	_answer ( A , ( _state ( A ) , _next_to ( A , B ) , _smallest ( B , ( _state ( B ) , _next_to ( B , C ) , _const ( C , _stateid ( texas ) ) ) ) ) )
what are the rivers in the state of the states through which the longest river runs ?	_answer ( A , ( _river ( A ) , _loc ( A , B ) , _state ( B ) , _state ( B ) , _longest ( C , ( _river ( C ) , _traverse ( C , B ) ) ) ) )
what is the adjacent state of state has the smallest population density ?	_answer ( A , ( _next_to ( A , B ) , _state ( A ) , _smallest ( C , ( _state ( B ) , _density ( B , C ) ) ) ) )
what is the highest point in the neighboring states for michigan ?	_answer ( A , _highest ( A , ( _place ( A ) , _loc ( A , B ) , _next_to ( B , C ) , _state ( B ) , _const ( C , _stateid ( michigan ) ) ) ) )
what river runs through state is rochester ?	_answer ( A , ( _river ( A ) , _traverse ( A , B ) , _loc ( C , B ) , _state ( B ) , _const ( C , _cityid ( rochester , _ ) ) ) )
what states have a city named the capital of texas ?	_answer ( A , ( _state ( A ) , _loc ( B , A ) , _capital ( B ) , _loc ( B , C ) , _const ( C , _stateid ( texas ) ) ) )
what is the capital of the states that the potomac run through ?	_answer ( A , ( _capital ( A ) , _loc ( A , B ) , _state ( B ) , _const ( C , _riverid ( potomac ) ) , _traverse ( C , B ) ) )
what are the neighboring states for the states through which the longest river runs ?	_answer ( A , ( _next_to ( A , B ) , _state ( A ) , _state ( B ) , _longest ( C , ( _river ( C ) , _traverse ( C , B ) ) ) ) )
what is the longest river flowing through state has the city with the largest population ?	_answer ( A , _longest ( A , ( _river ( A ) , _traverse ( A , B ) , _state ( B ) , _loc ( C , B ) , _largest ( D , ( _city ( C ) , _population ( C , D ) ) ) ) ) )
what is capital of states border states that border colorado ?	_answer ( A , ( _capital ( A ) , _loc ( A , B ) , _state ( B ) , _next_to ( B , C ) , _state ( C ) , _next_to ( C , D ) , _const ( D , _stateid ( colorado ) ) ) )
what river flows through the smallest state that borders texas ?	_answer ( A , ( _river ( A ) , _traverse ( A , B ) , _smallest ( B , ( _state ( B ) , _next_to ( B , C ) , _const ( C , _stateid ( texas ) ) ) ) ) )
what states have rivers named river flows through kansas ?	_answer ( A , ( _state ( A ) , _loc ( B , A ) , _river ( B ) , _traverse ( B , C ) , _const ( C , _stateid ( kansas ) ) ) )
what is the average population per square km in state does the highest point in usa exist ?	_answer ( A , ( _density ( B , A ) , _loc ( C , B ) , _state ( B ) , _highest ( C , ( _place ( C ) , _loc ( C , D ) , _const ( D , _countryid ( usa ) ) ) ) ) )
how many states have a city named the capital of the alabama state ?	_answer ( A , _count ( B , ( _state ( B ) , _loc ( C , B ) , _capital ( C ) , _loc ( C , D ) , _const ( D , _stateid ( alabama ) ) , _state ( D ) ) , A ) )
what is the adjacent state of states have points that are higher than the highest point in texas ?	_answer ( A , ( _next_to ( A , B ) , _state ( A ) , _state ( B ) , _place ( C ) , _loc ( C , B ) , _higher ( C , D ) , _highest ( D , ( _place ( D ) , _loc ( D , E ) , _const ( E , _stateid ( texas ) ) ) ) ) )
how many people live in the biggest city in nebraska ?	_answer ( A , ( _population ( B , A ) , _largest ( B , ( _city ( B ) , _loc ( B , C ) , _const ( C , _stateid ( nebraska ) ) ) ) ) )
what is the population of the biggest city in texas ?	_answer ( A , ( _population ( B , A ) , _largest ( B , ( _city ( B ) , _loc ( B , C ) , _const ( C , _stateid ( texas ) ) ) ) ) )
what are the names of the major cities in state has highest elevation ?	_answer ( A , ( _major ( A ) , _city ( A ) , _loc ( A , B ) , _state ( B ) , _loc ( C , B ) , _highest ( C , _place ( C ) ) ) )
in which state is the cities which are in texas ?	_answer ( A , ( _loc ( B , A ) , _state ( A ) , _city ( B ) , _loc ( B , C ) , _const ( C , _stateid ( texas ) ) ) )
what is the largest city in the states that the potomac run through ?	_answer ( A , _largest ( A , ( _city ( A ) , _loc ( A , B ) , _state ( B ) , _const ( C , _riverid ( potomac ) ) , _traverse ( C , B ) ) ) )
what cities are located in states border states through which the mississippi traverses ?	_answer ( A , ( _city ( A ) , _loc ( A , B ) , _state ( B ) , _next_to ( B , C ) , _state ( C ) , _const ( D , _riverid ( mississippi ) ) , _traverse ( D , C ) ) )
where is the smallest state in the usa ?	_answer ( A , ( _loc ( B , A ) , _smallest ( B , ( _state ( B ) , _loc ( B , C ) , _const ( C , _countryid ( usa ) ) ) ) ) )
what is the adjacent state of the smallest state through which the longest river runs ?	_answer ( A , ( _next_to ( A , B ) , _state ( A ) , _smallest ( B , ( _state ( B ) , _longest ( C , _river ( C ) ) , _traverse ( C , B ) ) ) ) )
in which state is the biggest city in the usa ?	_answer ( A , ( _loc ( B , A ) , _state ( A ) , _largest ( B , ( _city ( B ) , _loc ( B , C ) , _const ( C , _countryid ( usa ) ) ) ) ) )
could you tell me what is the highest point in the state of state border kentucky ?	_answer ( A , _highest ( A , ( _place ( A ) , _loc ( A , B ) , _state ( B ) , _state ( B ) , _next_to ( B , C ) , _const ( C , _stateid ( kentucky ) ) ) ) )
what are the populations of states through which the the longest river in america run ?	_answer ( A , ( _population ( B , A ) , _state ( B ) , _longest ( C , ( _river ( C ) , _loc ( C , D ) , _const ( D , _countryid ( usa ) ) ) ) , _river ( C ) , _traverse ( C , B ) ) )
what is the lowest elevation in state has highest elevation ?	_answer ( A , _lowest ( A , ( _place ( A ) , _loc ( A , B ) , _state ( B ) , _loc ( C , B ) , _highest ( C , _place ( C ) ) ) ) )
where is state has the highest population density ?	_answer ( A , ( _loc ( B , A ) , _largest ( C , ( _state ( B ) , _density ( B , C ) ) ) ) )
what states border state is rochester ?	_answer ( A , ( _state ( A ) , _next_to ( A , B ) , _loc ( C , B ) , _state ( B ) , _const ( C , _cityid ( rochester , _ ) ) ) )
how many cities named s the largest city are there in the usa ?	_answer ( A , _count ( B , ( _city ( B ) , _largest ( B , _city ( B ) ) , _loc ( B , C ) , _const ( C , _countryid ( usa ) ) ) , A ) )
what is the size of state has the highest peak in the country ?	_answer ( A , ( _size ( B , A ) , _highest ( C , ( _state ( B ) , _loc ( C , B ) , _mountain ( C ) ) ) ) )
how many rivers in state has the most rivers running through it ?	_answer ( A , _count ( B , ( _river ( B ) , _loc ( B , C ) , _most ( C , D , ( _state ( C ) , _loc ( D , C ) , _river ( D ) , _traverse ( D , C ) ) ) ) , A ) )
what states border states border kentucky ?	_answer ( A , ( _state ( A ) , _next_to ( A , B ) , _state ( B ) , _next_to ( B , C ) , _const ( C , _stateid ( kentucky ) ) ) )
what rivers are in state border kentucky ?	_answer ( A , ( _river ( A ) , _loc ( A , B ) , _state ( B ) , _next_to ( B , C ) , _const ( C , _stateid ( kentucky ) ) ) )
what is the biggest city in the state with the lowest point ?	_answer ( A , _largest ( A , ( _city ( A ) , _loc ( A , B ) , _state ( B ) , _loc ( C , B ) , _lowest ( C , _place ( C ) ) ) ) )
what are the populations of states through which the the biggest rivers in texas run ?	_answer ( A , ( _population ( B , A ) , _state ( B ) , _longest ( C , ( _river ( C ) , _loc ( C , D ) , _const ( D , _stateid ( texas ) ) ) ) , _river ( C ) , _traverse ( C , B ) ) )
what is the lowest point in the state with the lowest point ?	_answer ( A , _lowest ( A , ( _place ( A ) , _loc ( A , B ) , _state ( B ) , _loc ( C , B ) , _lowest ( C , _place ( C ) ) ) ) )
what are the high points of states surrounding state has the longest river ?	_answer ( A , ( _high_point ( B , A ) , _loc ( A , B ) , _state ( B ) , _next_to ( B , C ) , _longest ( D , ( _state ( C ) , _loc ( D , C ) , _river ( D ) ) ) ) )
what is the adjacent state of the biggest state in continental us ?	_answer ( A , ( _next_to ( A , B ) , _state ( A ) , _largest ( B , ( _state ( B ) , _loc ( B , C ) , _const ( C , _countryid ( usa ) ) ) ) ) )
how long is the the river that cross over ohio ?	_answer ( A , ( _len ( B , A ) , _river ( B ) , _traverse ( B , C ) , _const ( C , _stateid ( ohio ) ) , _river ( B ) ) )
how many states does the smallest state in the usa border ?	_answer ( A , _count ( B , ( _state ( B ) , _smallest ( C , ( _state ( C ) , _loc ( C , D ) , _const ( D , _countryid ( usa ) ) ) ) , _next_to ( C , B ) ) , A ) )
what is the highest elevation in state has the largest city ?	_answer ( A , _highest ( A , ( _place ( A ) , _loc ( A , B ) , _largest ( C , ( _state ( B ) , _loc ( C , B ) , _city ( C ) ) ) ) ) )
could you tell me what is the highest point in the state of state is rochester ?	_answer ( A , _highest ( A , ( _place ( A ) , _loc ( A , B ) , _state ( B ) , _loc ( C , B ) , _state ( B ) , _const ( C , _cityid ( rochester , _ ) ) ) ) )
how many states does the the biggest river in illinois flow through ?	_answer ( A , _count ( B , ( _state ( B ) , _largest ( C , ( _river ( C ) , _loc ( C , D ) , _const ( D , _stateid ( illinois ) ) ) ) , _river ( C ) , _traverse ( C , B ) ) , A ) )
what are the populations of the states through which the major rivers run through illinois run ?	_answer ( A , ( _population ( B , A ) , _state ( B ) , _major ( C ) , _river ( C ) , _traverse ( C , D ) , _const ( D , _stateid ( illinois ) ) , _river ( C ) , _traverse ( C , B ) ) )
what is the population of the major cities in kansas ga ?	_answer ( A , ( _population ( B , A ) , _major ( B ) , _city ( B ) , _loc ( B , C ) , _const ( C , _stateid ( kansas ) ) ) )
which states have points that are higher than the highest point in state has the shortest river ?	_answer ( A , ( _state ( A ) , _place ( B ) , _loc ( B , A ) , _higher ( B , C ) , _highest ( C , ( _place ( C ) , _loc ( C , D ) , _state ( D ) , _loc ( E , D ) , _shortest ( E , _river ( E ) ) ) ) ) )
what states does the the major rivers in the us run through ?	_answer ( A , ( _state ( A ) , _major ( B ) , _river ( B ) , _loc ( B , C ) , _const ( C , _countryid ( usa ) ) , _river ( B ) , _traverse ( B , A ) ) )
what is the average population per square km in states have points that are higher than the highest point in texas ?	_answer ( A , ( _density ( B , A ) , _state ( B ) , _place ( C ) , _loc ( C , B ) , _higher ( C , D ) , _highest ( D , ( _place ( D ) , _loc ( D , E ) , _const ( E , _stateid ( texas ) ) ) ) ) )
what are the names of the major cities in state is the largest city in montana in ?	_answer ( A , ( _major ( A ) , _city ( A ) , _loc ( A , B ) , _state ( B ) , _largest ( C , ( _city ( C ) , _loc ( C , D ) , _const ( D , _stateid ( montana ) ) ) ) , _loc ( C , B ) ) )
which states have points that are higher than the highest point in the adjacent state of california ?	_answer ( A , ( _state ( A ) , _place ( B ) , _loc ( B , A ) , _higher ( B , C ) , _highest ( C , ( _place ( C ) , _loc ( C , D ) , _next_to ( D , E ) , _state ( D ) , _const ( E , _stateid ( california ) ) ) ) ) )
how high is the highest point of states border kentucky ?	_answer ( A , ( _elevation ( B , A ) , _highest ( B , ( _place ( B ) , _loc ( B , C ) , _state ( C ) , _next_to ( C , D ) , _const ( D , _stateid ( kentucky ) ) ) ) ) )
what is the longest river in state is mount mckinley ?	_answer ( A , _longest ( A , ( _river ( A ) , _loc ( A , B ) , _loc ( C , B ) , _state ( B ) , _const ( C , _placeid ( ' mount mckinley ' ) ) ) ) )
what is the population of the smallest state that borders texas ?	_answer ( A , ( _population ( B , A ) , _smallest ( B , ( _state ( B ) , _next_to ( B , C ) , _const ( C , _stateid ( texas ) ) ) ) ) )
what is the size of state has the largest population density ?	_answer ( A , ( _size ( B , A ) , _largest ( C , ( _state ( B ) , _density ( B , C ) ) ) ) )
what major rivers run through the states ?	_answer ( A , ( _major ( A ) , _river ( A ) , _traverse ( A , B ) , _state ( B ) ) )
what are the capitals of the states that border states border georgia ?	_answer ( A , ( _capital ( A ) , _loc ( A , B ) , _state ( B ) , _next_to ( B , C ) , _state ( C ) , _next_to ( C , D ) , _const ( D , _stateid ( georgia ) ) ) )
what are the biggest rivers in the largest state bordering texas ?	_answer ( A , _longest ( A , ( _river ( A ) , _loc ( A , B ) , _largest ( B , ( _state ( B ) , _next_to ( B , C ) , _const ( C , _stateid ( texas ) ) ) ) ) ) )
what is the longest river in states border states through which the mississippi traverses ?	_answer ( A , _longest ( A , ( _river ( A ) , _loc ( A , B ) , _state ( B ) , _next_to ( B , C ) , _state ( C ) , _const ( D , _riverid ( mississippi ) ) , _traverse ( D , C ) ) ) )
what are the populations of the states through which the the longest river that passes through the us run ?	_answer ( A , ( _population ( B , A ) , _state ( B ) , _longest ( C , ( _river ( C ) , _traverse ( C , D ) , _const ( D , _countryid ( usa ) ) ) ) , _river ( C ) , _traverse ( C , B ) ) )
what river flows through state is the largest city in montana in ?	_answer ( A , ( _river ( A ) , _traverse ( A , B ) , _state ( B ) , _largest ( C , ( _city ( C ) , _loc ( C , D ) , _const ( D , _stateid ( montana ) ) ) ) , _loc ( C , B ) ) )
can you tell me the capital of state has the longest river ?	_answer ( A , ( _capital ( A ) , _loc ( A , B ) , _longest ( C , ( _state ( B ) , _loc ( C , B ) , _river ( C ) ) ) ) )
what is the adjacent state of states border colorado ?	_answer ( A , ( _next_to ( A , B ) , _state ( A ) , _state ( B ) , _next_to ( B , C ) , _const ( C , _stateid ( colorado ) ) ) )
what is the longest river that runs through a state that borders states does the mississippi river run through ?	_answer ( A , _longest ( A , ( _river ( A ) , _traverse ( A , B ) , _state ( B ) , _next_to ( B , C ) , _state ( C ) , _const ( D , _riverid ( mississippi ) ) , _river ( D ) , _traverse ( D , C ) ) ) )
how many rivers in states border texas ?	_answer ( A , _count ( B , ( _river ( B ) , _loc ( B , C ) , _state ( C ) , _next_to ( C , D ) , _const ( D , _stateid ( texas ) ) ) , A ) )
what cities are located in state has the smallest population density ?	_answer ( A , ( _city ( A ) , _loc ( A , B ) , _smallest ( C , ( _state ( B ) , _density ( B , C ) ) ) ) )
what river flows through states does the longest river cross ?	_answer ( A , ( _river ( A ) , _traverse ( A , B ) , _state ( B ) , _longest ( C , _river ( C ) ) , _traverse ( C , B ) ) )
what is the smallest state that borders state border kentucky ?	_answer ( A , _smallest ( A , ( _state ( A ) , _next_to ( A , B ) , _state ( B ) , _next_to ( B , C ) , _const ( C , _stateid ( kentucky ) ) ) ) )
how many rivers are in states border arkansas ?	_answer ( A , _count ( B , ( _river ( B ) , _loc ( B , C ) , _state ( C ) , _next_to ( C , D ) , _const ( D , _stateid ( arkansas ) ) ) , A ) )
what is the most populous city in states border states that border colorado ?	_answer ( B , _largest ( A , ( _population ( B , A ) , _city ( B ) , _loc ( B , C ) , _state ( C ) , _next_to ( C , D ) , _state ( D ) , _next_to ( D , E ) , _const ( E , _stateid ( colorado ) ) ) ) )
what is the average population per square km in state is rochester ?	_answer ( A , ( _density ( B , A ) , _loc ( C , B ) , _state ( B ) , _const ( C , _cityid ( rochester , _ ) ) ) )
which states does the the biggest river in illinois run through ?	_answer ( A , ( _state ( A ) , _largest ( B , ( _river ( B ) , _loc ( B , C ) , _const ( C , _stateid ( illinois ) ) ) ) , _river ( B ) , _traverse ( B , A ) ) )
how many major cities are in state has highest elevation ?	_answer ( A , _count ( B , ( _major ( B ) , _city ( B ) , _loc ( B , C ) , _state ( C ) , _loc ( D , C ) , _highest ( D , _place ( D ) ) ) , A ) )
how many cities named capital of iowa are there in the usa ?	_answer ( A , _count ( B , ( _city ( B ) , _capital ( B ) , _loc ( B , D ) , _const ( D , _stateid ( iowa ) ) , _loc ( B , C ) , _const ( C , _countryid ( usa ) ) ) , A ) )
what is the longest river that runs through a state that borders the biggest state in continental us ?	_answer ( A , _longest ( A , ( _river ( A ) , _traverse ( A , B ) , _state ( B ) , _next_to ( B , C ) , _largest ( C , ( _state ( C ) , _loc ( C , D ) , _const ( D , _countryid ( usa ) ) ) ) ) ) )
how many cities named the biggest city in texas are there in the usa ?	_answer ( A , _count ( B , ( _city ( B ) , _largest ( B , ( _city ( B ) , _loc ( B , D ) , _const ( D , _stateid ( texas ) ) ) ) , _loc ( B , C ) , _const ( C , _countryid ( usa ) ) ) , A ) )
what are the neighboring states for states border arkansas ?	_answer ( A , ( _next_to ( A , B ) , _state ( A ) , _state ( B ) , _next_to ( B , C ) , _const ( C , _stateid ( arkansas ) ) ) )
how many people live in the states that border the state with the greatest population ?	_answer ( A , ( _population ( B , A ) , _state ( B ) , _next_to ( C , B ) , _largest ( D , ( _state ( C ) , _population ( C , D ) ) ) ) )
what is the smallest state that borders the smallest state in the usa ?	_answer ( A , _smallest ( A , ( _state ( A ) , _next_to ( A , B ) , _smallest ( B , ( _state ( B ) , _loc ( B , C ) , _const ( C , _countryid ( usa ) ) ) ) ) ) )
what is the longest river flowing through the states that the potomac run through ?	_answer ( A , _longest ( A , ( _river ( A ) , _traverse ( A , B ) , _state ( B ) , _const ( C , _riverid ( potomac ) ) , _traverse ( C , B ) ) ) )
what states does the river runs through illinois run through ?	_answer ( A , ( _state ( A ) , _river ( B ) , _traverse ( B , C ) , _const ( C , _stateid ( illinois ) ) , _river ( B ) , _traverse ( B , A ) ) )
what river runs through states does the colorado river run through ?	_answer ( A , ( _river ( A ) , _traverse ( A , B ) , _state ( B ) , _const ( C , _riverid ( colorado ) ) , _river ( C ) , _traverse ( C , B ) ) )
what is the largest state bordering states border colorado ?	_answer ( A , _largest ( A , ( _state ( A ) , _next_to ( A , B ) , _state ( B ) , _next_to ( B , C ) , _const ( C , _stateid ( colorado ) ) ) ) )
how high is the highest point of states border texas ?	_answer ( A , ( _elevation ( B , A ) , _highest ( B , ( _place ( B ) , _loc ( B , C ) , _state ( C ) , _next_to ( C , D ) , _const ( D , _stateid ( texas ) ) ) ) ) )
what is the largest state bordering state does the highest point in usa exist ?	_answer ( A , _largest ( A , ( _state ( A ) , _next_to ( A , B ) , _loc ( C , B ) , _state ( B ) , _highest ( C , ( _place ( C ) , _loc ( C , D ) , _const ( D , _countryid ( usa ) ) ) ) ) ) )
what are the rivers in the state of state has highest elevation ?	_answer ( A , ( _river ( A ) , _loc ( A , B ) , _state ( B ) , _state ( B ) , _loc ( C , B ) , _highest ( C , _place ( C ) ) ) )
what is the largest city in state does the highest point in usa exist ?	_answer ( A , _largest ( A , ( _city ( A ) , _loc ( A , B ) , _loc ( C , B ) , _state ( B ) , _highest ( C , ( _place ( C ) , _loc ( C , D ) , _const ( D , _countryid ( usa ) ) ) ) ) ) )
what is the population of capital of iowa ?	_answer ( A , ( _population ( B , A ) , _capital ( B ) , _loc ( B , C ) , _const ( C , _stateid ( iowa ) ) ) )
what is the smallest city in the smallest state that borders texas ?	_answer ( A , _smallest ( A , ( _city ( A ) , _loc ( A , B ) , _smallest ( B , ( _state ( B ) , _next_to ( B , C ) , _const ( C , _stateid ( texas ) ) ) ) ) ) )
what is the area of the states ?	_answer ( A , ( _area ( B , A ) , _state ( B ) ) )
name all the rivers in state has the highest population density ?	_answer ( A , ( _river ( A ) , _loc ( A , B ) , _largest ( C , ( _state ( B ) , _density ( B , C ) ) ) ) )
what is the longest river that runs through a state that borders the states ?	_answer ( A , _longest ( A , ( _river ( A ) , _traverse ( A , B ) , _state ( B ) , _next_to ( B , C ) , _state ( C ) ) ) )
what states neighbor state has highest elevation ?	_answer ( A , ( _state ( A ) , _next_to ( A , B ) , _state ( B ) , _loc ( C , B ) , _highest ( C , _place ( C ) ) ) )
give me the cities which are in state has the shortest river ?	_answer ( A , ( _city ( A ) , _loc ( A , B ) , _state ( B ) , _loc ( C , B ) , _shortest ( C , _river ( C ) ) ) )
which capitals are in the states that border the state with the lowest population ?	_answer ( A , ( _capital ( A ) , _loc ( A , B ) , _state ( B ) , _next_to ( B , C ) , _smallest ( D , ( _state ( C ) , _population ( C , D ) ) ) ) )
can you tell me the capital of the states that border the state with the greatest population ?	_answer ( A , ( _capital ( A ) , _loc ( A , B ) , _state ( B ) , _next_to ( C , B ) , _largest ( D , ( _state ( C ) , _population ( C , D ) ) ) ) )
what is the smallest state that borders states border colorado ?	_answer ( A , _smallest ( A , ( _state ( A ) , _next_to ( A , B ) , _state ( B ) , _next_to ( B , C ) , _const ( C , _stateid ( colorado ) ) ) ) )
what is the most populated state bordering states border arkansas ?	_answer ( A , _largest ( B , ( _population ( A , B ) , _state ( A ) , _next_to ( A , C ) , _state ( C ) , _next_to ( C , D ) , _const ( D , _stateid ( arkansas ) ) ) ) )
what states border the states through which the longest river runs ?	_answer ( A , ( _state ( A ) , _next_to ( A , B ) , _state ( B ) , _longest ( C , ( _river ( C ) , _traverse ( C , B ) ) ) ) )
what is capital of the biggest state in continental us ?	_answer ( A , ( _capital ( A ) , _loc ( A , B ) , _largest ( B , ( _state ( B ) , _loc ( B , C ) , _const ( C , _countryid ( usa ) ) ) ) ) )
what river runs through the states ?	_answer ( A , ( _river ( A ) , _traverse ( A , B ) , _state ( B ) ) )
what river runs through state is the city denver located in ?	_answer ( A , ( _river ( A ) , _traverse ( A , B ) , _state ( B ) , _city ( C ) , _const ( C , _cityid ( denver , _ ) ) , _loc ( C , B ) ) )
what are the rivers in the state of states border states that border colorado ?	_answer ( A , ( _river ( A ) , _loc ( A , B ) , _state ( B ) , _state ( B ) , _next_to ( B , C ) , _state ( C ) , _next_to ( C , D ) , _const ( D , _stateid ( colorado ) ) ) )
what states have a city named capitals are not major cities ?	_answer ( A , ( _state ( A ) , _loc ( B , A ) , _capital ( B ) , \+ ( _major ( B ) , _city ( B ) ) ) )
what is the population of state does the highest point in usa exist ?	_answer ( A , ( _population ( B , A ) , _loc ( C , B ) , _state ( B ) , _highest ( C , ( _place ( C ) , _loc ( C , D ) , _const ( D , _countryid ( usa ) ) ) ) ) )
name all the rivers in the smallest state in the usa ?	_answer ( A , ( _river ( A ) , _loc ( A , B ) , _smallest ( B , ( _state ( B ) , _loc ( B , C ) , _const ( C , _countryid ( usa ) ) ) ) ) )
what is the highest point in state has the city with the largest population ?	_answer ( A , _highest ( A , ( _place ( A ) , _loc ( A , B ) , _state ( B ) , _loc ( C , B ) , _largest ( D , ( _city ( C ) , _population ( C , D ) ) ) ) ) )
what is the number of neighboring states for state is the largest city in montana in ?	_answer ( A , _count ( B , ( _state ( B ) , _next_to ( B , C ) , _state ( C ) , _largest ( D , ( _city ( D ) , _loc ( D , E ) , _const ( E , _stateid ( montana ) ) ) ) , _loc ( D , C ) ) , A ) )
which states border the states that the potomac run through ?	_answer ( A , ( _state ( A ) , _next_to ( A , B ) , _state ( B ) , _const ( C , _riverid ( potomac ) ) , _traverse ( C , B ) ) )
how many rivers in states does the colorado river run through ?	_answer ( A , _count ( B , ( _river ( B ) , _loc ( B , C ) , _state ( C ) , _const ( D , _riverid ( colorado ) ) , _river ( D ) , _traverse ( D , C ) ) , A ) )
what is the highest mountain in states border colorado ?	_answer ( A , _highest ( A , ( _mountain ( A ) , _loc ( A , B ) , _state ( B ) , _next_to ( B , C ) , _const ( C , _stateid ( colorado ) ) ) ) )
what are the capitals of the states that border the state with the lowest point ?	_answer ( A , ( _capital ( A ) , _loc ( A , B ) , _state ( B ) , _next_to ( B , C ) , _state ( C ) , _loc ( D , C ) , _lowest ( D , _place ( D ) ) ) )
what state that borders state has the highest population density is the largest ?	_answer ( A , _largest ( A , ( _state ( A ) , _next_to ( A , B ) , _largest ( C , ( _state ( B ) , _density ( B , C ) ) ) ) ) )
how many states have a city called capitals are in the states that border texas ?	_answer ( A , _count ( B , ( _state ( B ) , _loc ( C , B ) , _capital ( C ) , _loc ( C , D ) , _state ( D ) , _next_to ( D , E ) , _const ( E , _stateid ( texas ) ) ) , A ) )
what is the lowest point in states border arkansas ?	_answer ( A , _lowest ( A , ( _place ( A ) , _loc ( A , B ) , _state ( B ) , _next_to ( B , C ) , _const ( C , _stateid ( arkansas ) ) ) ) )
name all the rivers in the state with the lowest point ?	_answer ( A , ( _river ( A ) , _loc ( A , B ) , _state ( B ) , _loc ( C , B ) , _lowest ( C , _place ( C ) ) ) )
what is the capital of the state has no rivers state ?	_answer ( A , ( _capital ( A ) , _loc ( A , B ) , _state ( B ) , \+ ( _loc ( C , B ) , _river ( C ) ) , _state ( B ) ) )
what is the total population of the states that border state is the largest city in montana in ?	_answer ( A , _sum ( C , ( _state ( C ) , _next_to ( D , C ) , _state ( D ) , _largest ( E , ( _city ( E ) , _loc ( E , F ) , _const ( F , _stateid ( montana ) ) ) ) , _loc ( E , D ) ) , _population ( C ) , A ) )
what is the longest river flowing through state has the highest peak in the country ?	_answer ( A , _longest ( A , ( _river ( A ) , _traverse ( A , B ) , _highest ( C , ( _state ( B ) , _loc ( C , B ) , _mountain ( C ) ) ) ) ) )
what is the biggest city in state has the highest peak in the country ?	_answer ( A , _largest ( A , ( _city ( A ) , _loc ( A , B ) , _highest ( C , ( _state ( B ) , _loc ( C , B ) , _mountain ( C ) ) ) ) ) )
what is the total population of the states that border state has the highest peak in the country ?	_answer ( A , _sum ( C , ( _state ( C ) , _next_to ( D , C ) , _highest ( E , ( _state ( D ) , _loc ( E , D ) , _mountain ( E ) ) ) ) , _population ( C ) , A ) )
what rivers run through the state with the lowest point ?	_answer ( A , ( _river ( A ) , _traverse ( A , B ) , _state ( B ) , _loc ( C , B ) , _lowest ( C , _place ( C ) ) ) )
what are the major cities in the neighboring states for michigan ?	_answer ( A , ( _major ( A ) , _city ( A ) , _loc ( A , B ) , _next_to ( B , C ) , _state ( B ) , _const ( C , _stateid ( michigan ) ) ) )
what is the total population of the states that border states have points that are higher than the highest point in texas ?	_answer ( A , _sum ( C , ( _state ( C ) , _next_to ( D , C ) , _state ( D ) , _place ( E ) , _loc ( E , D ) , _higher ( E , F ) , _highest ( F , ( _place ( F ) , _loc ( F , G ) , _const ( G , _stateid ( texas ) ) ) ) ) , _population ( C ) , A ) )
what is the population of the major cities in texas ?	_answer ( A , ( _population ( B , A ) , _major ( B ) , _city ( B ) , _loc ( B , C ) , _const ( C , _stateid ( texas ) ) ) )
what is the highest point in states does the mississippi river run through ?	_answer ( A , _highest ( A , ( _place ( A ) , _loc ( A , B ) , _state ( B ) , _const ( C , _riverid ( mississippi ) ) , _river ( C ) , _traverse ( C , B ) ) ) )
which states border the most populated state bordering oklahoma ?	_answer ( A , ( _state ( A ) , _next_to ( A , B ) , _largest ( C , ( _population ( B , C ) , _state ( B ) , _next_to ( B , D ) , _const ( D , _stateid ( oklahoma ) ) ) ) ) )
how many rivers are in the states that border the state with the greatest population ?	_answer ( A , _count ( B , ( _river ( B ) , _loc ( B , C ) , _state ( C ) , _next_to ( D , C ) , _largest ( E , ( _state ( D ) , _population ( D , E ) ) ) ) , A ) )
what states neighbor state has the highest peak in the country ?	_answer ( A , ( _state ( A ) , _next_to ( A , B ) , _highest ( C , ( _state ( B ) , _loc ( C , B ) , _mountain ( C ) ) ) ) )
what are the capitals of the states that border states have a city named austin ?	_answer ( A , ( _capital ( A ) , _loc ( A , B ) , _state ( B ) , _next_to ( B , C ) , _state ( C ) , _loc ( D , C ) , _const ( D , _cityid ( austin , _ ) ) ) )
what major rivers run through state has the highest peak in the country ?	_answer ( A , ( _major ( A ) , _river ( A ) , _traverse ( A , B ) , _highest ( C , ( _state ( B ) , _loc ( C , B ) , _mountain ( C ) ) ) ) )
how many states does the the shortest river in the united states flow through ?	_answer ( A , _count ( B , ( _state ( B ) , _shortest ( C , ( _river ( C ) , _loc ( C , D ) , _const ( D , _countryid ( usa ) ) ) ) , _river ( C ) , _traverse ( C , B ) ) , A ) )
how many major cities are in states neighbor maine ?	_answer ( A , _count ( B , ( _major ( B ) , _city ( B ) , _loc ( B , C ) , _state ( C ) , _next_to ( C , D ) , _const ( D , _stateid ( maine ) ) ) , A ) )
how high is the highest point of the adjacent state of california ?	_answer ( A , ( _elevation ( B , A ) , _highest ( B , ( _place ( B ) , _loc ( B , C ) , _next_to ( C , D ) , _state ( C ) , _const ( D , _stateid ( california ) ) ) ) ) )
what states neighbor states border states through which the mississippi traverses ?	_answer ( A , ( _state ( A ) , _next_to ( A , B ) , _state ( B ) , _next_to ( B , C ) , _state ( C ) , _const ( D , _riverid ( mississippi ) ) , _traverse ( D , C ) ) )
what is capital of the states that border the state with the greatest population ?	_answer ( A , ( _capital ( A ) , _loc ( A , B ) , _state ( B ) , _next_to ( C , B ) , _largest ( D , ( _state ( C ) , _population ( C , D ) ) ) ) )
what are the biggest rivers in the states which have no surrounding states ?	_answer ( A , _longest ( A , ( _river ( A ) , _loc ( A , B ) , _state ( B ) , \+ ( _next_to ( B , C ) , _state ( C ) ) ) ) )
