what is the highest point in florida ?	_answer ( A , _highest ( A , ( _place ( A ) , _loc ( A , B ) , _const ( B , _stateid ( florida ) ) ) ) )
what are the high points of states surrounding mississippi ?	_answer ( A , ( _high_point ( B , A ) , _loc ( A , B ) , _state ( B ) , _next_to ( B , C ) , _const ( C , _stateid ( mississippi ) ) ) )
what state has the shortest river ?	_answer ( A , ( _state ( A ) , _loc ( B , A ) , _shortest ( B , _river ( B ) ) ) )
what is the tallest mountain in the united states ?	_answer ( A , _highest ( A , ( _mountain ( A ) , _loc ( A , B ) , _const ( B , _countryid ( usa ) ) ) ) )
what is the capital of maine ?	_answer ( A , ( _capital ( A ) , _loc ( A , B ) , _const ( B , _stateid ( maine ) ) ) )
what are the populations of states through which the mississippi river run ?	_answer ( A , ( _population ( B , A ) , _state ( B ) , _const ( C , _riverid ( mississippi ) ) , _river ( C ) , _traverse ( C , B ) ) )
name all the lakes of us ?	_answer ( A , ( _lake ( A ) , _loc ( A , B ) , _const ( B , _countryid ( usa ) ) ) )
which states border states through which the mississippi traverses ?	_answer ( A , ( _state ( A ) , _next_to ( A , B ) , _state ( B ) , _const ( C , _riverid ( mississippi ) ) , _traverse ( C , B ) ) )
what is the highest mountain in alaska ?	_answer ( A , _highest ( A , ( _mountain ( A ) , _loc ( A , B ) , _const ( B , _stateid ( alaska ) ) ) ) )
what is the population of illinois ?	_answer ( A , ( _population ( B , A ) , _const ( B , _stateid ( illinois ) ) ) )
name all the rivers in colorado ?	_answer ( A , ( _river ( A ) , _loc ( A , B ) , _const ( B , _stateid ( colorado ) ) ) )
in which state does the highest point in usa exist ?	_answer ( A , ( _loc ( B , A ) , _state ( A ) , _highest ( B , ( _place ( B ) , _loc ( B , C ) , _const ( C , _countryid ( usa ) ) ) ) ) )
which state is the city denver located in ?	_answer ( A , ( _state ( A ) , _city ( B ) , _const ( B , _cityid ( denver , _ ) ) , _loc ( B , A ) ) )
what is the lowest point in texas ?	_answer ( A , _lowest ( A , ( _place ( A ) , _loc ( A , B ) , _const ( B , _stateid ( texas ) ) ) ) )
how many states have a city called rochester ?	_answer ( A , _count ( B , ( _state ( B ) , _loc ( C , B ) , _const ( C , _cityid ( rochester , _ ) ) ) , A ) )
which capitals are in the states that border texas ?	_answer ( A , ( _capital ( A ) , _loc ( A , B ) , _state ( B ) , _next_to ( B , C ) , _const ( C , _stateid ( texas ) ) ) )
how many people live in austin ?	_answer ( A , ( _population ( B , A ) , _const ( B , _cityid ( austin , _ ) ) ) )
what states have rivers named colorado ?	_answer ( A , ( _state ( A ) , _loc ( B , A ) , _const ( B , _riverid ( colorado ) ) ) )
what is the size of texas ?	_answer ( A , ( _size ( B , A ) , _const ( B , _stateid ( texas ) ) ) )
what is the shortest river in the usa ?	_answer ( A , _shortest ( A , ( _river ( A ) , _loc ( A , B ) , _const ( B , _countryid ( usa ) ) ) ) )
what are the major cities of the us ?	_answer ( A , ( _major ( A ) , _city ( A ) , _loc ( A , B ) , _const ( B , _countryid ( usa ) ) ) )
which state border kentucky ?	_answer ( A , ( _state ( A ) , _next_to ( A , B ) , _const ( B , _stateid ( kentucky ) ) ) )
what is the population of oregon ?	_answer ( A , ( _population ( B , A ) , _const ( B , _stateid ( oregon ) ) ) )
what states have a city named austin ?	_answer ( A , ( _state ( A ) , _loc ( B , A ) , _const ( B , _cityid ( austin , _ ) ) ) )
what is the highest elevation in south carolina ?	_answer ( A , _highest ( A , ( _place ( A ) , _loc ( A , B ) , _const ( B , _stateid ( ' south carolina ' ) ) ) ) )
how many people live in austin texas ?	_answer ( A , ( _population ( B , A ) , _const ( B , _cityid ( austin , tx ) ) ) )
what are the rivers in the state of texas ?	_answer ( A , ( _river ( A ) , _loc ( A , B ) , _state ( B ) , _const ( B , _stateid ( texas ) ) ) )
what is the lowest point of colorado ?	_answer ( A , _lowest ( A , ( _place ( A ) , _loc ( A , B ) , _const ( B , _stateid ( colorado ) ) ) ) )
what is the population of atlanta ?	_answer ( A , ( _population ( B , A ) , _const ( B , _cityid ( atlanta , _ ) ) ) )
what rivers are in utah ?	_answer ( A , ( _river ( A ) , _loc ( A , B ) , _const ( B , _stateid ( utah ) ) ) )
what river runs through the most states ?	_answer ( A , _most ( A , B , ( _river ( A ) , _traverse ( A , B ) , _state ( B ) ) ) )
what is the population of sacramento ?	_answer ( A , ( _population ( B , A ) , _const ( B , _cityid ( sacramento , _ ) ) ) )
could you tell me what is the highest point in the state of oregon ?	_answer ( A , _highest ( A , ( _place ( A ) , _loc ( A , B ) , _state ( B ) , _const ( B , _stateid ( oregon ) ) ) ) )
which states does the mississippi river run through ?	_answer ( A , ( _state ( A ) , _const ( B , _riverid ( mississippi ) ) , _river ( B ) , _traverse ( B , A ) ) )
what are the major cities in the smallest state in the us ?	_answer ( A , ( _major ( A ) , _city ( A ) , _loc ( A , B ) , _smallest ( B , ( _state ( B ) , _loc ( B , C ) , _const ( C , _countryid ( usa ) ) ) ) ) )
how high is guadalupe peak ?	_answer ( A , ( _elevation ( B , A ) , _const ( B , _placeid ( ' guadalupe peak ' ) ) ) )
what river runs through illinois ?	_answer ( A , ( _river ( A ) , _traverse ( A , B ) , _const ( B , _stateid ( illinois ) ) ) )
how long is the mississippi river ?	_answer ( A , ( _len ( B , A ) , _const ( B , _riverid ( mississippi ) ) , _river ( B ) ) )
how high is the highest point in the largest state ?	_answer ( A , ( _elevation ( B , A ) , _highest ( B , ( _place ( B ) , _loc ( B , C ) , _largest ( C , _state ( C ) ) ) ) ) )
what is the area of south carolina ?	_answer ( A , ( _area ( B , A ) , _const ( B , _stateid ( ' south carolina ' ) ) ) )
what are the states through which the longest river runs ?	_answer ( A , ( _state ( A ) , _longest ( B , ( _river ( B ) , _traverse ( B , A ) ) ) ) )
where is new orleans ?	_answer ( A , ( _loc ( B , A ) , _const ( B , _cityid ( ' new orleans ' , _ ) ) ) )
in what state is mount mckinley ?	_answer ( A , ( _loc ( B , A ) , _state ( A ) , _const ( B , _placeid ( ' mount mckinley ' ) ) ) )
what state has highest elevation ?	_answer ( A , ( _state ( A ) , _loc ( B , A ) , _highest ( B , _place ( B ) ) ) )
what is the size of california ?	_answer ( A , ( _size ( B , A ) , _const ( B , _stateid ( california ) ) ) )
what is the smallest state that borders texas ?	_answer ( A , _smallest ( A , ( _state ( A ) , _next_to ( A , B ) , _const ( B , _stateid ( texas ) ) ) ) )
how many citizens in alabama ?	_answer ( A , ( _population ( B , A ) , _const ( B , _stateid ( alabama ) ) ) )
in which state is rochester ?	_answer ( A , ( _loc ( B , A ) , _state ( A ) , _const ( B , _cityid ( rochester , _ ) ) ) )
how many states in the us does the shortest river run through ?	_answer ( A , _count ( B , ( _state ( B ) , _loc ( B , C ) , _const ( C , _countryid ( usa ) ) , _shortest ( D , _river ( D ) ) , _traverse ( D , B ) ) , A ) )
what is the biggest state in continental us ?	_answer ( A , _largest ( A , ( _state ( A ) , _loc ( A , B ) , _const ( B , _countryid ( usa ) ) ) ) )
what is the area of the largest state ?	_answer ( A , ( _area ( B , A ) , _largest ( B , _state ( B ) ) ) )
where is mount whitney ?	_answer ( A , ( _loc ( B , A ) , _const ( B , _placeid ( ' mount whitney ' ) ) ) )
how many states does iowa border ?	_answer ( A , _count ( B , ( _state ( B ) , _const ( C , _stateid ( iowa ) ) , _next_to ( C , B ) ) , A ) )
which states does the longest river cross ?	_answer ( A , ( _state ( A ) , _longest ( B , _river ( B ) ) , _traverse ( B , A ) ) )
what river flows through kansas ?	_answer ( A , ( _river ( A ) , _traverse ( A , B ) , _const ( B , _stateid ( kansas ) ) ) )
what is the population of austin texas ?	_answer ( A , ( _population ( B , A ) , _const ( B , _cityid ( austin , tx ) ) ) )
what is the capital of vermont ?	_answer ( A , ( _capital ( A ) , _loc ( A , B ) , _const ( B , _stateid ( vermont ) ) ) )
which states border colorado ?	_answer ( A , ( _state ( A ) , _next_to ( A , B ) , _const ( B , _stateid ( colorado ) ) ) )
how long is the mississippi ?	_answer ( A , ( _len ( B , A ) , _const ( B , _riverid ( mississippi ) ) ) )
what state has the largest population density ?	_answer ( A , _largest ( B , ( _state ( A ) , _density ( A , B ) ) ) )
what states border georgia ?	_answer ( A , ( _state ( A ) , _next_to ( A , B ) , _const ( B , _stateid ( georgia ) ) ) )
what is the capital of pennsylvania ?	_answer ( A , ( _capital ( A ) , _loc ( A , B ) , _const ( B , _stateid ( pennsylvania ) ) ) )
what are the biggest rivers in texas ?	_answer ( A , _longest ( A , ( _river ( A ) , _loc ( A , B ) , _const ( B , _stateid ( texas ) ) ) ) )
what is the longest river in the united states ?	_answer ( A , _longest ( A , ( _river ( A ) , _loc ( A , B ) , _const ( B , _countryid ( usa ) ) ) ) )
what is the capital of utah ?	_answer ( A , ( _capital ( A ) , _loc ( A , B ) , _const ( B , _stateid ( utah ) ) ) )
what state has the smallest population density ?	_answer ( A , _smallest ( B , ( _state ( A ) , _density ( A , B ) ) ) )
which capitals are not major cities ?	_answer ( A , ( _capital ( A ) , \+ ( _major ( A ) , _city ( A ) ) ) )
what is the biggest city in nebraska ?	_answer ( A , _largest ( A , ( _city ( A ) , _loc ( A , B ) , _const ( B , _stateid ( nebraska ) ) ) ) )
what is the population of texas ?	_answer ( A , ( _population ( B , A ) , _const ( B , _stateid ( texas ) ) ) )
what is the shortest river in the united states ?	_answer ( A , _shortest ( A , ( _river ( A ) , _loc ( A , B ) , _const ( B , _countryid ( usa ) ) ) ) )
what is the population of rhode island ?	_answer ( A , ( _population ( B , A ) , _const ( B , _stateid ( ' rhode island ' ) ) ) )
what is the state with the lowest point ?	_answer ( A , ( _state ( A ) , _loc ( B , A ) , _lowest ( B , _place ( B ) ) ) )
what is the longest river in new york ?	_answer ( A , _longest ( A , ( _river ( A ) , _loc ( A , B ) , _const ( B , _stateid ( ' new york ' ) ) ) ) )
what is the longest river that runs through a state that borders tennessee ?	_answer ( A , _longest ( A , ( _river ( A ) , _traverse ( A , B ) , _state ( B ) , _next_to ( B , C ) , _const ( C , _stateid ( tennessee ) ) ) ) )
how many major cities are in arizona ?	_answer ( A , _count ( B , ( _major ( B ) , _city ( B ) , _loc ( B , C ) , _const ( C , _stateid ( arizona ) ) ) , A ) )
what are the neighboring states for michigan ?	_answer ( A , ( _next_to ( A , B ) , _state ( A ) , _const ( B , _stateid ( michigan ) ) ) )
what state that borders texas is the largest ?	_answer ( A , _largest ( A , ( _state ( A ) , _next_to ( A , B ) , _const ( B , _stateid ( texas ) ) ) ) )
what is the shortest river ?	_answer ( A , _shortest ( A , _river ( A ) ) )
how many states border the state that borders the most states ?	_answer ( A , _count ( B , ( _state ( B ) , _next_to ( B , C ) , _most ( C , D , ( _state ( C ) , _next_to ( C , D ) , _state ( D ) ) ) ) , A ) )
which state is the largest city in montana in ?	_answer ( A , ( _state ( A ) , _largest ( B , ( _city ( B ) , _loc ( B , C ) , _const ( C , _stateid ( montana ) ) ) ) , _loc ( B , A ) ) )
what is the population of washington dc ?	_answer ( A , ( _population ( B , A ) , _const ( B , _cityid ( washington , dc ) ) ) )
what is the most populous city in texas ?	_answer ( B , _largest ( A , ( _population ( B , A ) , _city ( B ) , _loc ( B , C ) , _const ( C , _stateid ( texas ) ) ) ) )
what is the capital of hawaii ?	_answer ( A , ( _capital ( A ) , _loc ( A , B ) , _const ( B , _stateid ( hawaii ) ) ) )
what is capital of iowa ?	_answer ( A , ( _capital ( A ) , _loc ( A , B ) , _const ( B , _stateid ( iowa ) ) ) )
where is san diego ?	_answer ( A , ( _loc ( B , A ) , _const ( B , _cityid ( ' san diego ' , _ ) ) ) )
what are the major cities in delaware ?	_answer ( A , ( _major ( A ) , _city ( A ) , _loc ( A , B ) , _const ( B , _stateid ( delaware ) ) ) )
what is the lowest point in louisiana ?	_answer ( A , _lowest ( A , ( _place ( A ) , _loc ( A , B ) , _const ( B , _stateid ( louisiana ) ) ) ) )
which state has the highest peak in the country ?	_answer ( A , _highest ( B , ( _state ( A ) , _loc ( B , A ) , _mountain ( B ) ) ) )
what texas city has the largest population ?	_answer ( A , _largest ( B , ( _const ( C , _stateid ( texas ) ) , _city ( A ) , _loc ( A , C ) , _population ( A , B ) ) ) )
what capital is the largest in the us ?	_answer ( A , _largest ( A , ( _capital ( A ) , _loc ( A , B ) , _const ( B , _countryid ( usa ) ) ) ) )
what is the population of new york ?	_answer ( A , ( _population ( B , A ) , _const ( B , _stateid ( ' new york ' ) ) ) )
what is the population of the capital of the smallest state ?	_answer ( A , ( _population ( B , A ) , _capital ( B ) , _loc ( B , C ) , _smallest ( C , _state ( C ) ) ) )
what is the area of alaska ?	_answer ( A , ( _area ( B , A ) , _const ( B , _stateid ( alaska ) ) ) )
what is the population of california ?	_answer ( A , ( _population ( B , A ) , _const ( B , _stateid ( california ) ) ) )
which state has the longest river ?	_answer ( A , _longest ( B , ( _state ( A ) , _loc ( B , A ) , _river ( B ) ) ) )
what is the capital of texas ?	_answer ( A , ( _capital ( A ) , _loc ( A , B ) , _const ( B , _stateid ( texas ) ) ) )
give me the cities which are in texas ?	_answer ( A , ( _city ( A ) , _loc ( A , B ) , _const ( B , _stateid ( texas ) ) ) )
what states border kentucky ?	_answer ( A , ( _state ( A ) , _next_to ( A , B ) , _const ( B , _stateid ( kentucky ) ) ) )
how high is the highest point of florida ?	_answer ( A , ( _elevation ( B , A ) , _highest ( B , ( _place ( B ) , _loc ( B , C ) , _const ( C , _stateid ( florida ) ) ) ) ) )
what are the major cities in north carolina ?	_answer ( A , ( _major ( A ) , _city ( A ) , _loc ( A , B ) , _const ( B , _stateid ( ' north carolina ' ) ) ) )
in which state is the major cities in the smallest state in the us ?	_answer ( A , ( _loc ( B , A ) , _state ( A ) , _major ( B ) , _city ( B ) , _loc ( B , C ) , _smallest ( C , ( _state ( C ) , _loc ( C , D ) , _const ( D , _countryid ( usa ) ) ) ) ) )
how long is the the biggest rivers in arizona ?	_answer ( A , ( _len ( B , A ) , _longest ( B , ( _river ( B ) , _loc ( B , C ) , _const ( C , _stateid ( arizona ) ) ) ) , _river ( B ) ) )
what river flows through state has the smallest population density ?	_answer ( A , ( _river ( A ) , _traverse ( A , B ) , _smallest ( C , ( _state ( B ) , _density ( B , C ) ) ) ) )
what states have rivers named rivers are in pennsylvania ?	_answer ( A , ( _state ( A ) , _loc ( B , A ) , _river ( B ) , _loc ( B , C ) , _const ( C , _stateid ( pennsylvania ) ) ) )
where is the biggest city in hawaii ?	_answer ( A , ( _loc ( B , A ) , _largest ( B , ( _city ( B ) , _loc ( B , C ) , _const ( C , _stateid ( hawaii ) ) ) ) ) )
what are the neighboring states for state that borders kansas is the largest ?	_answer ( A , ( _next_to ( A , B ) , _state ( A ) , _largest ( B , ( _state ( B ) , _next_to ( B , C ) , _const ( C , _stateid ( kansas ) ) ) ) ) )
where is capital of alaska ?	_answer ( A , ( _loc ( B , A ) , _capital ( B ) , _loc ( B , C ) , _const ( C , _stateid ( alaska ) ) ) )
how many people live in the major cities in vermont ?	_answer ( A , ( _population ( B , A ) , _major ( B ) , _city ( B ) , _loc ( B , C ) , _const ( C , _stateid ( vermont ) ) ) )
give me the cities which are in state is the largest city in tennessee in ?	_answer ( A , ( _city ( A ) , _loc ( A , B ) , _state ( B ) , _largest ( C , ( _city ( C ) , _loc ( C , D ) , _const ( D , _stateid ( tennessee ) ) ) ) , _loc ( C , B ) ) )
what is the lowest point in the biggest state in continental us ?	_answer ( A , _lowest ( A , ( _place ( A ) , _loc ( A , B ) , _largest ( B , ( _state ( B ) , _loc ( B , C ) , _const ( C , _countryid ( usa ) ) ) ) ) ) )
how many people live in the biggest city in montana ?	_answer ( A , ( _population ( B , A ) , _largest ( B , ( _city ( B ) , _loc ( B , C ) , _const ( C , _stateid ( montana ) ) ) ) ) )
where is the cities which are in california ?	_answer ( A , ( _loc ( B , A ) , _city ( B ) , _loc ( B , C ) , _const ( C , _stateid ( california ) ) ) )
what is capital of states have rivers named colorado ?	_answer ( A , ( _capital ( A ) , _loc ( A , B ) , _state ( B ) , _loc ( C , B ) , _const ( C , _riverid ( colorado ) ) ) )
where is the major cities in alabama ?	_answer ( A , ( _loc ( B , A ) , _major ( B ) , _city ( B ) , _loc ( B , C ) , _const ( C , _stateid ( alabama ) ) ) )
what is the highest elevation in state is the largest city in kansas in ?	_answer ( A , _highest ( A , ( _place ( A ) , _loc ( A , B ) , _state ( B ) , _largest ( C , ( _city ( C ) , _loc ( C , D ) , _const ( D , _stateid ( kansas ) ) ) ) , _loc ( C , B ) ) ) )
what river flows through the biggest state in continental us ?	_answer ( A , ( _river ( A ) , _traverse ( A , B ) , _largest ( B , ( _state ( B ) , _loc ( B , C ) , _const ( C , _countryid ( usa ) ) ) ) ) )
what state that borders states have a city named rochester is the largest ?	_answer ( A , _largest ( A , ( _state ( A ) , _next_to ( A , B ) , _state ( B ) , _loc ( C , B ) , _const ( C , _cityid ( rochester , _ ) ) ) ) )
what are the populations of states through which the river runs through south carolina run ?	_answer ( A , ( _population ( B , A ) , _state ( B ) , _river ( C ) , _traverse ( C , D ) , _const ( D , _stateid ( ' south carolina ' ) ) , _river ( C ) , _traverse ( C , B ) ) )
how many states have a city called the cities which are in alabama ?	_answer ( A , _count ( B , ( _state ( B ) , _loc ( C , B ) , _city ( C ) , _loc ( C , D ) , _const ( D , _stateid ( alabama ) ) ) , A ) )
what are the biggest rivers in state that borders kentucky is the largest ?	_answer ( A , _longest ( A , ( _river ( A ) , _loc ( A , B ) , _largest ( B , ( _state ( B ) , _next_to ( B , C ) , _const ( C , _stateid ( kentucky ) ) ) ) ) ) )
where is the major cities in louisiana ?	_answer ( A , ( _loc ( B , A ) , _major ( B ) , _city ( B ) , _loc ( B , C ) , _const ( C , _stateid ( louisiana ) ) ) )
what states have rivers named the biggest rivers in vermont ?	_answer ( A , ( _state ( A ) , _loc ( B , A ) , _longest ( B , ( _river ( B ) , _loc ( B , C ) , _const ( C , _stateid ( vermont ) ) ) ) ) )
how long is the river flows through pennsylvania ?	_answer ( A , ( _len ( B , A ) , _river ( B ) , _traverse ( B , C ) , _const ( C , _stateid ( pennsylvania ) ) ) )
which state is the city the capital of louisiana located in ?	_answer ( A , ( _state ( A ) , _city ( B ) , _capital ( B ) , _loc ( B , C ) , _const ( C , _stateid ( louisiana ) ) , _loc ( B , A ) ) )
which state is the city the capital of colorado located in ?	_answer ( A , ( _state ( A ) , _city ( B ) , _capital ( B ) , _loc ( B , C ) , _const ( C , _stateid ( colorado ) ) , _loc ( B , A ) ) )
how long is the the longest river in california ?	_answer ( A , ( _len ( B , A ) , _longest ( B , ( _river ( B ) , _loc ( B , C ) , _const ( C , _stateid ( california ) ) ) ) , _river ( B ) ) )
what is the capital of state that borders delaware is the largest ?	_answer ( A , ( _capital ( A ) , _loc ( A , B ) , _largest ( B , ( _state ( B ) , _next_to ( B , C ) , _const ( C , _stateid ( delaware ) ) ) ) ) )
how many states does state is the largest city in montana in border ?	_answer ( A , _count ( B , ( _state ( B ) , _state ( C ) , _largest ( D , ( _city ( D ) , _loc ( D , E ) , _const ( E , _stateid ( montana ) ) ) ) , _loc ( D , C ) , _next_to ( C , B ) ) , A ) )
could you tell me what is the highest point in the state of states border california ?	_answer ( A , _highest ( A , ( _place ( A ) , _loc ( A , B ) , _state ( B ) , _state ( B ) , _next_to ( B , C ) , _const ( C , _stateid ( california ) ) ) ) )
which state border the neighboring states for oregon ?	_answer ( A , ( _state ( A ) , _next_to ( A , B ) , _next_to ( B , C ) , _state ( B ) , _const ( C , _stateid ( oregon ) ) ) )
what is the biggest city in state is the city new orleans located in ?	_answer ( A , _largest ( A , ( _city ( A ) , _loc ( A , B ) , _state ( B ) , _city ( C ) , _const ( C , _cityid ( ' new orleans ' , _ ) ) , _loc ( C , B ) ) ) )
how long is the the rivers in the state of mississippi ?	_answer ( A , ( _len ( B , A ) , _river ( B ) , _loc ( B , C ) , _state ( C ) , _const ( C , _stateid ( mississippi ) ) ) )
what are the major cities in state does the highest point in usa exist ?	_answer ( A , ( _major ( A ) , _city ( A ) , _loc ( A , B ) , _loc ( C , B ) , _state ( B ) , _highest ( C , ( _place ( C ) , _loc ( C , D ) , _const ( D , _countryid ( usa ) ) ) ) ) )
what are the populations of states through which the the longest river in mississippi run ?	_answer ( A , ( _population ( B , A ) , _state ( B ) , _longest ( C , ( _river ( C ) , _loc ( C , D ) , _const ( D , _stateid ( mississippi ) ) ) ) , _river ( C ) , _traverse ( C , B ) ) )
what states have a city named the capital of north carolina ?	_answer ( A , ( _state ( A ) , _loc ( B , A ) , _capital ( B ) , _loc ( B , C ) , _const ( C , _stateid ( ' north carolina ' ) ) ) )
what states have a city named capital of new york ?	_answer ( A , ( _state ( A ) , _loc ( B , A ) , _capital ( B ) , _loc ( B , C ) , _const ( C , _stateid ( ' new york ' ) ) ) )
how many states have a city called capitals are not major cities ?	_answer ( A , _count ( B , ( _state ( B ) , _loc ( C , B ) , _capital ( C ) , \+ ( _major ( C ) , _city ( C ) ) ) , A ) )
which capitals are in the states that border the smallest state that borders alabama ?	_answer ( A , ( _capital ( A ) , _loc ( A , B ) , _state ( B ) , _next_to ( B , C ) , _smallest ( C , ( _state ( C ) , _next_to ( C , D ) , _const ( D , _stateid ( alabama ) ) ) ) ) )
which states border states through which the the rivers in the state of vermont traverses ?	_answer ( A , ( _state ( A ) , _next_to ( A , B ) , _state ( B ) , _river ( C ) , _loc ( C , D ) , _state ( D ) , _const ( D , _stateid ( vermont ) ) , _traverse ( C , B ) ) )
name all the rivers in states does the longest river cross ?	_answer ( A , ( _river ( A ) , _loc ( A , B ) , _state ( B ) , _longest ( C , _river ( C ) ) , _traverse ( C , B ) ) )
what is capital of state does the highest point in usa exist ?	_answer ( A , ( _capital ( A ) , _loc ( A , B ) , _loc ( C , B ) , _state ( B ) , _highest ( C , ( _place ( C ) , _loc ( C , D ) , _const ( D , _countryid ( usa ) ) ) ) ) )
name all the rivers in state border montana ?	_answer ( A , ( _river ( A ) , _loc ( A , B ) , _state ( B ) , _next_to ( B , C ) , _const ( C , _stateid ( montana ) ) ) )
what states have rivers named all the rivers in rhode island ?	_answer ( A , ( _state ( A ) , _loc ( B , A ) , _river ( B ) , _loc ( B , C ) , _const ( C , _stateid ( ' rhode island ' ) ) ) )
how long is the rivers are in texas ?	_answer ( A , ( _len ( B , A ) , _river ( B ) , _loc ( B , C ) , _const ( C , _stateid ( texas ) ) , _river ( B ) ) )
what are the biggest rivers in the states through which the longest river runs ?	_answer ( A , _longest ( A , ( _river ( A ) , _loc ( A , B ) , _state ( B ) , _longest ( C , ( _river ( C ) , _traverse ( C , B ) ) ) ) ) )
how many people live in the major cities in alabama ?	_answer ( A , ( _population ( B , A ) , _major ( B ) , _city ( B ) , _loc ( B , C ) , _const ( C , _stateid ( alabama ) ) ) )
how many major cities are in the states through which the longest river runs ?	_answer ( A , _count ( B , ( _major ( B ) , _city ( B ) , _loc ( B , C ) , _state ( C ) , _longest ( D , ( _river ( D ) , _traverse ( D , C ) ) ) ) , A ) )
in which state is the capital of kentucky ?	_answer ( A , ( _loc ( B , A ) , _state ( A ) , _capital ( B ) , _loc ( B , C ) , _const ( C , _stateid ( kentucky ) ) ) )
how long is the river runs through oregon ?	_answer ( A , ( _len ( B , A ) , _river ( B ) , _traverse ( B , C ) , _const ( C , _stateid ( oregon ) ) ) )
what is the longest river in the smallest state that borders montana ?	_answer ( A , _longest ( A , ( _river ( A ) , _loc ( A , B ) , _smallest ( B , ( _state ( B ) , _next_to ( B , C ) , _const ( C , _stateid ( montana ) ) ) ) ) ) )
what are the populations of states through which the the longest river that runs through a state that borders alabama run ?	_answer ( A , ( _population ( B , A ) , _state ( B ) , _longest ( C , ( _river ( C ) , _traverse ( C , D ) , _state ( D ) , _next_to ( D , E ) , _const ( E , _stateid ( alabama ) ) ) ) , _river ( C ) , _traverse ( C , B ) ) )
what is the size of state is mount mckinley ?	_answer ( A , ( _size ( B , A ) , _loc ( C , B ) , _state ( B ) , _const ( C , _placeid ( ' mount mckinley ' ) ) ) )
how many people live in the capital of arizona ?	_answer ( A , ( _population ( B , A ) , _capital ( B ) , _loc ( B , C ) , _const ( C , _stateid ( arizona ) ) ) )
what states have rivers named the rivers in the state of colorado ?	_answer ( A , ( _state ( A ) , _loc ( B , A ) , _river ( B ) , _loc ( B , C ) , _state ( C ) , _const ( C , _stateid ( colorado ) ) ) )
how long is the the longest river in illinois ?	_answer ( A , ( _len ( B , A ) , _longest ( B , ( _river ( B ) , _loc ( B , C ) , _const ( C , _stateid ( illinois ) ) ) ) , _river ( B ) ) )
how high is the highest point of states border states through which the colorado traverses ?	_answer ( A , ( _elevation ( B , A ) , _highest ( B , ( _place ( B ) , _loc ( B , C ) , _state ( C ) , _next_to ( C , D ) , _state ( D ) , _const ( E , _riverid ( colorado ) ) , _traverse ( E , D ) ) ) ) )
how many people live in capital of tennessee ?	_answer ( A , ( _population ( B , A ) , _capital ( B ) , _loc ( B , C ) , _const ( C , _stateid ( tennessee ) ) ) )
what are the populations of states through which the the biggest rivers in nebraska run ?	_answer ( A , ( _population ( B , A ) , _state ( B ) , _longest ( C , ( _river ( C ) , _loc ( C , D ) , _const ( D , _stateid ( nebraska ) ) ) ) , _river ( C ) , _traverse ( C , B ) ) )
what is the population of the cities which are in alaska ?	_answer ( A , ( _population ( B , A ) , _city ( B ) , _loc ( B , C ) , _const ( C , _stateid ( alaska ) ) ) )
which states border states through which the river runs through georgia traverses ?	_answer ( A , ( _state ( A ) , _next_to ( A , B ) , _state ( B ) , _river ( C ) , _traverse ( C , D ) , _const ( D , _stateid ( georgia ) ) , _traverse ( C , B ) ) )
where is the major cities in oregon ?	_answer ( A , ( _loc ( B , A ) , _major ( B ) , _city ( B ) , _loc ( B , C ) , _const ( C , _stateid ( oregon ) ) ) )
what is the longest river that runs through a state that borders the neighboring states for montana ?	_answer ( A , _longest ( A , ( _river ( A ) , _traverse ( A , B ) , _state ( B ) , _next_to ( B , C ) , _next_to ( C , D ) , _state ( C ) , _const ( D , _stateid ( montana ) ) ) ) )
which state is the city the major cities in north carolina located in ?	_answer ( A , ( _state ( A ) , _city ( B ) , _major ( B ) , _city ( B ) , _loc ( B , C ) , _const ( C , _stateid ( ' north carolina ' ) ) , _loc ( B , A ) ) )
what states have a city named the cities which are in hawaii ?	_answer ( A , ( _state ( A ) , _loc ( B , A ) , _city ( B ) , _loc ( B , C ) , _const ( C , _stateid ( hawaii ) ) ) )
what is the lowest point in the state with the lowest point ?	_answer ( A , _lowest ( A , ( _place ( A ) , _loc ( A , B ) , _state ( B ) , _loc ( C , B ) , _lowest ( C , _place ( C ) ) ) ) )
what states have rivers named river flows through kentucky ?	_answer ( A , ( _state ( A ) , _loc ( B , A ) , _river ( B ) , _traverse ( B , C ) , _const ( C , _stateid ( kentucky ) ) ) )
give me the cities which are in state is the largest city in louisiana in ?	_answer ( A , ( _city ( A ) , _loc ( A , B ) , _state ( B ) , _largest ( C , ( _city ( C ) , _loc ( C , D ) , _const ( D , _stateid ( louisiana ) ) ) ) , _loc ( C , B ) ) )
what are the populations of states through which the the longest river in alabama run ?	_answer ( A , ( _population ( B , A ) , _state ( B ) , _longest ( C , ( _river ( C ) , _loc ( C , D ) , _const ( D , _stateid ( alabama ) ) ) ) , _river ( C ) , _traverse ( C , B ) ) )
what state that borders the state with the lowest point is the largest ?	_answer ( A , _largest ( A , ( _state ( A ) , _next_to ( A , B ) , _state ( B ) , _loc ( C , B ) , _lowest ( C , _place ( C ) ) ) ) )
how many states have a city called the major cities in kansas ?	_answer ( A , _count ( B , ( _state ( B ) , _loc ( C , B ) , _major ( C ) , _city ( C ) , _loc ( C , D ) , _const ( D , _stateid ( kansas ) ) ) , A ) )
which states border states through which the the rivers in the state of oregon traverses ?	_answer ( A , ( _state ( A ) , _next_to ( A , B ) , _state ( B ) , _river ( C ) , _loc ( C , D ) , _state ( D ) , _const ( D , _stateid ( oregon ) ) , _traverse ( C , B ) ) )
what is capital of state that borders delaware is the largest ?	_answer ( A , ( _capital ( A ) , _loc ( A , B ) , _largest ( B , ( _state ( B ) , _next_to ( B , C ) , _const ( C , _stateid ( delaware ) ) ) ) ) )
what state that borders the smallest state that borders rhode island is the largest ?	_answer ( A , _largest ( A , ( _state ( A ) , _next_to ( A , B ) , _smallest ( B , ( _state ( B ) , _next_to ( B , C ) , _const ( C , _stateid ( ' rhode island ' ) ) ) ) ) ) )
how many states have a city called georgia city has the largest population ?	_answer ( A , _count ( B , ( _state ( B ) , _loc ( C , B ) , _largest ( D , ( _const ( E , _stateid ( georgia ) ) , _city ( C ) , _loc ( C , E ) , _population ( C , D ) ) ) ) , A ) )
how long is the all the rivers in tennessee ?	_answer ( A , ( _len ( B , A ) , _river ( B ) , _loc ( B , C ) , _const ( C , _stateid ( tennessee ) ) ) )
what is the longest river in state is mount mckinley ?	_answer ( A , _longest ( A , ( _river ( A ) , _loc ( A , B ) , _loc ( C , B ) , _state ( B ) , _const ( C , _placeid ( ' mount mckinley ' ) ) ) ) )
what is the highest elevation in state is mount mckinley ?	_answer ( A , _highest ( A , ( _place ( A ) , _loc ( A , B ) , _loc ( C , B ) , _state ( B ) , _const ( C , _placeid ( ' mount mckinley ' ) ) ) ) )
what is the smallest state that borders the state with the lowest point ?	_answer ( A , _smallest ( A , ( _state ( A ) , _next_to ( A , B ) , _state ( B ) , _loc ( C , B ) , _lowest ( C , _place ( C ) ) ) ) )
where is iowa city has the largest population ?	_answer ( A , ( _loc ( B , A ) , _largest ( C , ( _const ( D , _stateid ( iowa ) ) , _city ( B ) , _loc ( B , D ) , _population ( B , C ) ) ) ) )
which states border the smallest state that borders pennsylvania ?	_answer ( A , ( _state ( A ) , _next_to ( A , B ) , _smallest ( B , ( _state ( B ) , _next_to ( B , C ) , _const ( C , _stateid ( pennsylvania ) ) ) ) ) )
what is the longest river in states border florida ?	_answer ( A , _longest ( A , ( _river ( A ) , _loc ( A , B ) , _state ( B ) , _next_to ( B , C ) , _const ( C , _stateid ( florida ) ) ) ) )
what are the major cities in states border states through which the colorado traverses ?	_answer ( A , ( _major ( A ) , _city ( A ) , _loc ( A , B ) , _state ( B ) , _next_to ( B , C ) , _state ( C ) , _const ( D , _riverid ( colorado ) ) , _traverse ( D , C ) ) )
what is the highest mountain in the smallest state that borders south carolina ?	_answer ( A , _highest ( A , ( _mountain ( A ) , _loc ( A , B ) , _smallest ( B , ( _state ( B ) , _next_to ( B , C ) , _const ( C , _stateid ( ' south carolina ' ) ) ) ) ) ) )
where is the capital of montana ?	_answer ( A , ( _loc ( B , A ) , _capital ( B ) , _loc ( B , C ) , _const ( C , _stateid ( montana ) ) ) )
how many states have a city called the capital of arizona ?	_answer ( A , _count ( B , ( _state ( B ) , _loc ( C , B ) , _capital ( C ) , _loc ( C , D ) , _const ( D , _stateid ( arizona ) ) ) , A ) )
what is the population of the major cities in louisiana ?	_answer ( A , ( _population ( B , A ) , _major ( B ) , _city ( B ) , _loc ( B , C ) , _const ( C , _stateid ( louisiana ) ) ) )
what are the rivers in the state of states have rivers named mississippi ?	_answer ( A , ( _river ( A ) , _loc ( A , B ) , _state ( B ) , _state ( B ) , _loc ( C , B ) , _const ( C , _riverid ( mississippi ) ) ) )
what states have rivers named the longest river that runs through a state that borders georgia ?	_answer ( A , ( _state ( A ) , _loc ( B , A ) , _longest ( B , ( _river ( B ) , _traverse ( B , C ) , _state ( C ) , _next_to ( C , D ) , _const ( D , _stateid ( georgia ) ) ) ) ) )
how long is the the biggest rivers in nebraska ?	_answer ( A , ( _len ( B , A ) , _longest ( B , ( _river ( B ) , _loc ( B , C ) , _const ( C , _stateid ( nebraska ) ) ) ) ) )
how many people live in the capital of louisiana ?	_answer ( A , ( _population ( B , A ) , _capital ( B ) , _loc ( B , C ) , _const ( C , _stateid ( louisiana ) ) ) )
which state border state is atlanta ?	_answer ( A , ( _state ( A ) , _next_to ( A , B ) , _loc ( C , B ) , _state ( B ) , _const ( C , _cityid ( atlanta , _ ) ) ) )
which states border the neighboring states for rhode island ?	_answer ( A , ( _state ( A ) , _next_to ( A , B ) , _next_to ( B , C ) , _state ( B ) , _const ( C , _stateid ( ' rhode island ' ) ) ) )
how long is the the rivers in the state of colorado ?	_answer ( A , ( _len ( B , A ) , _river ( B ) , _loc ( B , C ) , _state ( C ) , _const ( C , _stateid ( colorado ) ) ) )
which states border the smallest state that borders delaware ?	_answer ( A , ( _state ( A ) , _next_to ( A , B ) , _smallest ( B , ( _state ( B ) , _next_to ( B , C ) , _const ( C , _stateid ( delaware ) ) ) ) ) )
what is the most populous city in state is the largest city in kentucky in ?	_answer ( B , _largest ( A , ( _population ( B , A ) , _city ( B ) , _loc ( B , C ) , _state ( C ) , _largest ( D , ( _city ( D ) , _loc ( D , E ) , _const ( E , _stateid ( kentucky ) ) ) ) , _loc ( D , C ) ) ) )
what states have a city named the major cities in alaska ?	_answer ( A , ( _state ( A ) , _loc ( B , A ) , _major ( B ) , _city ( B ) , _loc ( B , C ) , _const ( C , _stateid ( alaska ) ) ) )
in which state is the capital of utah ?	_answer ( A , ( _loc ( B , A ) , _state ( A ) , _capital ( B ) , _loc ( B , C ) , _const ( C , _stateid ( utah ) ) ) )
what is the population of the major cities in utah ?	_answer ( A , ( _population ( B , A ) , _major ( B ) , _city ( B ) , _loc ( B , C ) , _const ( C , _stateid ( utah ) ) ) )
how long is the the biggest rivers in texas ?	_answer ( A , ( _len ( B , A ) , _longest ( B , ( _river ( B ) , _loc ( B , C ) , _const ( C , _stateid ( texas ) ) ) ) , _river ( B ) ) )
what is the population of the major cities in california ?	_answer ( A , ( _population ( B , A ) , _major ( B ) , _city ( B ) , _loc ( B , C ) , _const ( C , _stateid ( california ) ) ) )
what river flows through state has the longest river ?	_answer ( A , ( _river ( A ) , _traverse ( A , B ) , _longest ( C , ( _state ( B ) , _loc ( C , B ) , _river ( C ) ) ) ) )
what are the populations of states through which the rivers are in maine run ?	_answer ( A , ( _population ( B , A ) , _state ( B ) , _river ( C ) , _loc ( C , D ) , _const ( D , _stateid ( maine ) ) , _river ( C ) , _traverse ( C , B ) ) )
name all the rivers in the smallest state that borders oregon ?	_answer ( A , ( _river ( A ) , _loc ( A , B ) , _smallest ( B , ( _state ( B ) , _next_to ( B , C ) , _const ( C , _stateid ( oregon ) ) ) ) ) )
how many states have a city called the capital of mississippi ?	_answer ( A , _count ( B , ( _state ( B ) , _loc ( C , B ) , _capital ( C ) , _loc ( C , D ) , _const ( D , _stateid ( mississippi ) ) ) , A ) )
how long is the the longest river in delaware ?	_answer ( A , ( _len ( B , A ) , _longest ( B , ( _river ( B ) , _loc ( B , C ) , _const ( C , _stateid ( delaware ) ) ) ) , _river ( B ) ) )
what are the populations of states through which the rivers are in north carolina run ?	_answer ( A , ( _population ( B , A ) , _state ( B ) , _river ( C ) , _loc ( C , D ) , _const ( D , _stateid ( ' north carolina ' ) ) , _river ( C ) , _traverse ( C , B ) ) )
what are the neighboring states for the neighboring states for kentucky ?	_answer ( A , ( _next_to ( A , B ) , _state ( A ) , _next_to ( B , C ) , _state ( B ) , _const ( C , _stateid ( kentucky ) ) ) )
in which state is vermont city has the largest population ?	_answer ( A , ( _loc ( B , A ) , _state ( A ) , _largest ( C , ( _const ( D , _stateid ( vermont ) ) , _city ( B ) , _loc ( B , D ) , _population ( B , C ) ) ) ) )
how long is the the longest river that runs through a state that borders delaware ?	_answer ( A , ( _len ( B , A ) , _longest ( B , ( _river ( B ) , _traverse ( B , C ) , _state ( C ) , _next_to ( C , D ) , _const ( D , _stateid ( delaware ) ) ) ) , _river ( B ) ) )
where is the capital of arizona ?	_answer ( A , ( _loc ( B , A ) , _capital ( B ) , _loc ( B , C ) , _const ( C , _stateid ( arizona ) ) ) )
what states have rivers named all the rivers in hawaii ?	_answer ( A , ( _state ( A ) , _loc ( B , A ) , _river ( B ) , _loc ( B , C ) , _const ( C , _stateid ( hawaii ) ) ) )
which states border states through which the the rivers in the state of tennessee traverses ?	_answer ( A , ( _state ( A ) , _next_to ( A , B ) , _state ( B ) , _river ( C ) , _loc ( C , D ) , _state ( D ) , _const ( D , _stateid ( tennessee ) ) , _traverse ( C , B ) ) )
what is the area of state is the largest city in tennessee in ?	_answer ( A , ( _area ( B , A ) , _state ( B ) , _largest ( C , ( _city ( C ) , _loc ( C , D ) , _const ( D , _stateid ( tennessee ) ) ) ) , _loc ( C , B ) ) )
which states border states through which the all the rivers in alabama traverses ?	_answer ( A , ( _state ( A ) , _next_to ( A , B ) , _state ( B ) , _river ( C ) , _loc ( C , D ) , _const ( D , _stateid ( alabama ) ) , _traverse ( C , B ) ) )
what is the lowest point in state is mount mckinley ?	_answer ( A , _lowest ( A , ( _place ( A ) , _loc ( A , B ) , _loc ( C , B ) , _state ( B ) , _const ( C , _placeid ( ' mount mckinley ' ) ) ) ) )
what is the population of the capital of georgia ?	_answer ( A , ( _population ( B , A ) , _capital ( B ) , _loc ( B , C ) , _const ( C , _stateid ( georgia ) ) ) )
how many states have a city called the cities which are in vermont ?	_answer ( A , _count ( B , ( _state ( B ) , _loc ( C , B ) , _city ( C ) , _loc ( C , D ) , _const ( D , _stateid ( vermont ) ) ) , A ) )
what is the size of state does the highest point in usa exist ?	_answer ( A , ( _size ( B , A ) , _loc ( C , B ) , _state ( B ) , _highest ( C , ( _place ( C ) , _loc ( C , D ) , _const ( D , _countryid ( usa ) ) ) ) ) )
what states have a city named the capital of georgia ?	_answer ( A , ( _state ( A ) , _loc ( B , A ) , _capital ( B ) , _loc ( B , C ) , _const ( C , _stateid ( georgia ) ) ) )
how long is the river runs through texas ?	_answer ( A , ( _len ( B , A ) , _river ( B ) , _traverse ( B , C ) , _const ( C , _stateid ( texas ) ) , _river ( B ) ) )
what is the smallest state that borders states border north carolina ?	_answer ( A , _smallest ( A , ( _state ( A ) , _next_to ( A , B ) , _state ( B ) , _next_to ( B , C ) , _const ( C , _stateid ( ' north carolina ' ) ) ) ) )
how long is the river runs through utah ?	_answer ( A , ( _len ( B , A ) , _river ( B ) , _traverse ( B , C ) , _const ( C , _stateid ( utah ) ) , _river ( B ) ) )
which capitals are in the states that border states does the mississippi run through ?	_answer ( A , ( _capital ( A ) , _loc ( A , B ) , _state ( B ) , _next_to ( B , C ) , _state ( C ) , _const ( D , _riverid ( mississippi ) ) , _river ( D ) , _traverse ( D , C ) ) )
what are the populations of states through which the the rivers in the state of georgia run ?	_answer ( A , ( _population ( B , A ) , _state ( B ) , _river ( C ) , _loc ( C , D ) , _state ( D ) , _const ( D , _stateid ( georgia ) ) , _river ( C ) , _traverse ( C , B ) ) )
how long is the the longest river in louisiana ?	_answer ( A , ( _len ( B , A ) , _longest ( B , ( _river ( B ) , _loc ( B , C ) , _const ( C , _stateid ( louisiana ) ) ) ) , _river ( B ) ) )
how long is the river flows through hawaii ?	_answer ( A , ( _len ( B , A ) , _river ( B ) , _traverse ( B , C ) , _const ( C , _stateid ( hawaii ) ) ) )
what states have a city named the major cities in new york ?	_answer ( A , ( _state ( A ) , _loc ( B , A ) , _major ( B ) , _city ( B ) , _loc ( B , C ) , _const ( C , _stateid ( ' new york ' ) ) ) )
what rivers are in state is the largest city in iowa in ?	_answer ( A , ( _river ( A ) , _loc ( A , B ) , _state ( B ) , _largest ( C , ( _city ( C ) , _loc ( C , D ) , _const ( D , _stateid ( iowa ) ) ) ) , _loc ( C , B ) ) )
how many states does the biggest state in continental us border ?	_answer ( A , _count ( B , ( _state ( B ) , _largest ( C , ( _state ( C ) , _loc ( C , D ) , _const ( D , _countryid ( usa ) ) ) ) , _next_to ( C , B ) ) , A ) )
how long is the the biggest rivers in utah ?	_answer ( A , ( _len ( B , A ) , _longest ( B , ( _river ( B ) , _loc ( B , C ) , _const ( C , _stateid ( utah ) ) ) ) ) )
what is the highest point in the smallest state that borders new york ?	_answer ( A , _highest ( A , ( _place ( A ) , _loc ( A , B ) , _smallest ( B , ( _state ( B ) , _next_to ( B , C ) , _const ( C , _stateid ( ' new york ' ) ) ) ) ) ) )
what are the populations of states through which the the shortest river run ?	_answer ( A , ( _population ( B , A ) , _state ( B ) , _shortest ( C , _river ( C ) ) , _river ( C ) , _traverse ( C , B ) ) )
name all the rivers in the smallest state that borders montana ?	_answer ( A , ( _river ( A ) , _loc ( A , B ) , _smallest ( B , ( _state ( B ) , _next_to ( B , C ) , _const ( C , _stateid ( montana ) ) ) ) ) )
how long is the river runs through georgia ?	_answer ( A , ( _len ( B , A ) , _river ( B ) , _traverse ( B , C ) , _const ( C , _stateid ( georgia ) ) ) )
which states does the all the rivers in georgia run through ?	_answer ( A , ( _state ( A ) , _river ( B ) , _loc ( B , C ) , _const ( C , _stateid ( georgia ) ) , _river ( B ) , _traverse ( B , A ) ) )
could you tell me what is the highest point in the state of state has the highest peak in the country ?	_answer ( A , _highest ( A , ( _place ( A ) , _loc ( A , B ) , _state ( B ) , _highest ( C , ( _state ( B ) , _loc ( C , B ) , _mountain ( C ) ) ) ) ) )
what is capital of state is the largest city in florida in ?	_answer ( A , ( _capital ( A ) , _loc ( A , B ) , _state ( B ) , _largest ( C , ( _city ( C ) , _loc ( C , D ) , _const ( D , _stateid ( florida ) ) ) ) , _loc ( C , B ) ) )
how long is the river runs through texas ?	_answer ( A , ( _len ( B , A ) , _river ( B ) , _traverse ( B , C ) , _const ( C , _stateid ( texas ) ) ) )
which state is the city the biggest city in utah located in ?	_answer ( A , ( _state ( A ) , _city ( B ) , _largest ( B , ( _city ( B ) , _loc ( B , C ) , _const ( C , _stateid ( utah ) ) ) ) , _loc ( B , A ) ) )
what are the high points of states surrounding state that borders utah is the largest ?	_answer ( A , ( _high_point ( B , A ) , _loc ( A , B ) , _state ( B ) , _next_to ( B , C ) , _largest ( C , ( _state ( C ) , _next_to ( C , D ) , _const ( D , _stateid ( utah ) ) ) ) ) )
what states have a city named the capital of iowa ?	_answer ( A , ( _state ( A ) , _loc ( B , A ) , _capital ( B ) , _loc ( B , C ) , _const ( C , _stateid ( iowa ) ) ) )
what is the population of delaware city has the largest population ?	_answer ( A , ( _population ( B , A ) , _largest ( C , ( _const ( D , _stateid ( delaware ) ) , _city ( B ) , _loc ( B , D ) , _population ( B , C ) ) ) ) )
what is the lowest point in states border texas ?	_answer ( A , _lowest ( A , ( _place ( A ) , _loc ( A , B ) , _state ( B ) , _next_to ( B , C ) , _const ( C , _stateid ( texas ) ) ) ) )
what is the population of states have a city named rochester ?	_answer ( A , ( _population ( B , A ) , _state ( B ) , _loc ( C , B ) , _const ( C , _cityid ( rochester , _ ) ) ) )
what is the size of state has the shortest river ?	_answer ( A , ( _size ( B , A ) , _state ( B ) , _loc ( C , B ) , _shortest ( C , _river ( C ) ) ) )
what states have a city named hawaii city has the largest population ?	_answer ( A , ( _state ( A ) , _loc ( B , A ) , _largest ( C , ( _const ( D , _stateid ( hawaii ) ) , _city ( B ) , _loc ( B , D ) , _population ( B , C ) ) ) ) )
what are the high points of states surrounding the neighboring states for texas ?	_answer ( A , ( _high_point ( B , A ) , _loc ( A , B ) , _state ( B ) , _next_to ( B , C ) , _next_to ( C , D ) , _state ( C ) , _const ( D , _stateid ( texas ) ) ) )
what is the population of the capital of alabama ?	_answer ( A , ( _population ( B , A ) , _capital ( B ) , _loc ( B , C ) , _const ( C , _stateid ( alabama ) ) ) )
how long is the the longest river in vermont ?	_answer ( A , ( _len ( B , A ) , _longest ( B , ( _river ( B ) , _loc ( B , C ) , _const ( C , _stateid ( vermont ) ) ) ) ) )
which states border states through which the all the rivers in alaska traverses ?	_answer ( A , ( _state ( A ) , _next_to ( A , B ) , _state ( B ) , _river ( C ) , _loc ( C , D ) , _const ( D , _stateid ( alaska ) ) , _traverse ( C , B ) ) )
which state is the largest city in states have a city named san diego in ?	_answer ( A , ( _state ( A ) , _largest ( B , ( _city ( B ) , _loc ( B , C ) , _state ( C ) , _loc ( D , C ) , _const ( D , _cityid ( ' san diego ' , _ ) ) ) ) , _loc ( B , A ) ) )
what is the most populous city in states have a city named sacramento ?	_answer ( B , _largest ( A , ( _population ( B , A ) , _city ( B ) , _loc ( B , C ) , _state ( C ) , _loc ( D , C ) , _const ( D , _cityid ( sacramento , _ ) ) ) ) )
which state is the city the capital of utah located in ?	_answer ( A , ( _state ( A ) , _city ( B ) , _capital ( B ) , _loc ( B , C ) , _const ( C , _stateid ( utah ) ) , _loc ( B , A ) ) )
what is the smallest state that borders state does the highest point in usa exist ?	_answer ( A , _smallest ( A , ( _state ( A ) , _next_to ( A , B ) , _loc ( C , B ) , _state ( B ) , _highest ( C , ( _place ( C ) , _loc ( C , D ) , _const ( D , _countryid ( usa ) ) ) ) ) ) )
which states border states through which the the longest river in south carolina traverses ?	_answer ( A , ( _state ( A ) , _next_to ( A , B ) , _state ( B ) , _longest ( C , ( _river ( C ) , _loc ( C , D ) , _const ( D , _stateid ( ' south carolina ' ) ) ) ) , _traverse ( C , B ) ) )
what is the most populous city in state that borders michigan is the largest ?	_answer ( B , _largest ( A , ( _population ( B , A ) , _city ( B ) , _loc ( B , C ) , _largest ( C , ( _state ( C ) , _next_to ( C , D ) , _const ( D , _stateid ( michigan ) ) ) ) ) ) )
what is the longest river in states does the longest river cross ?	_answer ( A , _longest ( A , ( _river ( A ) , _loc ( A , B ) , _state ( B ) , _longest ( C , _river ( C ) ) , _traverse ( C , B ) ) ) )
what are the major cities in state that borders rhode island is the largest ?	_answer ( A , ( _major ( A ) , _city ( A ) , _loc ( A , B ) , _largest ( B , ( _state ( B ) , _next_to ( B , C ) , _const ( C , _stateid ( ' rhode island ' ) ) ) ) ) )
what is the population of the capital of kansas ?	_answer ( A , ( _population ( B , A ) , _capital ( B ) , _loc ( B , C ) , _const ( C , _stateid ( kansas ) ) ) )
where is the cities which are in kansas ?	_answer ( A , ( _loc ( B , A ) , _city ( B ) , _loc ( B , C ) , _const ( C , _stateid ( kansas ) ) ) )
what is the longest river in state is the largest city in hawaii in ?	_answer ( A , _longest ( A , ( _river ( A ) , _loc ( A , B ) , _state ( B ) , _largest ( C , ( _city ( C ) , _loc ( C , D ) , _const ( D , _stateid ( hawaii ) ) ) ) , _loc ( C , B ) ) ) )
where is the capital of north carolina ?	_answer ( A , ( _loc ( B , A ) , _capital ( B ) , _loc ( B , C ) , _const ( C , _stateid ( ' north carolina ' ) ) ) )
what is the population of the biggest city in michigan ?	_answer ( A , ( _population ( B , A ) , _largest ( B , ( _city ( B ) , _loc ( B , C ) , _const ( C , _stateid ( michigan ) ) ) ) ) )
how long is the the rivers in the state of montana ?	_answer ( A , ( _len ( B , A ) , _river ( B ) , _loc ( B , C ) , _state ( C ) , _const ( C , _stateid ( montana ) ) ) )
what is the area of states have rivers named mississippi river ?	_answer ( A , ( _area ( B , A ) , _state ( B ) , _loc ( C , B ) , _const ( C , _riverid ( mississippi ) ) ) )
how many states have a city called the capital of maine ?	_answer ( A , _count ( B , ( _state ( B ) , _loc ( C , B ) , _capital ( C ) , _loc ( C , D ) , _const ( D , _stateid ( maine ) ) ) , A ) )
what is the longest river that runs through a state that borders state is the largest city in florida in ?	_answer ( A , _longest ( A , ( _river ( A ) , _traverse ( A , B ) , _state ( B ) , _next_to ( B , C ) , _state ( C ) , _largest ( D , ( _city ( D ) , _loc ( D , E ) , _const ( E , _stateid ( florida ) ) ) ) , _loc ( D , C ) ) ) )
what are the major cities in state border montana ?	_answer ( A , ( _major ( A ) , _city ( A ) , _loc ( A , B ) , _state ( B ) , _next_to ( B , C ) , _const ( C , _stateid ( montana ) ) ) )
which states does the the longest river in alaska run through ?	_answer ( A , ( _state ( A ) , _longest ( B , ( _river ( B ) , _loc ( B , C ) , _const ( C , _stateid ( alaska ) ) ) ) , _river ( B ) , _traverse ( B , A ) ) )
which states does the the longest river that runs through a state that borders louisiana run through ?	_answer ( A , ( _state ( A ) , _longest ( B , ( _river ( B ) , _traverse ( B , C ) , _state ( C ) , _next_to ( C , D ) , _const ( D , _stateid ( louisiana ) ) ) ) , _river ( B ) , _traverse ( B , A ) ) )
which states border states through which the the biggest rivers in montana traverses ?	_answer ( A , ( _state ( A ) , _next_to ( A , B ) , _state ( B ) , _longest ( C , ( _river ( C ) , _loc ( C , D ) , _const ( D , _stateid ( montana ) ) ) ) , _traverse ( C , B ) ) )
which capitals are in the states that border states border montana ?	_answer ( A , ( _capital ( A ) , _loc ( A , B ) , _state ( B ) , _next_to ( B , C ) , _state ( C ) , _next_to ( C , D ) , _const ( D , _stateid ( montana ) ) ) )
which states border states through which the rivers are in alabama traverses ?	_answer ( A , ( _state ( A ) , _next_to ( A , B ) , _state ( B ) , _river ( C ) , _loc ( C , D ) , _const ( D , _stateid ( alabama ) ) , _traverse ( C , B ) ) )
what states have rivers named river flows through vermont ?	_answer ( A , ( _state ( A ) , _loc ( B , A ) , _river ( B ) , _traverse ( B , C ) , _const ( C , _stateid ( vermont ) ) ) )
what states have rivers named all the rivers in california ?	_answer ( A , ( _state ( A ) , _loc ( B , A ) , _river ( B ) , _loc ( B , C ) , _const ( C , _stateid ( california ) ) ) )
what is the longest river that runs through a state that borders state has highest elevation ?	_answer ( A , _longest ( A , ( _river ( A ) , _traverse ( A , B ) , _state ( B ) , _next_to ( B , C ) , _state ( C ) , _loc ( D , C ) , _highest ( D , _place ( D ) ) ) ) )
how many states does states border california border ?	_answer ( A , _count ( B , ( _state ( B ) , _state ( C ) , _next_to ( C , D ) , _const ( D , _stateid ( california ) ) , _next_to ( C , B ) ) , A ) )
what are the high points of states surrounding states have a city named new orleans ?	_answer ( A , ( _high_point ( B , A ) , _loc ( A , B ) , _state ( B ) , _next_to ( B , C ) , _state ( C ) , _loc ( D , C ) , _const ( D , _cityid ( ' new orleans ' , _ ) ) ) )
in which state is the major cities in mississippi ?	_answer ( A , ( _loc ( B , A ) , _state ( A ) , _major ( B ) , _city ( B ) , _loc ( B , C ) , _const ( C , _stateid ( mississippi ) ) ) )
how high is the highest point of states border delaware ?	_answer ( A , ( _elevation ( B , A ) , _highest ( B , ( _place ( B ) , _loc ( B , C ) , _state ( C ) , _next_to ( C , D ) , _const ( D , _stateid ( delaware ) ) ) ) ) )
which states does the the longest river in vermont run through ?	_answer ( A , ( _state ( A ) , _longest ( B , ( _river ( B ) , _loc ( B , C ) , _const ( C , _stateid ( vermont ) ) ) ) , _river ( B ) , _traverse ( B , A ) ) )
what is the lowest point in state that borders maine is the largest ?	_answer ( A , _lowest ( A , ( _place ( A ) , _loc ( A , B ) , _largest ( B , ( _state ( B ) , _next_to ( B , C ) , _const ( C , _stateid ( maine ) ) ) ) ) ) )
what states have a city named the biggest city in north carolina ?	_answer ( A , ( _state ( A ) , _loc ( B , A ) , _largest ( B , ( _city ( B ) , _loc ( B , C ) , _const ( C , _stateid ( ' north carolina ' ) ) ) ) ) )
where is the capital of louisiana ?	_answer ( A , ( _loc ( B , A ) , _capital ( B ) , _loc ( B , C ) , _const ( C , _stateid ( louisiana ) ) ) )
how long is the all the rivers in florida ?	_answer ( A , ( _len ( B , A ) , _river ( B ) , _loc ( B , C ) , _const ( C , _stateid ( florida ) ) ) )
which state is the city the major cities in iowa located in ?	_answer ( A , ( _state ( A ) , _city ( B ) , _major ( B ) , _city ( B ) , _loc ( B , C ) , _const ( C , _stateid ( iowa ) ) , _loc ( B , A ) ) )
in which state is georgia city has the largest population ?	_answer ( A , ( _loc ( B , A ) , _state ( A ) , _largest ( C , ( _const ( D , _stateid ( georgia ) ) , _city ( B ) , _loc ( B , D ) , _population ( B , C ) ) ) ) )
what is the population of states does the mississippi river run through ?	_answer ( A , ( _population ( B , A ) , _state ( B ) , _const ( C , _riverid ( mississippi ) ) , _river ( C ) , _traverse ( C , B ) ) )
what is the population of iowa city has the largest population ?	_answer ( A , ( _population ( B , A ) , _largest ( C , ( _const ( D , _stateid ( iowa ) ) , _city ( B ) , _loc ( B , D ) , _population ( B , C ) ) ) ) )
what are the populations of states through which the river flows through maine run ?	_answer ( A , ( _population ( B , A ) , _state ( B ) , _river ( C ) , _traverse ( C , D ) , _const ( D , _stateid ( maine ) ) , _river ( C ) , _traverse ( C , B ) ) )
what is the area of states does the colorado run through ?	_answer ( A , ( _area ( B , A ) , _state ( B ) , _const ( C , _riverid ( colorado ) ) , _river ( C ) , _traverse ( C , B ) ) )
how many states does state is the city sacramento located in border ?	_answer ( A , _count ( B , ( _state ( B ) , _state ( C ) , _city ( D ) , _const ( D , _cityid ( sacramento , _ ) ) , _loc ( D , C ) , _next_to ( C , B ) ) , A ) )
how many states have a city called the cities which are in north carolina ?	_answer ( A , _count ( B , ( _state ( B ) , _loc ( C , B ) , _city ( C ) , _loc ( C , D ) , _const ( D , _stateid ( ' north carolina ' ) ) ) , A ) )
how many states does state that borders tennessee is the largest border ?	_answer ( A , _count ( B , ( _state ( B ) , _largest ( C , ( _state ( C ) , _next_to ( C , D ) , _const ( D , _stateid ( tennessee ) ) ) ) , _next_to ( C , B ) ) , A ) )
what is the capital of state border louisiana ?	_answer ( A , ( _capital ( A ) , _loc ( A , B ) , _state ( B ) , _next_to ( B , C ) , _const ( C , _stateid ( louisiana ) ) ) )
what are the populations of states through which the the longest river in texas run ?	_answer ( A , ( _population ( B , A ) , _state ( B ) , _longest ( C , ( _river ( C ) , _loc ( C , D ) , _const ( D , _stateid ( texas ) ) ) ) , _river ( C ) , _traverse ( C , B ) ) )
which state is the city the capital of georgia located in ?	_answer ( A , ( _state ( A ) , _city ( B ) , _capital ( B ) , _loc ( B , C ) , _const ( C , _stateid ( georgia ) ) , _loc ( B , A ) ) )
what is the smallest state that borders states does the mississippi river run through ?	_answer ( A , _smallest ( A , ( _state ( A ) , _next_to ( A , B ) , _state ( B ) , _const ( C , _riverid ( mississippi ) ) , _river ( C ) , _traverse ( C , B ) ) ) )
how long is the the longest river that runs through a state that borders oregon ?	_answer ( A , ( _len ( B , A ) , _longest ( B , ( _river ( B ) , _traverse ( B , C ) , _state ( C ) , _next_to ( C , D ) , _const ( D , _stateid ( oregon ) ) ) ) ) )
what is the lowest point of the biggest state in continental us ?	_answer ( A , _lowest ( A , ( _place ( A ) , _loc ( A , B ) , _largest ( B , ( _state ( B ) , _loc ( B , C ) , _const ( C , _countryid ( usa ) ) ) ) ) ) )
what states have rivers named all the rivers in florida ?	_answer ( A , ( _state ( A ) , _loc ( B , A ) , _river ( B ) , _loc ( B , C ) , _const ( C , _stateid ( florida ) ) ) )
which states does the the longest river in nebraska run through ?	_answer ( A , ( _state ( A ) , _longest ( B , ( _river ( B ) , _loc ( B , C ) , _const ( C , _stateid ( nebraska ) ) ) ) , _river ( B ) , _traverse ( B , A ) ) )
which state is the city the capital of illinois located in ?	_answer ( A , ( _state ( A ) , _city ( B ) , _capital ( B ) , _loc ( B , C ) , _const ( C , _stateid ( illinois ) ) , _loc ( B , A ) ) )
what is the size of state is austin ?	_answer ( A , ( _size ( B , A ) , _loc ( C , B ) , _state ( B ) , _const ( C , _cityid ( austin , _ ) ) ) )
where is the capital of alabama ?	_answer ( A , ( _loc ( B , A ) , _capital ( B ) , _loc ( B , C ) , _const ( C , _stateid ( alabama ) ) ) )
what states have rivers named the rivers in the state of mississippi ?	_answer ( A , ( _state ( A ) , _loc ( B , A ) , _river ( B ) , _loc ( B , C ) , _state ( C ) , _const ( C , _stateid ( mississippi ) ) ) )
what are the populations of states through which the river runs through maine run ?	_answer ( A , ( _population ( B , A ) , _state ( B ) , _river ( C ) , _traverse ( C , D ) , _const ( D , _stateid ( maine ) ) , _river ( C ) , _traverse ( C , B ) ) )
how long is the the rivers in the state of north carolina ?	_answer ( A , ( _len ( B , A ) , _river ( B ) , _loc ( B , C ) , _state ( C ) , _const ( C , _stateid ( ' north carolina ' ) ) ) )
how many citizens in the smallest state that borders north carolina ?	_answer ( A , ( _population ( B , A ) , _smallest ( B , ( _state ( B ) , _next_to ( B , C ) , _const ( C , _stateid ( ' north carolina ' ) ) ) ) ) )
how many people live in the capital of florida ?	_answer ( A , ( _population ( B , A ) , _capital ( B ) , _loc ( B , C ) , _const ( C , _stateid ( florida ) ) ) )
what is the population of the biggest state in continental us ?	_answer ( A , ( _population ( B , A ) , _largest ( B , ( _state ( B ) , _loc ( B , C ) , _const ( C , _countryid ( usa ) ) ) ) ) )
what is the longest river in state is the city san diego located in ?	_answer ( A , _longest ( A , ( _river ( A ) , _loc ( A , B ) , _state ( B ) , _city ( C ) , _const ( C , _cityid ( ' san diego ' , _ ) ) , _loc ( C , B ) ) ) )
what river runs through states does the mississippi river run through ?	_answer ( A , ( _river ( A ) , _traverse ( A , B ) , _state ( B ) , _const ( C , _riverid ( mississippi ) ) , _river ( C ) , _traverse ( C , B ) ) )
what is the population of the capital of louisiana ?	_answer ( A , ( _population ( B , A ) , _capital ( B ) , _loc ( B , C ) , _const ( C , _stateid ( louisiana ) ) ) )
what states border states border michigan ?	_answer ( A , ( _state ( A ) , _next_to ( A , B ) , _state ( B ) , _next_to ( B , C ) , _const ( C , _stateid ( michigan ) ) ) )
which states border states through which the the biggest rivers in illinois traverses ?	_answer ( A , ( _state ( A ) , _next_to ( A , B ) , _state ( B ) , _longest ( C , ( _river ( C ) , _loc ( C , D ) , _const ( D , _stateid ( illinois ) ) ) ) , _traverse ( C , B ) ) )
could you tell me what is the highest point in the state of the biggest state in continental us ?	_answer ( A , _highest ( A , ( _place ( A ) , _loc ( A , B ) , _state ( B ) , _largest ( B , ( _state ( B ) , _loc ( B , C ) , _const ( C , _countryid ( usa ) ) ) ) ) ) )
which state border the smallest state that borders illinois ?	_answer ( A , ( _state ( A ) , _next_to ( A , B ) , _smallest ( B , ( _state ( B ) , _next_to ( B , C ) , _const ( C , _stateid ( illinois ) ) ) ) ) )
what states have rivers named rivers are in delaware ?	_answer ( A , ( _state ( A ) , _loc ( B , A ) , _river ( B ) , _loc ( B , C ) , _const ( C , _stateid ( delaware ) ) ) )
how long is the the rivers in the state of south carolina ?	_answer ( A , ( _len ( B , A ) , _river ( B ) , _loc ( B , C ) , _state ( C ) , _const ( C , _stateid ( ' south carolina ' ) ) , _river ( B ) ) )
what states have rivers named all the rivers in texas ?	_answer ( A , ( _state ( A ) , _loc ( B , A ) , _river ( B ) , _loc ( B , C ) , _const ( C , _stateid ( texas ) ) ) )
what is the longest river that runs through a state that borders state has the longest river ?	_answer ( A , _longest ( A , ( _river ( A ) , _traverse ( A , B ) , _state ( B ) , _next_to ( B , C ) , _longest ( D , ( _state ( C ) , _loc ( D , C ) , _river ( D ) ) ) ) ) )
which states does the the longest river in oregon run through ?	_answer ( A , ( _state ( A ) , _longest ( B , ( _river ( B ) , _loc ( B , C ) , _const ( C , _stateid ( oregon ) ) ) ) , _river ( B ) , _traverse ( B , A ) ) )
what river runs through states border louisiana ?	_answer ( A , ( _river ( A ) , _traverse ( A , B ) , _state ( B ) , _next_to ( B , C ) , _const ( C , _stateid ( louisiana ) ) ) )
where is the major cities in texas ?	_answer ( A , ( _loc ( B , A ) , _major ( B ) , _city ( B ) , _loc ( B , C ) , _const ( C , _stateid ( texas ) ) ) )
what are the biggest rivers in state does the highest point in usa exist ?	_answer ( A , _longest ( A , ( _river ( A ) , _loc ( A , B ) , _loc ( C , B ) , _state ( B ) , _highest ( C , ( _place ( C ) , _loc ( C , D ) , _const ( D , _countryid ( usa ) ) ) ) ) ) )
what river flows through state has the highest peak in the country ?	_answer ( A , ( _river ( A ) , _traverse ( A , B ) , _highest ( C , ( _state ( B ) , _loc ( C , B ) , _mountain ( C ) ) ) ) )
in which state is capitals are in the states that border north carolina ?	_answer ( A , ( _loc ( B , A ) , _state ( A ) , _capital ( B ) , _loc ( B , C ) , _state ( C ) , _next_to ( C , D ) , _const ( D , _stateid ( ' north carolina ' ) ) ) )
what are the populations of states through which the river flows through montana run ?	_answer ( A , ( _population ( B , A ) , _state ( B ) , _river ( C ) , _traverse ( C , D ) , _const ( D , _stateid ( montana ) ) , _river ( C ) , _traverse ( C , B ) ) )
how high is the highest point of states does the mississippi river run through ?	_answer ( A , ( _elevation ( B , A ) , _highest ( B , ( _place ( B ) , _loc ( B , C ) , _state ( C ) , _const ( D , _riverid ( mississippi ) ) , _river ( D ) , _traverse ( D , C ) ) ) ) )
what are the populations of states through which the river runs through alaska run ?	_answer ( A , ( _population ( B , A ) , _state ( B ) , _river ( C ) , _traverse ( C , D ) , _const ( D , _stateid ( alaska ) ) , _river ( C ) , _traverse ( C , B ) ) )
in which state is the capital of alaska ?	_answer ( A , ( _loc ( B , A ) , _state ( A ) , _capital ( B ) , _loc ( B , C ) , _const ( C , _stateid ( alaska ) ) ) )
what are the populations of states through which the rivers are in oregon run ?	_answer ( A , ( _population ( B , A ) , _state ( B ) , _river ( C ) , _loc ( C , D ) , _const ( D , _stateid ( oregon ) ) , _river ( C ) , _traverse ( C , B ) ) )
which state is the city capitals are in the states that border arizona located in ?	_answer ( A , ( _state ( A ) , _city ( B ) , _capital ( B ) , _loc ( B , C ) , _state ( C ) , _next_to ( C , D ) , _const ( D , _stateid ( arizona ) ) , _loc ( B , A ) ) )
how many citizens in state that borders texas is the largest ?	_answer ( A , ( _population ( B , A ) , _largest ( B , ( _state ( B ) , _next_to ( B , C ) , _const ( C , _stateid ( texas ) ) ) ) ) )
how many major cities are in state is rochester ?	_answer ( A , _count ( B , ( _major ( B ) , _city ( B ) , _loc ( B , C ) , _loc ( D , C ) , _state ( C ) , _const ( D , _cityid ( rochester , _ ) ) ) , A ) )
how many major cities are in state border montana ?	_answer ( A , _count ( B , ( _major ( B ) , _city ( B ) , _loc ( B , C ) , _state ( C ) , _next_to ( C , D ) , _const ( D , _stateid ( montana ) ) ) , A ) )
which state is the city the major cities in oregon located in ?	_answer ( A , ( _state ( A ) , _city ( B ) , _major ( B ) , _city ( B ) , _loc ( B , C ) , _const ( C , _stateid ( oregon ) ) , _loc ( B , A ) ) )
which states border states through which the river flows through vermont traverses ?	_answer ( A , ( _state ( A ) , _next_to ( A , B ) , _state ( B ) , _river ( C ) , _traverse ( C , D ) , _const ( D , _stateid ( vermont ) ) , _traverse ( C , B ) ) )
what is the highest point in states does the colorado run through ?	_answer ( A , _highest ( A , ( _place ( A ) , _loc ( A , B ) , _state ( B ) , _const ( C , _riverid ( colorado ) ) , _river ( C ) , _traverse ( C , B ) ) ) )
which states does the river flows through maine run through ?	_answer ( A , ( _state ( A ) , _river ( B ) , _traverse ( B , C ) , _const ( C , _stateid ( maine ) ) , _river ( B ) , _traverse ( B , A ) ) )
how long is the the longest river in florida ?	_answer ( A , ( _len ( B , A ) , _longest ( B , ( _river ( B ) , _loc ( B , C ) , _const ( C , _stateid ( florida ) ) ) ) ) )
what states border tennessee city has the largest population ?	_answer ( A , _largest ( B , ( _state ( C ) , _next_to ( C , D ) , _const ( D , _stateid ( tennessee ) ) , _city ( A ) , _loc ( A , C ) , _population ( A , B ) ) ) )
what states have a city named the major cities in iowa ?	_answer ( A , ( _state ( A ) , _loc ( B , A ) , _major ( B ) , _city ( B ) , _loc ( B , C ) , _const ( C , _stateid ( iowa ) ) ) )
what is the population of the cities which are in nebraska ?	_answer ( A , ( _population ( B , A ) , _city ( B ) , _loc ( B , C ) , _const ( C , _stateid ( nebraska ) ) ) )
what river runs through states have rivers named colorado ?	_answer ( A , ( _river ( A ) , _traverse ( A , B ) , _state ( B ) , _loc ( C , B ) , _const ( C , _riverid ( colorado ) ) ) )
how many states have a city called the major cities in south carolina ?	_answer ( A , _count ( B , ( _state ( B ) , _loc ( C , B ) , _major ( C ) , _city ( C ) , _loc ( C , D ) , _const ( D , _stateid ( ' south carolina ' ) ) ) , A ) )
how long is the river flows through texas ?	_answer ( A , ( _len ( B , A ) , _river ( B ) , _traverse ( B , C ) , _const ( C , _stateid ( texas ) ) , _river ( B ) ) )
what states have rivers named the rivers in the state of illinois ?	_answer ( A , ( _state ( A ) , _loc ( B , A ) , _river ( B ) , _loc ( B , C ) , _state ( C ) , _const ( C , _stateid ( illinois ) ) ) )
what is the population of the capital of hawaii ?	_answer ( A , ( _population ( B , A ) , _capital ( B ) , _loc ( B , C ) , _const ( C , _stateid ( hawaii ) ) ) )
give me the cities which are in state is the city san diego located in ?	_answer ( A , ( _city ( A ) , _loc ( A , B ) , _state ( B ) , _city ( C ) , _const ( C , _cityid ( ' san diego ' , _ ) ) , _loc ( C , B ) ) )
how many people live in the capital of delaware ?	_answer ( A , ( _population ( B , A ) , _capital ( B ) , _loc ( B , C ) , _const ( C , _stateid ( delaware ) ) ) )
in which state is capital of north carolina ?	_answer ( A , ( _loc ( B , A ) , _state ( A ) , _capital ( B ) , _loc ( B , C ) , _const ( C , _stateid ( ' north carolina ' ) ) ) )
which states does the river runs through nebraska run through ?	_answer ( A , ( _state ( A ) , _river ( B ) , _traverse ( B , C ) , _const ( C , _stateid ( nebraska ) ) , _river ( B ) , _traverse ( B , A ) ) )
what is the lowest point in state does the highest point in usa exist ?	_answer ( A , _lowest ( A , ( _place ( A ) , _loc ( A , B ) , _loc ( C , B ) , _state ( B ) , _highest ( C , ( _place ( C ) , _loc ( C , D ) , _const ( D , _countryid ( usa ) ) ) ) ) ) )
which states border states through which the the longest river in tennessee traverses ?	_answer ( A , ( _state ( A ) , _next_to ( A , B ) , _state ( B ) , _longest ( C , ( _river ( C ) , _loc ( C , D ) , _const ( D , _stateid ( tennessee ) ) ) ) , _traverse ( C , B ) ) )
what is the capital of states have rivers named colorado ?	_answer ( A , ( _capital ( A ) , _loc ( A , B ) , _state ( B ) , _loc ( C , B ) , _const ( C , _riverid ( colorado ) ) ) )
what river runs through state that borders utah is the largest ?	_answer ( A , ( _river ( A ) , _traverse ( A , B ) , _largest ( B , ( _state ( B ) , _next_to ( B , C ) , _const ( C , _stateid ( utah ) ) ) ) ) )
what is the longest river that runs through a state that borders the smallest state that borders vermont ?	_answer ( A , _longest ( A , ( _river ( A ) , _traverse ( A , B ) , _state ( B ) , _next_to ( B , C ) , _smallest ( C , ( _state ( C ) , _next_to ( C , D ) , _const ( D , _stateid ( vermont ) ) ) ) ) ) )
how many major cities are in states have a city named sacramento ?	_answer ( A , _count ( B , ( _major ( B ) , _city ( B ) , _loc ( B , C ) , _state ( C ) , _loc ( D , C ) , _const ( D , _cityid ( sacramento , _ ) ) ) , A ) )
what is the most populous city in state does the highest point in usa exist ?	_answer ( B , _largest ( A , ( _population ( B , A ) , _city ( B ) , _loc ( B , C ) , _loc ( D , C ) , _state ( C ) , _highest ( D , ( _place ( D ) , _loc ( D , E ) , _const ( E , _countryid ( usa ) ) ) ) ) ) )
what is the population of the biggest city in maine ?	_answer ( A , ( _population ( B , A ) , _largest ( B , ( _city ( B ) , _loc ( B , C ) , _const ( C , _stateid ( maine ) ) ) ) ) )
where is capital of iowa ?	_answer ( A , ( _loc ( B , A ) , _capital ( B ) , _loc ( B , C ) , _const ( C , _stateid ( iowa ) ) ) )
where is the capital of tennessee ?	_answer ( A , ( _loc ( B , A ) , _capital ( B ) , _loc ( B , C ) , _const ( C , _stateid ( tennessee ) ) ) )
what is the highest mountain in state has the highest peak in the country ?	_answer ( A , _highest ( A , ( _mountain ( A ) , _loc ( A , B ) , _highest ( C , ( _state ( B ) , _loc ( C , B ) , _mountain ( C ) ) ) ) ) )
how long is the the rivers in the state of hawaii ?	_answer ( A , ( _len ( B , A ) , _river ( B ) , _loc ( B , C ) , _state ( C ) , _const ( C , _stateid ( hawaii ) ) ) )
how many states have a city called the capital of alaska ?	_answer ( A , _count ( B , ( _state ( B ) , _loc ( C , B ) , _capital ( C ) , _loc ( C , D ) , _const ( D , _stateid ( alaska ) ) ) , A ) )
what is the population of states border alabama ?	_answer ( A , ( _population ( B , A ) , _state ( B ) , _next_to ( B , C ) , _const ( C , _stateid ( alabama ) ) ) )
what is the longest river that runs through a state that borders state border utah ?	_answer ( A , _longest ( A , ( _river ( A ) , _traverse ( A , B ) , _state ( B ) , _next_to ( B , C ) , _state ( C ) , _next_to ( C , D ) , _const ( D , _stateid ( utah ) ) ) ) )
how long is the rivers are in north carolina ?	_answer ( A , ( _len ( B , A ) , _river ( B ) , _loc ( B , C ) , _const ( C , _stateid ( ' north carolina ' ) ) , _river ( B ) ) )
what are the populations of states through which the all the rivers in maine run ?	_answer ( A , ( _population ( B , A ) , _state ( B ) , _river ( C ) , _loc ( C , D ) , _const ( D , _stateid ( maine ) ) , _river ( C ) , _traverse ( C , B ) ) )
what states have rivers named all the rivers in south carolina ?	_answer ( A , ( _state ( A ) , _loc ( B , A ) , _river ( B ) , _loc ( B , C ) , _const ( C , _stateid ( ' south carolina ' ) ) ) )
where is the capital of kentucky ?	_answer ( A , ( _loc ( B , A ) , _capital ( B ) , _loc ( B , C ) , _const ( C , _stateid ( kentucky ) ) ) )
what states have a city named the major cities in north carolina ?	_answer ( A , ( _state ( A ) , _loc ( B , A ) , _major ( B ) , _city ( B ) , _loc ( B , C ) , _const ( C , _stateid ( ' north carolina ' ) ) ) )
what state that borders states does the colorado run through is the largest ?	_answer ( A , _largest ( A , ( _state ( A ) , _next_to ( A , B ) , _state ( B ) , _const ( C , _riverid ( colorado ) ) , _river ( C ) , _traverse ( C , B ) ) ) )
which states border states through which the the longest river in illinois traverses ?	_answer ( A , ( _state ( A ) , _next_to ( A , B ) , _state ( B ) , _longest ( C , ( _river ( C ) , _loc ( C , D ) , _const ( D , _stateid ( illinois ) ) ) ) , _traverse ( C , B ) ) )
what are the populations of states through which the rivers are in iowa run ?	_answer ( A , ( _population ( B , A ) , _state ( B ) , _river ( C ) , _loc ( C , D ) , _const ( D , _stateid ( iowa ) ) , _river ( C ) , _traverse ( C , B ) ) )
what state is the largest city in nebraska in city has the largest population ?	_answer ( A , _largest ( B , ( _state ( C ) , _largest ( D , ( _city ( D ) , _loc ( D , E ) , _const ( E , _stateid ( nebraska ) ) ) ) , _loc ( D , C ) , _city ( A ) , _loc ( A , C ) , _population ( A , B ) ) ) )
how long is the rivers are in kentucky ?	_answer ( A , ( _len ( B , A ) , _river ( B ) , _loc ( B , C ) , _const ( C , _stateid ( kentucky ) ) , _river ( B ) ) )
what is the size of states does the mississippi river run through ?	_answer ( A , ( _size ( B , A ) , _state ( B ) , _const ( C , _riverid ( mississippi ) ) , _river ( C ) , _traverse ( C , B ) ) )
what is the smallest state that borders state has the highest peak in the country ?	_answer ( A , _smallest ( A , ( _state ( A ) , _next_to ( A , B ) , _highest ( C , ( _state ( B ) , _loc ( C , B ) , _mountain ( C ) ) ) ) ) )
what states have rivers named the biggest rivers in rhode island ?	_answer ( A , ( _state ( A ) , _loc ( B , A ) , _longest ( B , ( _river ( B ) , _loc ( B , C ) , _const ( C , _stateid ( ' rhode island ' ) ) ) ) ) )
in which state is the capital of oregon ?	_answer ( A , ( _loc ( B , A ) , _state ( A ) , _capital ( B ) , _loc ( B , C ) , _const ( C , _stateid ( oregon ) ) ) )
which state is the city capitals are in the states that border tennessee located in ?	_answer ( A , ( _state ( A ) , _city ( B ) , _capital ( B ) , _loc ( B , C ) , _state ( C ) , _next_to ( C , D ) , _const ( D , _stateid ( tennessee ) ) , _loc ( B , A ) ) )
what is the most populous city in state is mount mckinley ?	_answer ( B , _largest ( A , ( _population ( B , A ) , _city ( B ) , _loc ( B , C ) , _loc ( D , C ) , _state ( C ) , _const ( D , _placeid ( ' mount mckinley ' ) ) ) ) )
how many people live in the capital of georgia ?	_answer ( A , ( _population ( B , A ) , _capital ( B ) , _loc ( B , C ) , _const ( C , _stateid ( georgia ) ) ) )
name all the rivers in the biggest state in continental us ?	_answer ( A , ( _river ( A ) , _loc ( A , B ) , _largest ( B , ( _state ( B ) , _loc ( B , C ) , _const ( C , _countryid ( usa ) ) ) ) ) )
where is the capital of utah ?	_answer ( A , ( _loc ( B , A ) , _capital ( B ) , _loc ( B , C ) , _const ( C , _stateid ( utah ) ) ) )
how many major cities are in state border maine ?	_answer ( A , _count ( B , ( _major ( B ) , _city ( B ) , _loc ( B , C ) , _state ( C ) , _next_to ( C , D ) , _const ( D , _stateid ( maine ) ) ) , A ) )
give me the cities which are in states have a city named denver ?	_answer ( A , ( _city ( A ) , _loc ( A , B ) , _state ( B ) , _loc ( C , B ) , _const ( C , _cityid ( denver , _ ) ) ) )
how many states have a city called the cities which are in new york ?	_answer ( A , _count ( B , ( _state ( B ) , _loc ( C , B ) , _city ( C ) , _loc ( C , D ) , _const ( D , _stateid ( ' new york ' ) ) ) , A ) )
what is capital of states border iowa ?	_answer ( A , ( _capital ( A ) , _loc ( A , B ) , _state ( B ) , _next_to ( B , C ) , _const ( C , _stateid ( iowa ) ) ) )
how long is the all the rivers in alaska ?	_answer ( A , ( _len ( B , A ) , _river ( B ) , _loc ( B , C ) , _const ( C , _stateid ( alaska ) ) ) )
how many people live in the capital of mississippi ?	_answer ( A , ( _population ( B , A ) , _capital ( B ) , _loc ( B , C ) , _const ( C , _stateid ( mississippi ) ) ) )
which state border the neighboring states for montana ?	_answer ( A , ( _state ( A ) , _next_to ( A , B ) , _next_to ( B , C ) , _state ( B ) , _const ( C , _stateid ( montana ) ) ) )
which states border states through which the all the rivers in mississippi traverses ?	_answer ( A , ( _state ( A ) , _next_to ( A , B ) , _state ( B ) , _river ( C ) , _loc ( C , D ) , _const ( D , _stateid ( mississippi ) ) , _traverse ( C , B ) ) )
what is the population of the smallest state that borders nebraska ?	_answer ( A , ( _population ( B , A ) , _smallest ( B , ( _state ( B ) , _next_to ( B , C ) , _const ( C , _stateid ( nebraska ) ) ) ) ) )
in which state is the capital of kansas ?	_answer ( A , ( _loc ( B , A ) , _state ( A ) , _capital ( B ) , _loc ( B , C ) , _const ( C , _stateid ( kansas ) ) ) )
which states does the the biggest rivers in california run through ?	_answer ( A , ( _state ( A ) , _longest ( B , ( _river ( B ) , _loc ( B , C ) , _const ( C , _stateid ( california ) ) ) ) , _river ( B ) , _traverse ( B , A ) ) )
what is the population of the capital of michigan ?	_answer ( A , ( _population ( B , A ) , _capital ( B ) , _loc ( B , C ) , _const ( C , _stateid ( michigan ) ) ) )
which state border the states through which the longest river runs ?	_answer ( A , ( _state ( A ) , _next_to ( A , B ) , _state ( B ) , _longest ( C , ( _river ( C ) , _traverse ( C , B ) ) ) ) )
what is the population of the biggest city in alaska ?	_answer ( A , ( _population ( B , A ) , _largest ( B , ( _city ( B ) , _loc ( B , C ) , _const ( C , _stateid ( alaska ) ) ) ) ) )
what is the highest mountain in the states through which the longest river runs ?	_answer ( A , _highest ( A , ( _mountain ( A ) , _loc ( A , B ) , _state ( B ) , _longest ( C , ( _river ( C ) , _traverse ( C , B ) ) ) ) ) )
which states border states through which the rivers are in alaska traverses ?	_answer ( A , ( _state ( A ) , _next_to ( A , B ) , _state ( B ) , _river ( C ) , _loc ( C , D ) , _const ( D , _stateid ( alaska ) ) , _traverse ( C , B ) ) )
which state is the city the biggest city in vermont located in ?	_answer ( A , ( _state ( A ) , _city ( B ) , _largest ( B , ( _city ( B ) , _loc ( B , C ) , _const ( C , _stateid ( vermont ) ) ) ) , _loc ( B , A ) ) )
what is capital of the state with the lowest point ?	_answer ( A , ( _capital ( A ) , _loc ( A , B ) , _state ( B ) , _loc ( C , B ) , _lowest ( C , _place ( C ) ) ) )
what river flows through state that borders new york is the largest ?	_answer ( A , ( _river ( A ) , _traverse ( A , B ) , _largest ( B , ( _state ( B ) , _next_to ( B , C ) , _const ( C , _stateid ( ' new york ' ) ) ) ) ) )
which states border states through which the rivers are in tennessee traverses ?	_answer ( A , ( _state ( A ) , _next_to ( A , B ) , _state ( B ) , _river ( C ) , _loc ( C , D ) , _const ( D , _stateid ( tennessee ) ) , _traverse ( C , B ) ) )
what is the lowest point of states border rhode island ?	_answer ( A , _lowest ( A , ( _place ( A ) , _loc ( A , B ) , _state ( B ) , _next_to ( B , C ) , _const ( C , _stateid ( ' rhode island ' ) ) ) ) )
where is capital of mississippi ?	_answer ( A , ( _loc ( B , A ) , _capital ( B ) , _loc ( B , C ) , _const ( C , _stateid ( mississippi ) ) ) )
how many people live in capitals are in the states that border georgia ?	_answer ( A , ( _population ( B , A ) , _capital ( B ) , _loc ( B , C ) , _state ( C ) , _next_to ( C , D ) , _const ( D , _stateid ( georgia ) ) ) )
which states does the rivers are in hawaii run through ?	_answer ( A , ( _state ( A ) , _river ( B ) , _loc ( B , C ) , _const ( C , _stateid ( hawaii ) ) , _river ( B ) , _traverse ( B , A ) ) )
what are the major cities in states have rivers named colorado ?	_answer ( A , ( _major ( A ) , _city ( A ) , _loc ( A , B ) , _state ( B ) , _loc ( C , B ) , _const ( C , _riverid ( colorado ) ) ) )
which states border states through which the the longest river in the united states traverses ?	_answer ( A , ( _state ( A ) , _next_to ( A , B ) , _state ( B ) , _longest ( C , ( _river ( C ) , _loc ( C , D ) , _const ( D , _countryid ( usa ) ) ) ) , _traverse ( C , B ) ) )
which states does the the biggest rivers in rhode island run through ?	_answer ( A , ( _state ( A ) , _longest ( B , ( _river ( B ) , _loc ( B , C ) , _const ( C , _stateid ( ' rhode island ' ) ) ) ) , _river ( B ) , _traverse ( B , A ) ) )
what is the smallest state that borders state is the city new orleans located in ?	_answer ( A , _smallest ( A , ( _state ( A ) , _next_to ( A , B ) , _state ( B ) , _city ( C ) , _const ( C , _cityid ( ' new orleans ' , _ ) ) , _loc ( C , B ) ) ) )
what is the most populous city in state border south carolina ?	_answer ( B , _largest ( A , ( _population ( B , A ) , _city ( B ) , _loc ( B , C ) , _state ( C ) , _next_to ( C , D ) , _const ( D , _stateid ( ' south carolina ' ) ) ) ) )
where is capital of maine ?	_answer ( A , ( _loc ( B , A ) , _capital ( B ) , _loc ( B , C ) , _const ( C , _stateid ( maine ) ) ) )
what are the populations of states through which the river flows through texas run ?	_answer ( A , ( _population ( B , A ) , _state ( B ) , _river ( C ) , _traverse ( C , D ) , _const ( D , _stateid ( texas ) ) , _river ( C ) , _traverse ( C , B ) ) )
which state is the city utah city has the largest population located in ?	_answer ( A , ( _state ( A ) , _city ( B ) , _largest ( C , ( _const ( D , _stateid ( utah ) ) , _city ( B ) , _loc ( B , D ) , _population ( B , C ) ) ) , _loc ( B , A ) ) )
which states border states through which the river flows through north carolina traverses ?	_answer ( A , ( _state ( A ) , _next_to ( A , B ) , _state ( B ) , _river ( C ) , _traverse ( C , D ) , _const ( D , _stateid ( ' north carolina ' ) ) , _traverse ( C , B ) ) )
what states have rivers named the longest river in illinois ?	_answer ( A , ( _state ( A ) , _loc ( B , A ) , _longest ( B , ( _river ( B ) , _loc ( B , C ) , _const ( C , _stateid ( illinois ) ) ) ) ) )
what are the populations of states through which the the longest river in montana run ?	_answer ( A , ( _population ( B , A ) , _state ( B ) , _longest ( C , ( _river ( C ) , _loc ( C , D ) , _const ( D , _stateid ( montana ) ) ) ) , _river ( C ) , _traverse ( C , B ) ) )
how many major cities are in states does the longest river cross ?	_answer ( A , _count ( B , ( _major ( B ) , _city ( B ) , _loc ( B , C ) , _state ( C ) , _longest ( D , _river ( D ) ) , _traverse ( D , C ) ) , A ) )
what are the rivers in the state of state that borders pennsylvania is the largest ?	_answer ( A , ( _river ( A ) , _loc ( A , B ) , _state ( B ) , _largest ( B , ( _state ( B ) , _next_to ( B , C ) , _const ( C , _stateid ( pennsylvania ) ) ) ) ) )
which state is the city the major cities in kansas located in ?	_answer ( A , ( _state ( A ) , _city ( B ) , _major ( B ) , _city ( B ) , _loc ( B , C ) , _const ( C , _stateid ( kansas ) ) , _loc ( B , A ) ) )
what is the population of the capital of mississippi ?	_answer ( A , ( _population ( B , A ) , _capital ( B ) , _loc ( B , C ) , _const ( C , _stateid ( mississippi ) ) ) )
in which state is the major cities of the us ?	_answer ( A , ( _loc ( B , A ) , _state ( A ) , _major ( B ) , _city ( B ) , _loc ( B , C ) , _const ( C , _countryid ( usa ) ) ) )
what are the high points of states surrounding the smallest state that borders florida ?	_answer ( A , ( _high_point ( B , A ) , _loc ( A , B ) , _state ( B ) , _next_to ( B , C ) , _smallest ( C , ( _state ( C ) , _next_to ( C , D ) , _const ( D , _stateid ( florida ) ) ) ) ) )
which state border state border montana ?	_answer ( A , ( _state ( A ) , _next_to ( A , B ) , _state ( B ) , _next_to ( B , C ) , _const ( C , _stateid ( montana ) ) ) )
what is the population of capitals are in the states that border mississippi ?	_answer ( A , ( _population ( B , A ) , _capital ( B ) , _loc ( B , C ) , _state ( C ) , _next_to ( C , D ) , _const ( D , _stateid ( mississippi ) ) ) )
what are the populations of states through which the the longest river that runs through a state that borders hawaii run ?	_answer ( A , ( _population ( B , A ) , _state ( B ) , _longest ( C , ( _river ( C ) , _traverse ( C , D ) , _state ( D ) , _next_to ( D , E ) , _const ( E , _stateid ( hawaii ) ) ) ) , _river ( C ) , _traverse ( C , B ) ) )
what are the populations of states through which the the biggest rivers in maine run ?	_answer ( A , ( _population ( B , A ) , _state ( B ) , _longest ( C , ( _river ( C ) , _loc ( C , D ) , _const ( D , _stateid ( maine ) ) ) ) , _river ( C ) , _traverse ( C , B ) ) )
what states have rivers named rivers are in mississippi ?	_answer ( A , ( _state ( A ) , _loc ( B , A ) , _river ( B ) , _loc ( B , C ) , _const ( C , _stateid ( mississippi ) ) ) )
what is the lowest point of the state with the lowest point ?	_answer ( A , _lowest ( A , ( _place ( A ) , _loc ( A , B ) , _state ( B ) , _loc ( C , B ) , _lowest ( C , _place ( C ) ) ) ) )
what states have rivers named the rivers in the state of california ?	_answer ( A , ( _state ( A ) , _loc ( B , A ) , _river ( B ) , _loc ( B , C ) , _state ( C ) , _const ( C , _stateid ( california ) ) ) )
what is the most populous city in states does the longest river cross ?	_answer ( B , _largest ( A , ( _population ( B , A ) , _city ( B ) , _loc ( B , C ) , _state ( C ) , _longest ( D , _river ( D ) ) , _traverse ( D , C ) ) ) )
how many states have a city called maine city has the largest population ?	_answer ( A , _count ( B , ( _state ( B ) , _loc ( C , B ) , _largest ( D , ( _const ( E , _stateid ( maine ) ) , _city ( C ) , _loc ( C , E ) , _population ( C , D ) ) ) ) , A ) )
how long is the the longest river in louisiana ?	_answer ( A , ( _len ( B , A ) , _longest ( B , ( _river ( B ) , _loc ( B , C ) , _const ( C , _stateid ( louisiana ) ) ) ) ) )
what is capital of state is mount mckinley ?	_answer ( A , ( _capital ( A ) , _loc ( A , B ) , _loc ( C , B ) , _state ( B ) , _const ( C , _placeid ( ' mount mckinley ' ) ) ) )
how many states have a city called capital of new york ?	_answer ( A , _count ( B , ( _state ( B ) , _loc ( C , B ) , _capital ( C ) , _loc ( C , D ) , _const ( D , _stateid ( ' new york ' ) ) ) , A ) )
what states have rivers named river runs through nebraska ?	_answer ( A , ( _state ( A ) , _loc ( B , A ) , _river ( B ) , _traverse ( B , C ) , _const ( C , _stateid ( nebraska ) ) ) )
which state is the city the capital of florida located in ?	_answer ( A , ( _state ( A ) , _city ( B ) , _capital ( B ) , _loc ( B , C ) , _const ( C , _stateid ( florida ) ) , _loc ( B , A ) ) )
how long is the the rivers in the state of hawaii ?	_answer ( A , ( _len ( B , A ) , _river ( B ) , _loc ( B , C ) , _state ( C ) , _const ( C , _stateid ( hawaii ) ) , _river ( B ) ) )
what state that borders state is the city rochester located in is the largest ?	_answer ( A , _largest ( A , ( _state ( A ) , _next_to ( A , B ) , _state ( B ) , _city ( C ) , _const ( C , _cityid ( rochester , _ ) ) , _loc ( C , B ) ) ) )
what is the smallest state that borders states does the mississippi run through ?	_answer ( A , _smallest ( A , ( _state ( A ) , _next_to ( A , B ) , _state ( B ) , _const ( C , _riverid ( mississippi ) ) , _river ( C ) , _traverse ( C , B ) ) ) )
what are the biggest rivers in states does the colorado run through ?	_answer ( A , _longest ( A , ( _river ( A ) , _loc ( A , B ) , _state ( B ) , _const ( C , _riverid ( colorado ) ) , _river ( C ) , _traverse ( C , B ) ) ) )
what is the longest river in the neighboring states for north carolina ?	_answer ( A , _longest ( A , ( _river ( A ) , _loc ( A , B ) , _next_to ( B , C ) , _state ( B ) , _const ( C , _stateid ( ' north carolina ' ) ) ) ) )
what states have a city named the cities which are in georgia ?	_answer ( A , ( _state ( A ) , _loc ( B , A ) , _city ( B ) , _loc ( B , C ) , _const ( C , _stateid ( georgia ) ) ) )
what states have rivers named rivers are in georgia ?	_answer ( A , ( _state ( A ) , _loc ( B , A ) , _river ( B ) , _loc ( B , C ) , _const ( C , _stateid ( georgia ) ) ) )
what is the population of the capital of south carolina ?	_answer ( A , ( _population ( B , A ) , _capital ( B ) , _loc ( B , C ) , _const ( C , _stateid ( ' south carolina ' ) ) ) )
how many states have a city called the capital of georgia ?	_answer ( A , _count ( B , ( _state ( B ) , _loc ( C , B ) , _capital ( C ) , _loc ( C , D ) , _const ( D , _stateid ( georgia ) ) ) , A ) )
what states have a city named new orleans city has the largest population ?	_answer ( A , _largest ( B , ( _state ( C ) , _loc ( D , C ) , _const ( D , _cityid ( ' new orleans ' , _ ) ) , _city ( A ) , _loc ( A , C ) , _population ( A , B ) ) ) )
what is the highest point in states does the longest river cross ?	_answer ( A , _highest ( A , ( _place ( A ) , _loc ( A , B ) , _state ( B ) , _longest ( C , _river ( C ) ) , _traverse ( C , B ) ) ) )
in which state is the cities which are in florida ?	_answer ( A , ( _loc ( B , A ) , _state ( A ) , _city ( B ) , _loc ( B , C ) , _const ( C , _stateid ( florida ) ) ) )
what is the lowest point in state border tennessee ?	_answer ( A , _lowest ( A , ( _place ( A ) , _loc ( A , B ) , _state ( B ) , _next_to ( B , C ) , _const ( C , _stateid ( tennessee ) ) ) ) )
what is the biggest city in state has the highest peak in the country ?	_answer ( A , _largest ( A , ( _city ( A ) , _loc ( A , B ) , _highest ( C , ( _state ( B ) , _loc ( C , B ) , _mountain ( C ) ) ) ) ) )
what is the most populous city in state border oregon ?	_answer ( B , _largest ( A , ( _population ( B , A ) , _city ( B ) , _loc ( B , C ) , _state ( C ) , _next_to ( C , D ) , _const ( D , _stateid ( oregon ) ) ) ) )
what states have rivers named the longest river in nebraska ?	_answer ( A , ( _state ( A ) , _loc ( B , A ) , _longest ( B , ( _river ( B ) , _loc ( B , C ) , _const ( C , _stateid ( nebraska ) ) ) ) ) )
which state is the city capital of louisiana located in ?	_answer ( A , ( _state ( A ) , _city ( B ) , _capital ( B ) , _loc ( B , C ) , _const ( C , _stateid ( louisiana ) ) , _loc ( B , A ) ) )
where is the capital of florida ?	_answer ( A , ( _loc ( B , A ) , _capital ( B ) , _loc ( B , C ) , _const ( C , _stateid ( florida ) ) ) )
what is the lowest point in states border utah ?	_answer ( A , _lowest ( A , ( _place ( A ) , _loc ( A , B ) , _state ( B ) , _next_to ( B , C ) , _const ( C , _stateid ( utah ) ) ) ) )
what is the population of the smallest state that borders delaware ?	_answer ( A , ( _population ( B , A ) , _smallest ( B , ( _state ( B ) , _next_to ( B , C ) , _const ( C , _stateid ( delaware ) ) ) ) ) )
what is the highest point in the state with the lowest point ?	_answer ( A , _highest ( A , ( _place ( A ) , _loc ( A , B ) , _state ( B ) , _loc ( C , B ) , _lowest ( C , _place ( C ) ) ) ) )
how long is the the longest river that runs through a state that borders new york ?	_answer ( A , ( _len ( B , A ) , _longest ( B , ( _river ( B ) , _traverse ( B , C ) , _state ( C ) , _next_to ( C , D ) , _const ( D , _stateid ( ' new york ' ) ) ) ) , _river ( B ) ) )
what is the area of states border states through which the colorado traverses ?	_answer ( A , ( _area ( B , A ) , _state ( B ) , _next_to ( B , C ) , _state ( C ) , _const ( D , _riverid ( colorado ) ) , _traverse ( D , C ) ) )
what is the population of alaska city has the largest population ?	_answer ( A , ( _population ( B , A ) , _largest ( C , ( _const ( D , _stateid ( alaska ) ) , _city ( B ) , _loc ( B , D ) , _population ( B , C ) ) ) ) )
how long is the river runs through pennsylvania ?	_answer ( A , ( _len ( B , A ) , _river ( B ) , _traverse ( B , C ) , _const ( C , _stateid ( pennsylvania ) ) ) )
what states have rivers named rivers are in utah ?	_answer ( A , ( _state ( A ) , _loc ( B , A ) , _river ( B ) , _loc ( B , C ) , _const ( C , _stateid ( utah ) ) ) )
how many people live in colorado city has the largest population ?	_answer ( A , ( _population ( B , A ) , _largest ( C , ( _const ( D , _stateid ( colorado ) ) , _city ( B ) , _loc ( B , D ) , _population ( B , C ) ) ) ) )
which states border states through which the the longest river in montana traverses ?	_answer ( A , ( _state ( A ) , _next_to ( A , B ) , _state ( B ) , _longest ( C , ( _river ( C ) , _loc ( C , D ) , _const ( D , _stateid ( montana ) ) ) ) , _traverse ( C , B ) ) )
which states does the the longest river in mississippi run through ?	_answer ( A , ( _state ( A ) , _longest ( B , ( _river ( B ) , _loc ( B , C ) , _const ( C , _stateid ( mississippi ) ) ) ) , _river ( B ) , _traverse ( B , A ) ) )
what rivers are in state is the city atlanta located in ?	_answer ( A , ( _river ( A ) , _loc ( A , B ) , _state ( B ) , _city ( C ) , _const ( C , _cityid ( atlanta , _ ) ) , _loc ( C , B ) ) )
what are the populations of states through which the river flows through south carolina run ?	_answer ( A , ( _population ( B , A ) , _state ( B ) , _river ( C ) , _traverse ( C , D ) , _const ( D , _stateid ( ' south carolina ' ) ) , _river ( C ) , _traverse ( C , B ) ) )
which states does the the rivers in the state of kansas run through ?	_answer ( A , ( _state ( A ) , _river ( B ) , _loc ( B , C ) , _state ( C ) , _const ( C , _stateid ( kansas ) ) , _river ( B ) , _traverse ( B , A ) ) )
what is the population of the cities which are in tennessee ?	_answer ( A , ( _population ( B , A ) , _city ( B ) , _loc ( B , C ) , _const ( C , _stateid ( tennessee ) ) ) )
what is the most populous city in state has the shortest river ?	_answer ( B , _largest ( A , ( _population ( B , A ) , _city ( B ) , _loc ( B , C ) , _state ( C ) , _loc ( D , C ) , _shortest ( D , _river ( D ) ) ) ) )
which states border states through which the the biggest rivers in rhode island traverses ?	_answer ( A , ( _state ( A ) , _next_to ( A , B ) , _state ( B ) , _longest ( C , ( _river ( C ) , _loc ( C , D ) , _const ( D , _stateid ( ' rhode island ' ) ) ) ) , _traverse ( C , B ) ) )
what are the populations of states through which the the longest river that runs through a state that borders tennessee run ?	_answer ( A , ( _population ( B , A ) , _state ( B ) , _longest ( C , ( _river ( C ) , _traverse ( C , D ) , _state ( D ) , _next_to ( D , E ) , _const ( E , _stateid ( tennessee ) ) ) ) , _river ( C ) , _traverse ( C , B ) ) )
which states border states through which the the rivers in the state of alaska traverses ?	_answer ( A , ( _state ( A ) , _next_to ( A , B ) , _state ( B ) , _river ( C ) , _loc ( C , D ) , _state ( D ) , _const ( D , _stateid ( alaska ) ) , _traverse ( C , B ) ) )
in which state is the capital of rhode island ?	_answer ( A , ( _loc ( B , A ) , _state ( A ) , _capital ( B ) , _loc ( B , C ) , _const ( C , _stateid ( ' rhode island ' ) ) ) )
how long is the all the rivers in new york ?	_answer ( A , ( _len ( B , A ) , _river ( B ) , _loc ( B , C ) , _const ( C , _stateid ( ' new york ' ) ) ) )
in which state is the capital of arizona ?	_answer ( A , ( _loc ( B , A ) , _state ( A ) , _capital ( B ) , _loc ( B , C ) , _const ( C , _stateid ( arizona ) ) ) )
give me the cities which are in state has the largest population density ?	_answer ( A , ( _city ( A ) , _loc ( A , B ) , _largest ( C , ( _state ( B ) , _density ( B , C ) ) ) ) )
what are the neighboring states for states border michigan ?	_answer ( A , ( _next_to ( A , B ) , _state ( A ) , _state ( B ) , _next_to ( B , C ) , _const ( C , _stateid ( michigan ) ) ) )
which state is the city capital of alabama located in ?	_answer ( A , ( _state ( A ) , _city ( B ) , _capital ( B ) , _loc ( B , C ) , _const ( C , _stateid ( alabama ) ) , _loc ( B , A ) ) )
what is the longest river that runs through a state that borders state is the city denver located in ?	_answer ( A , _longest ( A , ( _river ( A ) , _traverse ( A , B ) , _state ( B ) , _next_to ( B , C ) , _state ( C ) , _city ( D ) , _const ( D , _cityid ( denver , _ ) ) , _loc ( D , C ) ) ) )
how many major cities are in states have a city named denver ?	_answer ( A , _count ( B , ( _major ( B ) , _city ( B ) , _loc ( B , C ) , _state ( C ) , _loc ( D , C ) , _const ( D , _cityid ( denver , _ ) ) ) , A ) )
what is the longest river that runs through a state that borders state has the largest population density ?	_answer ( A , _longest ( A , ( _river ( A ) , _traverse ( A , B ) , _state ( B ) , _next_to ( B , C ) , _largest ( D , ( _state ( C ) , _density ( C , D ) ) ) ) ) )
where is capital is the largest in the us ?	_answer ( A , ( _loc ( B , A ) , _largest ( B , ( _capital ( B ) , _loc ( B , C ) , _const ( C , _countryid ( usa ) ) ) ) ) )
what are the populations of states through which the the rivers in the state of oregon run ?	_answer ( A , ( _population ( B , A ) , _state ( B ) , _river ( C ) , _loc ( C , D ) , _state ( D ) , _const ( D , _stateid ( oregon ) ) , _river ( C ) , _traverse ( C , B ) ) )
what are the populations of states through which the the longest river in michigan run ?	_answer ( A , ( _population ( B , A ) , _state ( B ) , _longest ( C , ( _river ( C ) , _loc ( C , D ) , _const ( D , _stateid ( michigan ) ) ) ) , _river ( C ) , _traverse ( C , B ) ) )
what river runs through state is mount mckinley ?	_answer ( A , ( _river ( A ) , _traverse ( A , B ) , _loc ( C , B ) , _state ( B ) , _const ( C , _placeid ( ' mount mckinley ' ) ) ) )
which state is the city the major cities in maine located in ?	_answer ( A , ( _state ( A ) , _city ( B ) , _major ( B ) , _city ( B ) , _loc ( B , C ) , _const ( C , _stateid ( maine ) ) , _loc ( B , A ) ) )
which capitals are in the states that border state is the city atlanta located in ?	_answer ( A , ( _capital ( A ) , _loc ( A , B ) , _state ( B ) , _next_to ( B , C ) , _state ( C ) , _city ( D ) , _const ( D , _cityid ( atlanta , _ ) ) , _loc ( D , C ) ) )
what river runs through state is the city rochester located in ?	_answer ( A , ( _river ( A ) , _traverse ( A , B ) , _state ( B ) , _city ( C ) , _const ( C , _cityid ( rochester , _ ) ) , _loc ( C , B ) ) )
which state is the largest city in the biggest state in continental us in ?	_answer ( A , ( _state ( A ) , _largest ( B , ( _city ( B ) , _loc ( B , C ) , _largest ( C , ( _state ( C ) , _loc ( C , D ) , _const ( D , _countryid ( usa ) ) ) ) ) ) , _loc ( B , A ) ) )
where is the major cities of the us ?	_answer ( A , ( _loc ( B , A ) , _major ( B ) , _city ( B ) , _loc ( B , C ) , _const ( C , _countryid ( usa ) ) ) )
what is the area of state is the largest city in illinois in ?	_answer ( A , ( _area ( B , A ) , _state ( B ) , _largest ( C , ( _city ( C ) , _loc ( C , D ) , _const ( D , _stateid ( illinois ) ) ) ) , _loc ( C , B ) ) )
how many states does the states through which the longest river runs border ?	_answer ( A , _count ( B , ( _state ( B ) , _state ( C ) , _longest ( D , ( _river ( D ) , _traverse ( D , C ) ) ) , _next_to ( C , B ) ) , A ) )
what is the longest river in state has the highest peak in the country ?	_answer ( A , _longest ( A , ( _river ( A ) , _loc ( A , B ) , _highest ( C , ( _state ( B ) , _loc ( C , B ) , _mountain ( C ) ) ) ) ) )
how many states have a city called the capital of colorado ?	_answer ( A , _count ( B , ( _state ( B ) , _loc ( C , B ) , _capital ( C ) , _loc ( C , D ) , _const ( D , _stateid ( colorado ) ) ) , A ) )
what is the lowest point in state is rochester ?	_answer ( A , _lowest ( A , ( _place ( A ) , _loc ( A , B ) , _loc ( C , B ) , _state ( B ) , _const ( C , _cityid ( rochester , _ ) ) ) ) )
how many people live in the biggest city in maine ?	_answer ( A , ( _population ( B , A ) , _largest ( B , ( _city ( B ) , _loc ( B , C ) , _const ( C , _stateid ( maine ) ) ) ) ) )
what states have a city named the cities which are in kansas ?	_answer ( A , ( _state ( A ) , _loc ( B , A ) , _city ( B ) , _loc ( B , C ) , _const ( C , _stateid ( kansas ) ) ) )
which states does the the biggest rivers in maine run through ?	_answer ( A , ( _state ( A ) , _longest ( B , ( _river ( B ) , _loc ( B , C ) , _const ( C , _stateid ( maine ) ) ) ) , _river ( B ) , _traverse ( B , A ) ) )
what states have rivers named the biggest rivers in maine ?	_answer ( A , ( _state ( A ) , _loc ( B , A ) , _longest ( B , ( _river ( B ) , _loc ( B , C ) , _const ( C , _stateid ( maine ) ) ) ) ) )
what rivers are in the smallest state that borders tennessee ?	_answer ( A , ( _river ( A ) , _loc ( A , B ) , _smallest ( B , ( _state ( B ) , _next_to ( B , C ) , _const ( C , _stateid ( tennessee ) ) ) ) ) )
how many major cities are in states border arizona ?	_answer ( A , _count ( B , ( _major ( B ) , _city ( B ) , _loc ( B , C ) , _state ( C ) , _next_to ( C , D ) , _const ( D , _stateid ( arizona ) ) ) , A ) )
what are the rivers in the state of state is the largest city in montana in ?	_answer ( A , ( _river ( A ) , _loc ( A , B ) , _state ( B ) , _state ( B ) , _largest ( C , ( _city ( C ) , _loc ( C , D ) , _const ( D , _stateid ( montana ) ) ) ) , _loc ( C , B ) ) )
what states have a city named the capital of utah ?	_answer ( A , ( _state ( A ) , _loc ( B , A ) , _capital ( B ) , _loc ( B , C ) , _const ( C , _stateid ( utah ) ) ) )
what is the lowest point in state is the largest city in rhode island in ?	_answer ( A , _lowest ( A , ( _place ( A ) , _loc ( A , B ) , _state ( B ) , _largest ( C , ( _city ( C ) , _loc ( C , D ) , _const ( D , _stateid ( ' rhode island ' ) ) ) ) , _loc ( C , B ) ) ) )
what state that borders state has the largest population density is the largest ?	_answer ( A , _largest ( A , ( _state ( A ) , _next_to ( A , B ) , _largest ( C , ( _state ( B ) , _density ( B , C ) ) ) ) ) )
how many states have a city called kentucky city has the largest population ?	_answer ( A , _count ( B , ( _state ( B ) , _loc ( C , B ) , _largest ( D , ( _const ( E , _stateid ( kentucky ) ) , _city ( C ) , _loc ( C , E ) , _population ( C , D ) ) ) ) , A ) )
what states have rivers named the rivers in the state of maine ?	_answer ( A , ( _state ( A ) , _loc ( B , A ) , _river ( B ) , _loc ( B , C ) , _state ( C ) , _const ( C , _stateid ( maine ) ) ) )
how long is the river flows through hawaii ?	_answer ( A , ( _len ( B , A ) , _river ( B ) , _traverse ( B , C ) , _const ( C , _stateid ( hawaii ) ) , _river ( B ) ) )
what states have a city named the capital of maine ?	_answer ( A , ( _state ( A ) , _loc ( B , A ) , _capital ( B ) , _loc ( B , C ) , _const ( C , _stateid ( maine ) ) ) )
what is the highest elevation in state is the city denver located in ?	_answer ( A , _highest ( A , ( _place ( A ) , _loc ( A , B ) , _state ( B ) , _city ( C ) , _const ( C , _cityid ( denver , _ ) ) , _loc ( C , B ) ) ) )
what is the population of the biggest city in louisiana ?	_answer ( A , ( _population ( B , A ) , _largest ( B , ( _city ( B ) , _loc ( B , C ) , _const ( C , _stateid ( louisiana ) ) ) ) ) )
what is capital of state is the largest city in iowa in ?	_answer ( A , ( _capital ( A ) , _loc ( A , B ) , _state ( B ) , _largest ( C , ( _city ( C ) , _loc ( C , D ) , _const ( D , _stateid ( iowa ) ) ) ) , _loc ( C , B ) ) )
how many people live in capitals are in the states that border california ?	_answer ( A , ( _population ( B , A ) , _capital ( B ) , _loc ( B , C ) , _state ( C ) , _next_to ( C , D ) , _const ( D , _stateid ( california ) ) ) )
what are the populations of states through which the the biggest rivers in arizona run ?	_answer ( A , ( _population ( B , A ) , _state ( B ) , _longest ( C , ( _river ( C ) , _loc ( C , D ) , _const ( D , _stateid ( arizona ) ) ) ) , _river ( C ) , _traverse ( C , B ) ) )
what river flows through state border vermont ?	_answer ( A , ( _river ( A ) , _traverse ( A , B ) , _state ( B ) , _next_to ( B , C ) , _const ( C , _stateid ( vermont ) ) ) )
how many states does states border tennessee border ?	_answer ( A , _count ( B , ( _state ( B ) , _state ( C ) , _next_to ( C , D ) , _const ( D , _stateid ( tennessee ) ) , _next_to ( C , B ) ) , A ) )
how many states have a city called capitals are in the states that border arizona ?	_answer ( A , _count ( B , ( _state ( B ) , _loc ( C , B ) , _capital ( C ) , _loc ( C , D ) , _state ( D ) , _next_to ( D , E ) , _const ( E , _stateid ( arizona ) ) ) , A ) )
how many states have a city called kansas city has the largest population ?	_answer ( A , _count ( B , ( _state ( B ) , _loc ( C , B ) , _largest ( D , ( _const ( E , _stateid ( kansas ) ) , _city ( C ) , _loc ( C , E ) , _population ( C , D ) ) ) ) , A ) )
what states have a city named the major cities of the us ?	_answer ( A , ( _state ( A ) , _loc ( B , A ) , _major ( B ) , _city ( B ) , _loc ( B , C ) , _const ( C , _countryid ( usa ) ) ) )
what states have rivers named all the rivers in arizona ?	_answer ( A , ( _state ( A ) , _loc ( B , A ) , _river ( B ) , _loc ( B , C ) , _const ( C , _stateid ( arizona ) ) ) )
what is the most populous city in the state with the lowest point ?	_answer ( B , _largest ( A , ( _population ( B , A ) , _city ( B ) , _loc ( B , C ) , _state ( C ) , _loc ( D , C ) , _lowest ( D , _place ( D ) ) ) ) )
what rivers are in the smallest state that borders hawaii ?	_answer ( A , ( _river ( A ) , _loc ( A , B ) , _smallest ( B , ( _state ( B ) , _next_to ( B , C ) , _const ( C , _stateid ( hawaii ) ) ) ) ) )
which states border state has the longest river ?	_answer ( A , ( _state ( A ) , _next_to ( A , B ) , _longest ( C , ( _state ( B ) , _loc ( C , B ) , _river ( C ) ) ) ) )
what are the rivers in the state of states border nebraska ?	_answer ( A , ( _river ( A ) , _loc ( A , B ) , _state ( B ) , _state ( B ) , _next_to ( B , C ) , _const ( C , _stateid ( nebraska ) ) ) )
what are the neighboring states for states does the colorado run through ?	_answer ( A , ( _next_to ( A , B ) , _state ( A ) , _state ( B ) , _const ( C , _riverid ( colorado ) ) , _river ( C ) , _traverse ( C , B ) ) )
in which state is capital of new york ?	_answer ( A , ( _loc ( B , A ) , _state ( A ) , _capital ( B ) , _loc ( B , C ) , _const ( C , _stateid ( ' new york ' ) ) ) )
what river flows through state border nebraska ?	_answer ( A , ( _river ( A ) , _traverse ( A , B ) , _state ( B ) , _next_to ( B , C ) , _const ( C , _stateid ( nebraska ) ) ) )
what river flows through the smallest state that borders florida ?	_answer ( A , ( _river ( A ) , _traverse ( A , B ) , _smallest ( B , ( _state ( B ) , _next_to ( B , C ) , _const ( C , _stateid ( florida ) ) ) ) ) )
how many major cities are in states border new york ?	_answer ( A , _count ( B , ( _major ( B ) , _city ( B ) , _loc ( B , C ) , _state ( C ) , _next_to ( C , D ) , _const ( D , _stateid ( ' new york ' ) ) ) , A ) )
how many people live in the capital of kansas ?	_answer ( A , ( _population ( B , A ) , _capital ( B ) , _loc ( B , C ) , _const ( C , _stateid ( kansas ) ) ) )
what states border kentucky city has the largest population ?	_answer ( A , _largest ( B , ( _state ( C ) , _next_to ( C , D ) , _const ( D , _stateid ( kentucky ) ) , _city ( A ) , _loc ( A , C ) , _population ( A , B ) ) ) )
which states does the the longest river that runs through a state that borders alabama run through ?	_answer ( A , ( _state ( A ) , _longest ( B , ( _river ( B ) , _traverse ( B , C ) , _state ( C ) , _next_to ( C , D ) , _const ( D , _stateid ( alabama ) ) ) ) , _river ( B ) , _traverse ( B , A ) ) )
how many citizens in state border oregon ?	_answer ( A , ( _population ( B , A ) , _state ( B ) , _next_to ( B , C ) , _const ( C , _stateid ( oregon ) ) ) )
what is the population of capitals are in the states that border pennsylvania ?	_answer ( A , ( _population ( B , A ) , _capital ( B ) , _loc ( B , C ) , _state ( C ) , _next_to ( C , D ) , _const ( D , _stateid ( pennsylvania ) ) ) )
what is the lowest point in state border montana ?	_answer ( A , _lowest ( A , ( _place ( A ) , _loc ( A , B ) , _state ( B ) , _next_to ( B , C ) , _const ( C , _stateid ( montana ) ) ) ) )
how long is the the biggest rivers in iowa ?	_answer ( A , ( _len ( B , A ) , _longest ( B , ( _river ( B ) , _loc ( B , C ) , _const ( C , _stateid ( iowa ) ) ) ) , _river ( B ) ) )
what are the populations of states through which the the longest river in nebraska run ?	_answer ( A , ( _population ( B , A ) , _state ( B ) , _longest ( C , ( _river ( C ) , _loc ( C , D ) , _const ( D , _stateid ( nebraska ) ) ) ) , _river ( C ) , _traverse ( C , B ) ) )
give me the cities which are in states have a city named new orleans ?	_answer ( A , ( _city ( A ) , _loc ( A , B ) , _state ( B ) , _loc ( C , B ) , _const ( C , _cityid ( ' new orleans ' , _ ) ) ) )
in which state is the capital of pennsylvania ?	_answer ( A , ( _loc ( B , A ) , _state ( A ) , _capital ( B ) , _loc ( B , C ) , _const ( C , _stateid ( pennsylvania ) ) ) )
how many citizens in the smallest state that borders texas ?	_answer ( A , ( _population ( B , A ) , _smallest ( B , ( _state ( B ) , _next_to ( B , C ) , _const ( C , _stateid ( texas ) ) ) ) ) )
what is capital of state has the shortest river ?	_answer ( A , ( _capital ( A ) , _loc ( A , B ) , _state ( B ) , _loc ( C , B ) , _shortest ( C , _river ( C ) ) ) )
which capitals are in the states that border states does the longest river cross ?	_answer ( A , ( _capital ( A ) , _loc ( A , B ) , _state ( B ) , _next_to ( B , C ) , _state ( C ) , _longest ( D , _river ( D ) ) , _traverse ( D , C ) ) )
what are the major cities in state has the shortest river ?	_answer ( A , ( _major ( A ) , _city ( A ) , _loc ( A , B ) , _state ( B ) , _loc ( C , B ) , _shortest ( C , _river ( C ) ) ) )
in which state is the major cities in new york ?	_answer ( A , ( _loc ( B , A ) , _state ( A ) , _major ( B ) , _city ( B ) , _loc ( B , C ) , _const ( C , _stateid ( ' new york ' ) ) ) )
how long is the river flows through north carolina ?	_answer ( A , ( _len ( B , A ) , _river ( B ) , _traverse ( B , C ) , _const ( C , _stateid ( ' north carolina ' ) ) , _river ( B ) ) )
which states border state has the shortest river ?	_answer ( A , ( _state ( A ) , _next_to ( A , B ) , _state ( B ) , _loc ( C , B ) , _shortest ( C , _river ( C ) ) ) )
which states does the rivers are in tennessee run through ?	_answer ( A , ( _state ( A ) , _river ( B ) , _loc ( B , C ) , _const ( C , _stateid ( tennessee ) ) , _river ( B ) , _traverse ( B , A ) ) )
what is the population of the biggest city in oregon ?	_answer ( A , ( _population ( B , A ) , _largest ( B , ( _city ( B ) , _loc ( B , C ) , _const ( C , _stateid ( oregon ) ) ) ) ) )
what river flows through states have rivers named colorado ?	_answer ( A , ( _river ( A ) , _traverse ( A , B ) , _state ( B ) , _loc ( C , B ) , _const ( C , _riverid ( colorado ) ) ) )
what is capital of state that borders alabama is the largest ?	_answer ( A , ( _capital ( A ) , _loc ( A , B ) , _largest ( B , ( _state ( B ) , _next_to ( B , C ) , _const ( C , _stateid ( alabama ) ) ) ) ) )
which state is the city the major cities in nebraska located in ?	_answer ( A , ( _state ( A ) , _city ( B ) , _major ( B ) , _city ( B ) , _loc ( B , C ) , _const ( C , _stateid ( nebraska ) ) , _loc ( B , A ) ) )
what state that borders state has highest elevation is the largest ?	_answer ( A , _largest ( A , ( _state ( A ) , _next_to ( A , B ) , _state ( B ) , _loc ( C , B ) , _highest ( C , _place ( C ) ) ) ) )
how many states have a city called capital of vermont ?	_answer ( A , _count ( B , ( _state ( B ) , _loc ( C , B ) , _capital ( C ) , _loc ( C , D ) , _const ( D , _stateid ( vermont ) ) ) , A ) )
what is the population of the capital of arizona ?	_answer ( A , ( _population ( B , A ) , _capital ( B ) , _loc ( B , C ) , _const ( C , _stateid ( arizona ) ) ) )
which state is the city the capital of kentucky located in ?	_answer ( A , ( _state ( A ) , _city ( B ) , _capital ( B ) , _loc ( B , C ) , _const ( C , _stateid ( kentucky ) ) , _loc ( B , A ) ) )
which state is the city texas city has the largest population located in ?	_answer ( A , ( _state ( A ) , _city ( B ) , _largest ( C , ( _const ( D , _stateid ( texas ) ) , _city ( B ) , _loc ( B , D ) , _population ( B , C ) ) ) , _loc ( B , A ) ) )
which states border states through which the the biggest rivers in kansas traverses ?	_answer ( A , ( _state ( A ) , _next_to ( A , B ) , _state ( B ) , _longest ( C , ( _river ( C ) , _loc ( C , D ) , _const ( D , _stateid ( kansas ) ) ) ) , _traverse ( C , B ) ) )
what is the smallest state that borders state has the largest population density ?	_answer ( A , _smallest ( A , ( _state ( A ) , _next_to ( A , B ) , _largest ( C , ( _state ( B ) , _density ( B , C ) ) ) ) ) )
where is capital of louisiana ?	_answer ( A , ( _loc ( B , A ) , _capital ( B ) , _loc ( B , C ) , _const ( C , _stateid ( louisiana ) ) ) )
what river flows through state border montana ?	_answer ( A , ( _river ( A ) , _traverse ( A , B ) , _state ( B ) , _next_to ( B , C ) , _const ( C , _stateid ( montana ) ) ) )
which states border states through which the river runs through california traverses ?	_answer ( A , ( _state ( A ) , _next_to ( A , B ) , _state ( B ) , _river ( C ) , _traverse ( C , D ) , _const ( D , _stateid ( california ) ) , _traverse ( C , B ) ) )
what states have rivers named mississippi river city has the largest population ?	_answer ( A , _largest ( B , ( _state ( C ) , _loc ( D , C ) , _const ( D , _riverid ( mississippi ) ) , _city ( A ) , _loc ( A , C ) , _population ( A , B ) ) ) )
how long is the the shortest river in the united states ?	_answer ( A , ( _len ( B , A ) , _shortest ( B , ( _river ( B ) , _loc ( B , C ) , _const ( C , _countryid ( usa ) ) ) ) , _river ( B ) ) )
how long is the rivers are in hawaii ?	_answer ( A , ( _len ( B , A ) , _river ( B ) , _loc ( B , C ) , _const ( C , _stateid ( hawaii ) ) ) )
which states border states through which the the longest river in kentucky traverses ?	_answer ( A , ( _state ( A ) , _next_to ( A , B ) , _state ( B ) , _longest ( C , ( _river ( C ) , _loc ( C , D ) , _const ( D , _stateid ( kentucky ) ) ) ) , _traverse ( C , B ) ) )
how many states does states does the mississippi run through border ?	_answer ( A , _count ( B , ( _state ( B ) , _state ( C ) , _const ( D , _riverid ( mississippi ) ) , _river ( D ) , _traverse ( D , C ) , _next_to ( C , B ) ) , A ) )
how long is the all the rivers in vermont ?	_answer ( A , ( _len ( B , A ) , _river ( B ) , _loc ( B , C ) , _const ( C , _stateid ( vermont ) ) , _river ( B ) ) )
what states have rivers named the biggest rivers in tennessee ?	_answer ( A , ( _state ( A ) , _loc ( B , A ) , _longest ( B , ( _river ( B ) , _loc ( B , C ) , _const ( C , _stateid ( tennessee ) ) ) ) ) )
how long is the the longest river that runs through a state that borders tennessee ?	_answer ( A , ( _len ( B , A ) , _longest ( B , ( _river ( B ) , _traverse ( B , C ) , _state ( C ) , _next_to ( C , D ) , _const ( D , _stateid ( tennessee ) ) ) ) , _river ( B ) ) )
what states border state is the city atlanta located in ?	_answer ( A , ( _state ( A ) , _next_to ( A , B ) , _state ( B ) , _city ( C ) , _const ( C , _cityid ( atlanta , _ ) ) , _loc ( C , B ) ) )
which states does the the longest river that runs through a state that borders mississippi run through ?	_answer ( A , ( _state ( A ) , _longest ( B , ( _river ( B ) , _traverse ( B , C ) , _state ( C ) , _next_to ( C , D ) , _const ( D , _stateid ( mississippi ) ) ) ) , _river ( B ) , _traverse ( B , A ) ) )
what states border states does the longest river cross ?	_answer ( A , ( _state ( A ) , _next_to ( A , B ) , _state ( B ) , _longest ( C , _river ( C ) ) , _traverse ( C , B ) ) )
what is the highest point in states have rivers named mississippi river ?	_answer ( A , _highest ( A , ( _place ( A ) , _loc ( A , B ) , _state ( B ) , _loc ( C , B ) , _const ( C , _riverid ( mississippi ) ) ) ) )
what states have a city named the major cities in louisiana ?	_answer ( A , ( _state ( A ) , _loc ( B , A ) , _major ( B ) , _city ( B ) , _loc ( B , C ) , _const ( C , _stateid ( louisiana ) ) ) )
what are the populations of states through which the the longest river that runs through a state that borders kansas run ?	_answer ( A , ( _population ( B , A ) , _state ( B ) , _longest ( C , ( _river ( C ) , _traverse ( C , D ) , _state ( D ) , _next_to ( D , E ) , _const ( E , _stateid ( kansas ) ) ) ) , _river ( C ) , _traverse ( C , B ) ) )
where is the major cities in utah ?	_answer ( A , ( _loc ( B , A ) , _major ( B ) , _city ( B ) , _loc ( B , C ) , _const ( C , _stateid ( utah ) ) ) )
what is capital of states border alabama ?	_answer ( A , ( _capital ( A ) , _loc ( A , B ) , _state ( B ) , _next_to ( B , C ) , _const ( C , _stateid ( alabama ) ) ) )
what are the neighboring states for states have rivers named mississippi river ?	_answer ( A , ( _next_to ( A , B ) , _state ( A ) , _state ( B ) , _loc ( C , B ) , _const ( C , _riverid ( mississippi ) ) ) )
how long is the rivers are in oregon ?	_answer ( A , ( _len ( B , A ) , _river ( B ) , _loc ( B , C ) , _const ( C , _stateid ( oregon ) ) , _river ( B ) ) )
what is the population of capitals are in the states that border vermont ?	_answer ( A , ( _population ( B , A ) , _capital ( B ) , _loc ( B , C ) , _state ( C ) , _next_to ( C , D ) , _const ( D , _stateid ( vermont ) ) ) )
which state is the city capitals are in the states that border mississippi located in ?	_answer ( A , ( _state ( A ) , _city ( B ) , _capital ( B ) , _loc ( B , C ) , _state ( C ) , _next_to ( C , D ) , _const ( D , _stateid ( mississippi ) ) , _loc ( B , A ) ) )
which states does the all the rivers in california run through ?	_answer ( A , ( _state ( A ) , _river ( B ) , _loc ( B , C ) , _const ( C , _stateid ( california ) ) , _river ( B ) , _traverse ( B , A ) ) )
how long is the river flows through alabama ?	_answer ( A , ( _len ( B , A ) , _river ( B ) , _traverse ( B , C ) , _const ( C , _stateid ( alabama ) ) ) )
in which state is the major cities in south carolina ?	_answer ( A , ( _loc ( B , A ) , _state ( A ) , _major ( B ) , _city ( B ) , _loc ( B , C ) , _const ( C , _stateid ( ' south carolina ' ) ) ) )
what state that borders state that borders michigan is the largest is the largest ?	_answer ( A , _largest ( A , ( _state ( A ) , _next_to ( A , B ) , _largest ( B , ( _state ( B ) , _next_to ( B , C ) , _const ( C , _stateid ( michigan ) ) ) ) ) ) )
how many states have a city called the major cities in the smallest state in the us ?	_answer ( A , _count ( B , ( _state ( B ) , _loc ( C , B ) , _major ( C ) , _city ( C ) , _loc ( C , D ) , _smallest ( D , ( _state ( D ) , _loc ( D , E ) , _const ( E , _countryid ( usa ) ) ) ) ) , A ) )
how many people live in the major cities in florida ?	_answer ( A , ( _population ( B , A ) , _major ( B ) , _city ( B ) , _loc ( B , C ) , _const ( C , _stateid ( florida ) ) ) )
in which state is the cities which are in kansas ?	_answer ( A , ( _loc ( B , A ) , _state ( A ) , _city ( B ) , _loc ( B , C ) , _const ( C , _stateid ( kansas ) ) ) )
how long is the the longest river that runs through a state that borders pennsylvania ?	_answer ( A , ( _len ( B , A ) , _longest ( B , ( _river ( B ) , _traverse ( B , C ) , _state ( C ) , _next_to ( C , D ) , _const ( D , _stateid ( pennsylvania ) ) ) ) ) )
what is the lowest point of state that borders california is the largest ?	_answer ( A , _lowest ( A , ( _place ( A ) , _loc ( A , B ) , _largest ( B , ( _state ( B ) , _next_to ( B , C ) , _const ( C , _stateid ( california ) ) ) ) ) ) )
how long is the the biggest rivers in michigan ?	_answer ( A , ( _len ( B , A ) , _longest ( B , ( _river ( B ) , _loc ( B , C ) , _const ( C , _stateid ( michigan ) ) ) ) ) )
what are the populations of states through which the the rivers in the state of colorado run ?	_answer ( A , ( _population ( B , A ) , _state ( B ) , _river ( C ) , _loc ( C , D ) , _state ( D ) , _const ( D , _stateid ( colorado ) ) , _river ( C ) , _traverse ( C , B ) ) )
how many citizens in state has highest elevation ?	_answer ( A , ( _population ( B , A ) , _state ( B ) , _loc ( C , B ) , _highest ( C , _place ( C ) ) ) )
how many major cities are in state that borders texas is the largest ?	_answer ( A , _count ( B , ( _major ( B ) , _city ( B ) , _loc ( B , C ) , _largest ( C , ( _state ( C ) , _next_to ( C , D ) , _const ( D , _stateid ( texas ) ) ) ) ) , A ) )
which states does the all the rivers in kansas run through ?	_answer ( A , ( _state ( A ) , _river ( B ) , _loc ( B , C ) , _const ( C , _stateid ( kansas ) ) , _river ( B ) , _traverse ( B , A ) ) )
how many states have a city called the capital of california ?	_answer ( A , _count ( B , ( _state ( B ) , _loc ( C , B ) , _capital ( C ) , _loc ( C , D ) , _const ( D , _stateid ( california ) ) ) , A ) )
which states does the river flows through hawaii run through ?	_answer ( A , ( _state ( A ) , _river ( B ) , _traverse ( B , C ) , _const ( C , _stateid ( hawaii ) ) , _river ( B ) , _traverse ( B , A ) ) )
which states border states through which the rivers are in arizona traverses ?	_answer ( A , ( _state ( A ) , _next_to ( A , B ) , _state ( B ) , _river ( C ) , _loc ( C , D ) , _const ( D , _stateid ( arizona ) ) , _traverse ( C , B ) ) )
what states have rivers named the longest river in louisiana ?	_answer ( A , ( _state ( A ) , _loc ( B , A ) , _longest ( B , ( _river ( B ) , _loc ( B , C ) , _const ( C , _stateid ( louisiana ) ) ) ) ) )
what is the highest mountain in states border hawaii ?	_answer ( A , _highest ( A , ( _mountain ( A ) , _loc ( A , B ) , _state ( B ) , _next_to ( B , C ) , _const ( C , _stateid ( hawaii ) ) ) ) )
which states does the the longest river that runs through a state that borders georgia run through ?	_answer ( A , ( _state ( A ) , _longest ( B , ( _river ( B ) , _traverse ( B , C ) , _state ( C ) , _next_to ( C , D ) , _const ( D , _stateid ( georgia ) ) ) ) , _river ( B ) , _traverse ( B , A ) ) )
how long is the the rivers in the state of tennessee ?	_answer ( A , ( _len ( B , A ) , _river ( B ) , _loc ( B , C ) , _state ( C ) , _const ( C , _stateid ( tennessee ) ) , _river ( B ) ) )
which state border states border south carolina ?	_answer ( A , ( _state ( A ) , _next_to ( A , B ) , _state ( B ) , _next_to ( B , C ) , _const ( C , _stateid ( ' south carolina ' ) ) ) )
what are the major cities in the biggest state in continental us ?	_answer ( A , ( _major ( A ) , _city ( A ) , _loc ( A , B ) , _largest ( B , ( _state ( B ) , _loc ( B , C ) , _const ( C , _countryid ( usa ) ) ) ) ) )
what is the area of state is the city sacramento located in ?	_answer ( A , ( _area ( B , A ) , _state ( B ) , _city ( C ) , _const ( C , _cityid ( sacramento , _ ) ) , _loc ( C , B ) ) )
how many major cities are in state is the city atlanta located in ?	_answer ( A , _count ( B , ( _major ( B ) , _city ( B ) , _loc ( B , C ) , _state ( C ) , _city ( D ) , _const ( D , _cityid ( atlanta , _ ) ) , _loc ( D , C ) ) , A ) )
how long is the river flows through rhode island ?	_answer ( A , ( _len ( B , A ) , _river ( B ) , _traverse ( B , C ) , _const ( C , _stateid ( ' rhode island ' ) ) ) )
how long is the the biggest rivers in georgia ?	_answer ( A , ( _len ( B , A ) , _longest ( B , ( _river ( B ) , _loc ( B , C ) , _const ( C , _stateid ( georgia ) ) ) ) ) )
what is the lowest point in states does the mississippi river run through ?	_answer ( A , _lowest ( A , ( _place ( A ) , _loc ( A , B ) , _state ( B ) , _const ( C , _riverid ( mississippi ) ) , _river ( C ) , _traverse ( C , B ) ) ) )
which states border states through which the the longest river that runs through a state that borders montana traverses ?	_answer ( A , ( _state ( A ) , _next_to ( A , B ) , _state ( B ) , _longest ( C , ( _river ( C ) , _traverse ( C , D ) , _state ( D ) , _next_to ( D , E ) , _const ( E , _stateid ( montana ) ) ) ) , _traverse ( C , B ) ) )
what are the populations of states through which the rivers are in alabama run ?	_answer ( A , ( _population ( B , A ) , _state ( B ) , _river ( C ) , _loc ( C , D ) , _const ( D , _stateid ( alabama ) ) , _river ( C ) , _traverse ( C , B ) ) )
how long is the river runs through louisiana ?	_answer ( A , ( _len ( B , A ) , _river ( B ) , _traverse ( B , C ) , _const ( C , _stateid ( louisiana ) ) , _river ( B ) ) )
how long is the river flows through colorado ?	_answer ( A , ( _len ( B , A ) , _river ( B ) , _traverse ( B , C ) , _const ( C , _stateid ( colorado ) ) ) )
how long is the all the rivers in montana ?	_answer ( A , ( _len ( B , A ) , _river ( B ) , _loc ( B , C ) , _const ( C , _stateid ( montana ) ) ) )
which state is the city capital is the largest in the us located in ?	_answer ( A , ( _state ( A ) , _city ( B ) , _largest ( B , ( _capital ( B ) , _loc ( B , C ) , _const ( C , _countryid ( usa ) ) ) ) , _loc ( B , A ) ) )
what is the population of capital of nebraska ?	_answer ( A , ( _population ( B , A ) , _capital ( B ) , _loc ( B , C ) , _const ( C , _stateid ( nebraska ) ) ) )
what is the capital of state does the highest point in usa exist ?	_answer ( A , ( _capital ( A ) , _loc ( A , B ) , _loc ( C , B ) , _state ( B ) , _highest ( C , ( _place ( C ) , _loc ( C , D ) , _const ( D , _countryid ( usa ) ) ) ) ) )
where is capitals are in the states that border florida ?	_answer ( A , ( _loc ( B , A ) , _capital ( B ) , _loc ( B , C ) , _state ( C ) , _next_to ( C , D ) , _const ( D , _stateid ( florida ) ) ) )
what is the biggest city in states border states through which the mississippi river traverses ?	_answer ( A , _largest ( A , ( _city ( A ) , _loc ( A , B ) , _state ( B ) , _next_to ( B , C ) , _state ( C ) , _const ( D , _riverid ( mississippi ) ) , _traverse ( D , C ) ) ) )
what is the population of state has highest elevation ?	_answer ( A , ( _population ( B , A ) , _state ( B ) , _loc ( C , B ) , _highest ( C , _place ( C ) ) ) )
what is capital of state has the smallest population density ?	_answer ( A , ( _capital ( A ) , _loc ( A , B ) , _smallest ( C , ( _state ( B ) , _density ( B , C ) ) ) ) )
what is the lowest point in state has the highest peak in the country ?	_answer ( A , _lowest ( A , ( _place ( A ) , _loc ( A , B ) , _highest ( C , ( _state ( B ) , _loc ( C , B ) , _mountain ( C ) ) ) ) ) )
what is the population of the capital of iowa ?	_answer ( A , ( _population ( B , A ) , _capital ( B ) , _loc ( B , C ) , _const ( C , _stateid ( iowa ) ) ) )
where is the capital of rhode island ?	_answer ( A , ( _loc ( B , A ) , _capital ( B ) , _loc ( B , C ) , _const ( C , _stateid ( ' rhode island ' ) ) ) )
how many states have a city called the cities which are in mississippi ?	_answer ( A , _count ( B , ( _state ( B ) , _loc ( C , B ) , _city ( C ) , _loc ( C , D ) , _const ( D , _stateid ( mississippi ) ) ) , A ) )
what are the populations of states through which the the longest river that runs through a state that borders nebraska run ?	_answer ( A , ( _population ( B , A ) , _state ( B ) , _longest ( C , ( _river ( C ) , _traverse ( C , D ) , _state ( D ) , _next_to ( D , E ) , _const ( E , _stateid ( nebraska ) ) ) ) , _river ( C ) , _traverse ( C , B ) ) )
where is the major cities in rhode island ?	_answer ( A , ( _loc ( B , A ) , _major ( B ) , _city ( B ) , _loc ( B , C ) , _const ( C , _stateid ( ' rhode island ' ) ) ) )
what is the population of capital of louisiana ?	_answer ( A , ( _population ( B , A ) , _capital ( B ) , _loc ( B , C ) , _const ( C , _stateid ( louisiana ) ) ) )
what are the rivers in the state of state is sacramento ?	_answer ( A , ( _river ( A ) , _loc ( A , B ) , _state ( B ) , _loc ( C , B ) , _state ( B ) , _const ( C , _cityid ( sacramento , _ ) ) ) )
which state is the city capital of montana located in ?	_answer ( A , ( _state ( A ) , _city ( B ) , _capital ( B ) , _loc ( B , C ) , _const ( C , _stateid ( montana ) ) , _loc ( B , A ) ) )
how many people live in the major cities in kansas ?	_answer ( A , ( _population ( B , A ) , _major ( B ) , _city ( B ) , _loc ( B , C ) , _const ( C , _stateid ( kansas ) ) ) )
what is the smallest state that borders state is the city sacramento located in ?	_answer ( A , _smallest ( A , ( _state ( A ) , _next_to ( A , B ) , _state ( B ) , _city ( C ) , _const ( C , _cityid ( sacramento , _ ) ) , _loc ( C , B ) ) ) )
how long is the all the rivers in vermont ?	_answer ( A , ( _len ( B , A ) , _river ( B ) , _loc ( B , C ) , _const ( C , _stateid ( vermont ) ) ) )
give me the cities which are in state has the longest river ?	_answer ( A , ( _city ( A ) , _loc ( A , B ) , _longest ( C , ( _state ( B ) , _loc ( C , B ) , _river ( C ) ) ) ) )
what is the most populous city in the neighboring states for illinois ?	_answer ( B , _largest ( A , ( _population ( B , A ) , _city ( B ) , _loc ( B , C ) , _next_to ( C , D ) , _state ( C ) , _const ( D , _stateid ( illinois ) ) ) ) )
where is capitals are in the states that border georgia ?	_answer ( A , ( _loc ( B , A ) , _capital ( B ) , _loc ( B , C ) , _state ( C ) , _next_to ( C , D ) , _const ( D , _stateid ( georgia ) ) ) )
how long is the the rivers in the state of kansas ?	_answer ( A , ( _len ( B , A ) , _river ( B ) , _loc ( B , C ) , _state ( C ) , _const ( C , _stateid ( kansas ) ) ) )
what states have rivers named rivers are in north carolina ?	_answer ( A , ( _state ( A ) , _loc ( B , A ) , _river ( B ) , _loc ( B , C ) , _const ( C , _stateid ( ' north carolina ' ) ) ) )
what state that borders state has the highest peak in the country is the largest ?	_answer ( A , _largest ( A , ( _state ( A ) , _next_to ( A , B ) , _highest ( C , ( _state ( B ) , _loc ( C , B ) , _mountain ( C ) ) ) ) ) )
what is the highest mountain in state border pennsylvania ?	_answer ( A , _highest ( A , ( _mountain ( A ) , _loc ( A , B ) , _state ( B ) , _next_to ( B , C ) , _const ( C , _stateid ( pennsylvania ) ) ) ) )
how many states does state has highest elevation border ?	_answer ( A , _count ( B , ( _state ( B ) , _state ( C ) , _loc ( D , C ) , _highest ( D , _place ( D ) ) , _next_to ( C , B ) ) , A ) )
what are the high points of states surrounding state is the city austin located in ?	_answer ( A , ( _high_point ( B , A ) , _loc ( A , B ) , _state ( B ) , _next_to ( B , C ) , _state ( C ) , _city ( D ) , _const ( D , _cityid ( austin , _ ) ) , _loc ( D , C ) ) )
what is the population of capitals are in the states that border louisiana ?	_answer ( A , ( _population ( B , A ) , _capital ( B ) , _loc ( B , C ) , _state ( C ) , _next_to ( C , D ) , _const ( D , _stateid ( louisiana ) ) ) )
what is the smallest state that borders states border alabama ?	_answer ( A , _smallest ( A , ( _state ( A ) , _next_to ( A , B ) , _state ( B ) , _next_to ( B , C ) , _const ( C , _stateid ( alabama ) ) ) ) )
which states border states through which the the longest river in rhode island traverses ?	_answer ( A , ( _state ( A ) , _next_to ( A , B ) , _state ( B ) , _longest ( C , ( _river ( C ) , _loc ( C , D ) , _const ( D , _stateid ( ' rhode island ' ) ) ) ) , _traverse ( C , B ) ) )
what is the highest point in state does the highest point in usa exist ?	_answer ( A , _highest ( A , ( _place ( A ) , _loc ( A , B ) , _loc ( C , B ) , _state ( B ) , _highest ( C , ( _place ( C ) , _loc ( C , D ) , _const ( D , _countryid ( usa ) ) ) ) ) ) )
which state is the city the cities which are in arizona located in ?	_answer ( A , ( _state ( A ) , _city ( B ) , _city ( B ) , _loc ( B , C ) , _const ( C , _stateid ( arizona ) ) , _loc ( B , A ) ) )
could you tell me what is the highest point in the state of state is mount mckinley ?	_answer ( A , _highest ( A , ( _place ( A ) , _loc ( A , B ) , _state ( B ) , _loc ( C , B ) , _state ( B ) , _const ( C , _placeid ( ' mount mckinley ' ) ) ) ) )
what states have a city named michigan city has the largest population ?	_answer ( A , ( _state ( A ) , _loc ( B , A ) , _largest ( C , ( _const ( D , _stateid ( michigan ) ) , _city ( B ) , _loc ( B , D ) , _population ( B , C ) ) ) ) )
what states border the states through which the longest river runs ?	_answer ( A , ( _state ( A ) , _next_to ( A , B ) , _state ( B ) , _longest ( C , ( _river ( C ) , _traverse ( C , B ) ) ) ) )
how long is the all the rivers in hawaii ?	_answer ( A , ( _len ( B , A ) , _river ( B ) , _loc ( B , C ) , _const ( C , _stateid ( hawaii ) ) , _river ( B ) ) )
what is the highest mountain in state is the largest city in south carolina in ?	_answer ( A , _highest ( A , ( _mountain ( A ) , _loc ( A , B ) , _state ( B ) , _largest ( C , ( _city ( C ) , _loc ( C , D ) , _const ( D , _stateid ( ' south carolina ' ) ) ) ) , _loc ( C , B ) ) ) )
how long is the the rivers in the state of new york ?	_answer ( A , ( _len ( B , A ) , _river ( B ) , _loc ( B , C ) , _state ( C ) , _const ( C , _stateid ( ' new york ' ) ) , _river ( B ) ) )
which states border states through which the the biggest rivers in arizona traverses ?	_answer ( A , ( _state ( A ) , _next_to ( A , B ) , _state ( B ) , _longest ( C , ( _river ( C ) , _loc ( C , D ) , _const ( D , _stateid ( arizona ) ) ) ) , _traverse ( C , B ) ) )
how high is the highest point of state has the smallest population density ?	_answer ( A , ( _elevation ( B , A ) , _highest ( B , ( _place ( B ) , _loc ( B , C ) , _smallest ( D , ( _state ( C ) , _density ( C , D ) ) ) ) ) ) )
what is the longest river that runs through a state that borders states border alabama ?	_answer ( A , _longest ( A , ( _river ( A ) , _traverse ( A , B ) , _state ( B ) , _next_to ( B , C ) , _state ( C ) , _next_to ( C , D ) , _const ( D , _stateid ( alabama ) ) ) ) )
what is the highest point in state has the smallest population density ?	_answer ( A , _highest ( A , ( _place ( A ) , _loc ( A , B ) , _smallest ( C , ( _state ( B ) , _density ( B , C ) ) ) ) ) )
which states does the river flows through colorado run through ?	_answer ( A , ( _state ( A ) , _river ( B ) , _traverse ( B , C ) , _const ( C , _stateid ( colorado ) ) , _river ( B ) , _traverse ( B , A ) ) )
where is the capital of kansas ?	_answer ( A , ( _loc ( B , A ) , _capital ( B ) , _loc ( B , C ) , _const ( C , _stateid ( kansas ) ) ) )
where is the capital of maine ?	_answer ( A , ( _loc ( B , A ) , _capital ( B ) , _loc ( B , C ) , _const ( C , _stateid ( maine ) ) ) )
how many states have a city called the capital of florida ?	_answer ( A , _count ( B , ( _state ( B ) , _loc ( C , B ) , _capital ( C ) , _loc ( C , D ) , _const ( D , _stateid ( florida ) ) ) , A ) )
what is the biggest city in state is mount mckinley ?	_answer ( A , _largest ( A , ( _city ( A ) , _loc ( A , B ) , _loc ( C , B ) , _state ( B ) , _const ( C , _placeid ( ' mount mckinley ' ) ) ) ) )
what state that borders alabama is the largest city has the largest population ?	_answer ( A , _largest ( B , ( _largest ( C , ( _state ( C ) , _next_to ( C , D ) , _const ( D , _stateid ( alabama ) ) ) ) , _city ( A ) , _loc ( A , C ) , _population ( A , B ) ) ) )
which states does the the shortest river in the united states run through ?	_answer ( A , ( _state ( A ) , _shortest ( B , ( _river ( B ) , _loc ( B , C ) , _const ( C , _countryid ( usa ) ) ) ) , _river ( B ) , _traverse ( B , A ) ) )
which state is the city the major cities in delaware located in ?	_answer ( A , ( _state ( A ) , _city ( B ) , _major ( B ) , _city ( B ) , _loc ( B , C ) , _const ( C , _stateid ( delaware ) ) , _loc ( B , A ) ) )
what is the highest point in state has the shortest river ?	_answer ( A , _highest ( A , ( _place ( A ) , _loc ( A , B ) , _state ( B ) , _loc ( C , B ) , _shortest ( C , _river ( C ) ) ) ) )
what is the smallest state that borders state is the largest city in iowa in ?	_answer ( A , _smallest ( A , ( _state ( A ) , _next_to ( A , B ) , _state ( B ) , _largest ( C , ( _city ( C ) , _loc ( C , D ) , _const ( D , _stateid ( iowa ) ) ) ) , _loc ( C , B ) ) ) )
which states border states through which the the biggest rivers in texas traverses ?	_answer ( A , ( _state ( A ) , _next_to ( A , B ) , _state ( B ) , _longest ( C , ( _river ( C ) , _loc ( C , D ) , _const ( D , _stateid ( texas ) ) ) ) , _traverse ( C , B ) ) )
what is the lowest point of states have rivers named mississippi ?	_answer ( A , _lowest ( A , ( _place ( A ) , _loc ( A , B ) , _state ( B ) , _loc ( C , B ) , _const ( C , _riverid ( mississippi ) ) ) ) )
how many people live in illinois city has the largest population ?	_answer ( A , ( _population ( B , A ) , _largest ( C , ( _const ( D , _stateid ( illinois ) ) , _city ( B ) , _loc ( B , D ) , _population ( B , C ) ) ) ) )
what is the biggest city in the smallest state that borders michigan ?	_answer ( A , _largest ( A , ( _city ( A ) , _loc ( A , B ) , _smallest ( B , ( _state ( B ) , _next_to ( B , C ) , _const ( C , _stateid ( michigan ) ) ) ) ) ) )
where is the major cities in kansas ?	_answer ( A , ( _loc ( B , A ) , _major ( B ) , _city ( B ) , _loc ( B , C ) , _const ( C , _stateid ( kansas ) ) ) )
where is the biggest city in maine ?	_answer ( A , ( _loc ( B , A ) , _largest ( B , ( _city ( B ) , _loc ( B , C ) , _const ( C , _stateid ( maine ) ) ) ) ) )
what is the longest river that runs through a state that borders the neighboring states for oregon ?	_answer ( A , _longest ( A , ( _river ( A ) , _traverse ( A , B ) , _state ( B ) , _next_to ( B , C ) , _next_to ( C , D ) , _state ( C ) , _const ( D , _stateid ( oregon ) ) ) ) )
which states does the the biggest rivers in vermont run through ?	_answer ( A , ( _state ( A ) , _longest ( B , ( _river ( B ) , _loc ( B , C ) , _const ( C , _stateid ( vermont ) ) ) ) , _river ( B ) , _traverse ( B , A ) ) )
how long is the river runs through mississippi ?	_answer ( A , ( _len ( B , A ) , _river ( B ) , _traverse ( B , C ) , _const ( C , _stateid ( mississippi ) ) ) )
what is the size of state has the smallest population density ?	_answer ( A , ( _size ( B , A ) , _smallest ( C , ( _state ( B ) , _density ( B , C ) ) ) ) )
how long is the river runs through vermont ?	_answer ( A , ( _len ( B , A ) , _river ( B ) , _traverse ( B , C ) , _const ( C , _stateid ( vermont ) ) , _river ( B ) ) )
in which state is the major cities in florida ?	_answer ( A , ( _loc ( B , A ) , _state ( A ) , _major ( B ) , _city ( B ) , _loc ( B , C ) , _const ( C , _stateid ( florida ) ) ) )
what state that borders state is mount mckinley is the largest ?	_answer ( A , _largest ( A , ( _state ( A ) , _next_to ( A , B ) , _loc ( C , B ) , _state ( B ) , _const ( C , _placeid ( ' mount mckinley ' ) ) ) ) )
what is the population of states have a city named austin ?	_answer ( A , ( _population ( B , A ) , _state ( B ) , _loc ( C , B ) , _const ( C , _cityid ( austin , _ ) ) ) )
what states have a city named the biggest city in rhode island ?	_answer ( A , ( _state ( A ) , _loc ( B , A ) , _largest ( B , ( _city ( B ) , _loc ( B , C ) , _const ( C , _stateid ( ' rhode island ' ) ) ) ) ) )
what is the area of the biggest state in continental us ?	_answer ( A , ( _area ( B , A ) , _largest ( B , ( _state ( B ) , _loc ( B , C ) , _const ( C , _countryid ( usa ) ) ) ) ) )
how many citizens in states border north carolina ?	_answer ( A , ( _population ( B , A ) , _state ( B ) , _next_to ( B , C ) , _const ( C , _stateid ( ' north carolina ' ) ) ) )
where is the cities which are in hawaii ?	_answer ( A , ( _loc ( B , A ) , _city ( B ) , _loc ( B , C ) , _const ( C , _stateid ( hawaii ) ) ) )
what states have a city named the capital of new york ?	_answer ( A , ( _state ( A ) , _loc ( B , A ) , _capital ( B ) , _loc ( B , C ) , _const ( C , _stateid ( ' new york ' ) ) ) )
how many states have a city called the major cities in pennsylvania ?	_answer ( A , _count ( B , ( _state ( B ) , _loc ( C , B ) , _major ( C ) , _city ( C ) , _loc ( C , D ) , _const ( D , _stateid ( pennsylvania ) ) ) , A ) )
how long is the the longest river that runs through a state that borders illinois ?	_answer ( A , ( _len ( B , A ) , _longest ( B , ( _river ( B ) , _traverse ( B , C ) , _state ( C ) , _next_to ( C , D ) , _const ( D , _stateid ( illinois ) ) ) ) , _river ( B ) ) )
what are the neighboring states for the smallest state that borders illinois ?	_answer ( A , ( _next_to ( A , B ) , _state ( A ) , _smallest ( B , ( _state ( B ) , _next_to ( B , C ) , _const ( C , _stateid ( illinois ) ) ) ) ) )
which state is the largest city in state has the highest peak in the country in ?	_answer ( A , ( _state ( A ) , _largest ( B , ( _city ( B ) , _loc ( B , C ) , _highest ( D , ( _state ( C ) , _loc ( D , C ) , _mountain ( D ) ) ) ) ) , _loc ( B , A ) ) )
what rivers are in state that borders south carolina is the largest ?	_answer ( A , ( _river ( A ) , _loc ( A , B ) , _largest ( B , ( _state ( B ) , _next_to ( B , C ) , _const ( C , _stateid ( ' south carolina ' ) ) ) ) ) )
what is the area of the state with the lowest point ?	_answer ( A , ( _area ( B , A ) , _state ( B ) , _loc ( C , B ) , _lowest ( C , _place ( C ) ) ) )
what river runs through state has the largest population density ?	_answer ( A , ( _river ( A ) , _traverse ( A , B ) , _largest ( C , ( _state ( B ) , _density ( B , C ) ) ) ) )
what states have rivers named the shortest river ?	_answer ( A , ( _state ( A ) , _loc ( B , A ) , _shortest ( B , _river ( B ) ) ) )
how many people live in the major cities in utah ?	_answer ( A , ( _population ( B , A ) , _major ( B ) , _city ( B ) , _loc ( B , C ) , _const ( C , _stateid ( utah ) ) ) )
what states have rivers named river runs through texas ?	_answer ( A , ( _state ( A ) , _loc ( B , A ) , _river ( B ) , _traverse ( B , C ) , _const ( C , _stateid ( texas ) ) ) )
how long is the the rivers in the state of michigan ?	_answer ( A , ( _len ( B , A ) , _river ( B ) , _loc ( B , C ) , _state ( C ) , _const ( C , _stateid ( michigan ) ) , _river ( B ) ) )
which capitals are in the states that border state that borders vermont is the largest ?	_answer ( A , ( _capital ( A ) , _loc ( A , B ) , _state ( B ) , _next_to ( B , C ) , _largest ( C , ( _state ( C ) , _next_to ( C , D ) , _const ( D , _stateid ( vermont ) ) ) ) ) )
in which state is the biggest city in louisiana ?	_answer ( A , ( _loc ( B , A ) , _state ( A ) , _largest ( B , ( _city ( B ) , _loc ( B , C ) , _const ( C , _stateid ( louisiana ) ) ) ) ) )
what are the biggest rivers in state is the largest city in mississippi in ?	_answer ( A , _longest ( A , ( _river ( A ) , _loc ( A , B ) , _state ( B ) , _largest ( C , ( _city ( C ) , _loc ( C , D ) , _const ( D , _stateid ( mississippi ) ) ) ) , _loc ( C , B ) ) ) )
in which state is the capital of delaware ?	_answer ( A , ( _loc ( B , A ) , _state ( A ) , _capital ( B ) , _loc ( B , C ) , _const ( C , _stateid ( delaware ) ) ) )
how many major cities are in state has the longest river ?	_answer ( A , _count ( B , ( _major ( B ) , _city ( B ) , _loc ( B , C ) , _longest ( D , ( _state ( C ) , _loc ( D , C ) , _river ( D ) ) ) ) , A ) )
what is the most populous city in state has the highest peak in the country ?	_answer ( B , _largest ( A , ( _population ( B , A ) , _city ( B ) , _loc ( B , C ) , _highest ( D , ( _state ( C ) , _loc ( D , C ) , _mountain ( D ) ) ) ) ) )
what is the capital of state has the smallest population density ?	_answer ( A , ( _capital ( A ) , _loc ( A , B ) , _smallest ( C , ( _state ( B ) , _density ( B , C ) ) ) ) )
what states have rivers named river runs through rhode island ?	_answer ( A , ( _state ( A ) , _loc ( B , A ) , _river ( B ) , _traverse ( B , C ) , _const ( C , _stateid ( ' rhode island ' ) ) ) )
how high is the highest point of state has the longest river ?	_answer ( A , ( _elevation ( B , A ) , _highest ( B , ( _place ( B ) , _loc ( B , C ) , _longest ( D , ( _state ( C ) , _loc ( D , C ) , _river ( D ) ) ) ) ) ) )
how long is the river flows through iowa ?	_answer ( A , ( _len ( B , A ) , _river ( B ) , _traverse ( B , C ) , _const ( C , _stateid ( iowa ) ) ) )
what is the lowest point of states have a city named new orleans ?	_answer ( A , _lowest ( A , ( _place ( A ) , _loc ( A , B ) , _state ( B ) , _loc ( C , B ) , _const ( C , _cityid ( ' new orleans ' , _ ) ) ) ) )
how many people live in pennsylvania city has the largest population ?	_answer ( A , ( _population ( B , A ) , _largest ( C , ( _const ( D , _stateid ( pennsylvania ) ) , _city ( B ) , _loc ( B , D ) , _population ( B , C ) ) ) ) )
what is the longest river that runs through a state that borders the smallest state that borders alaska ?	_answer ( A , _longest ( A , ( _river ( A ) , _traverse ( A , B ) , _state ( B ) , _next_to ( B , C ) , _smallest ( C , ( _state ( C ) , _next_to ( C , D ) , _const ( D , _stateid ( alaska ) ) ) ) ) ) )
what state has the shortest river city has the largest population ?	_answer ( A , _largest ( B , ( _state ( C ) , _loc ( D , C ) , _shortest ( D , _river ( D ) ) , _city ( A ) , _loc ( A , C ) , _population ( A , B ) ) ) )
what are the populations of states through which the all the rivers in arizona run ?	_answer ( A , ( _population ( B , A ) , _state ( B ) , _river ( C ) , _loc ( C , D ) , _const ( D , _stateid ( arizona ) ) , _river ( C ) , _traverse ( C , B ) ) )
which states border states through which the rivers are in hawaii traverses ?	_answer ( A , ( _state ( A ) , _next_to ( A , B ) , _state ( B ) , _river ( C ) , _loc ( C , D ) , _const ( D , _stateid ( hawaii ) ) , _traverse ( C , B ) ) )
which state is the city the biggest city in arizona located in ?	_answer ( A , ( _state ( A ) , _city ( B ) , _largest ( B , ( _city ( B ) , _loc ( B , C ) , _const ( C , _stateid ( arizona ) ) ) ) , _loc ( B , A ) ) )
which state is the city capitals are in the states that border kentucky located in ?	_answer ( A , ( _state ( A ) , _city ( B ) , _capital ( B ) , _loc ( B , C ) , _state ( C ) , _next_to ( C , D ) , _const ( D , _stateid ( kentucky ) ) , _loc ( B , A ) ) )
what is the population of capital of texas ?	_answer ( A , ( _population ( B , A ) , _capital ( B ) , _loc ( B , C ) , _const ( C , _stateid ( texas ) ) ) )
what is the capital of state is the largest city in vermont in ?	_answer ( A , ( _capital ( A ) , _loc ( A , B ) , _state ( B ) , _largest ( C , ( _city ( C ) , _loc ( C , D ) , _const ( D , _stateid ( vermont ) ) ) ) , _loc ( C , B ) ) )
give me the cities which are in state is the city new orleans located in ?	_answer ( A , ( _city ( A ) , _loc ( A , B ) , _state ( B ) , _city ( C ) , _const ( C , _cityid ( ' new orleans ' , _ ) ) , _loc ( C , B ) ) )
what are the populations of states through which the river runs through montana run ?	_answer ( A , ( _population ( B , A ) , _state ( B ) , _river ( C ) , _traverse ( C , D ) , _const ( D , _stateid ( montana ) ) , _river ( C ) , _traverse ( C , B ) ) )
what states border states through which the mississippi river traverses city has the largest population ?	_answer ( A , _largest ( B , ( _state ( C ) , _next_to ( C , D ) , _state ( D ) , _const ( E , _riverid ( mississippi ) ) , _traverse ( E , D ) , _city ( A ) , _loc ( A , C ) , _population ( A , B ) ) ) )
how many people live in capitals are not major cities ?	_answer ( A , ( _population ( B , A ) , _capital ( B ) , \+ ( _major ( B ) , _city ( B ) ) ) )
what is the longest river in state has the smallest population density ?	_answer ( A , _longest ( A , ( _river ( A ) , _loc ( A , B ) , _smallest ( C , ( _state ( B ) , _density ( B , C ) ) ) ) ) )
which state border states border mississippi ?	_answer ( A , ( _state ( A ) , _next_to ( A , B ) , _state ( B ) , _next_to ( B , C ) , _const ( C , _stateid ( mississippi ) ) ) )
what states have a city named the capital of florida ?	_answer ( A , ( _state ( A ) , _loc ( B , A ) , _capital ( B ) , _loc ( B , C ) , _const ( C , _stateid ( florida ) ) ) )
what is the lowest point of state is the largest city in montana in ?	_answer ( A , _lowest ( A , ( _place ( A ) , _loc ( A , B ) , _state ( B ) , _largest ( C , ( _city ( C ) , _loc ( C , D ) , _const ( D , _stateid ( montana ) ) ) ) , _loc ( C , B ) ) ) )
what are the populations of states through which the the biggest rivers in new york run ?	_answer ( A , ( _population ( B , A ) , _state ( B ) , _longest ( C , ( _river ( C ) , _loc ( C , D ) , _const ( D , _stateid ( ' new york ' ) ) ) ) , _river ( C ) , _traverse ( C , B ) ) )
what is the biggest city in states does the mississippi run through ?	_answer ( A , _largest ( A , ( _city ( A ) , _loc ( A , B ) , _state ( B ) , _const ( C , _riverid ( mississippi ) ) , _river ( C ) , _traverse ( C , B ) ) ) )
how many states have a city called new york city has the largest population ?	_answer ( A , _count ( B , ( _state ( B ) , _loc ( C , B ) , _largest ( D , ( _const ( E , _stateid ( ' new york ' ) ) , _city ( C ) , _loc ( C , E ) , _population ( C , D ) ) ) ) , A ) )
where is capitals are not major cities ?	_answer ( A , ( _loc ( B , A ) , _capital ( B ) , \+ ( _major ( B ) , _city ( B ) ) ) )
what river runs through the neighboring states for pennsylvania ?	_answer ( A , ( _river ( A ) , _traverse ( A , B ) , _next_to ( B , C ) , _state ( B ) , _const ( C , _stateid ( pennsylvania ) ) ) )
name all the rivers in states have rivers named mississippi ?	_answer ( A , ( _river ( A ) , _loc ( A , B ) , _state ( B ) , _loc ( C , B ) , _const ( C , _riverid ( mississippi ) ) ) )
how many states does the smallest state that borders vermont border ?	_answer ( A , _count ( B , ( _state ( B ) , _smallest ( C , ( _state ( C ) , _next_to ( C , D ) , _const ( D , _stateid ( vermont ) ) ) ) , _next_to ( C , B ) ) , A ) )
where is the capital of colorado ?	_answer ( A , ( _loc ( B , A ) , _capital ( B ) , _loc ( B , C ) , _const ( C , _stateid ( colorado ) ) ) )
how long is the river runs through alabama ?	_answer ( A , ( _len ( B , A ) , _river ( B ) , _traverse ( B , C ) , _const ( C , _stateid ( alabama ) ) , _river ( B ) ) )
in which state is the cities which are in arizona ?	_answer ( A , ( _loc ( B , A ) , _state ( A ) , _city ( B ) , _loc ( B , C ) , _const ( C , _stateid ( arizona ) ) ) )
how many states have a city called the cities which are in kansas ?	_answer ( A , _count ( B , ( _state ( B ) , _loc ( C , B ) , _city ( C ) , _loc ( C , D ) , _const ( D , _stateid ( kansas ) ) ) , A ) )
how long is the the longest river in alabama ?	_answer ( A , ( _len ( B , A ) , _longest ( B , ( _river ( B ) , _loc ( B , C ) , _const ( C , _stateid ( alabama ) ) ) ) , _river ( B ) ) )
what is the smallest state that borders states border illinois ?	_answer ( A , _smallest ( A , ( _state ( A ) , _next_to ( A , B ) , _state ( B ) , _next_to ( B , C ) , _const ( C , _stateid ( illinois ) ) ) ) )
how long is the the longest river in tennessee ?	_answer ( A , ( _len ( B , A ) , _longest ( B , ( _river ( B ) , _loc ( B , C ) , _const ( C , _stateid ( tennessee ) ) ) ) ) )
how long is the river flows through maine ?	_answer ( A , ( _len ( B , A ) , _river ( B ) , _traverse ( B , C ) , _const ( C , _stateid ( maine ) ) ) )
what are the neighboring states for states border states through which the mississippi traverses ?	_answer ( A , ( _next_to ( A , B ) , _state ( A ) , _state ( B ) , _next_to ( B , C ) , _state ( C ) , _const ( D , _riverid ( mississippi ) ) , _traverse ( D , C ) ) )
how many states have a city called capitals are in the states that border colorado ?	_answer ( A , _count ( B , ( _state ( B ) , _loc ( C , B ) , _capital ( C ) , _loc ( C , D ) , _state ( D ) , _next_to ( D , E ) , _const ( E , _stateid ( colorado ) ) ) , A ) )
what are the high points of states surrounding state is the largest city in rhode island in ?	_answer ( A , ( _high_point ( B , A ) , _loc ( A , B ) , _state ( B ) , _next_to ( B , C ) , _state ( C ) , _largest ( D , ( _city ( D ) , _loc ( D , E ) , _const ( E , _stateid ( ' rhode island ' ) ) ) ) , _loc ( D , C ) ) )
what states have a city named capitals are not major cities ?	_answer ( A , ( _state ( A ) , _loc ( B , A ) , _capital ( B ) , \+ ( _major ( B ) , _city ( B ) ) ) )
which states border states through which the the biggest rivers in louisiana traverses ?	_answer ( A , ( _state ( A ) , _next_to ( A , B ) , _state ( B ) , _longest ( C , ( _river ( C ) , _loc ( C , D ) , _const ( D , _stateid ( louisiana ) ) ) ) , _traverse ( C , B ) ) )
which states border states does the mississippi run through ?	_answer ( A , ( _state ( A ) , _next_to ( A , B ) , _state ( B ) , _const ( C , _riverid ( mississippi ) ) , _river ( C ) , _traverse ( C , B ) ) )
which capitals are in the states that border state that borders rhode island is the largest ?	_answer ( A , ( _capital ( A ) , _loc ( A , B ) , _state ( B ) , _next_to ( B , C ) , _largest ( C , ( _state ( C ) , _next_to ( C , D ) , _const ( D , _stateid ( ' rhode island ' ) ) ) ) ) )
what are the high points of states surrounding states border states through which the mississippi traverses ?	_answer ( A , ( _high_point ( B , A ) , _loc ( A , B ) , _state ( B ) , _next_to ( B , C ) , _state ( C ) , _next_to ( C , D ) , _state ( D ) , _const ( E , _riverid ( mississippi ) ) , _traverse ( E , D ) ) )
what is the population of state has the smallest population density ?	_answer ( A , ( _population ( B , A ) , _smallest ( C , ( _state ( B ) , _density ( B , C ) ) ) ) )
what states have rivers named rivers are in illinois ?	_answer ( A , ( _state ( A ) , _loc ( B , A ) , _river ( B ) , _loc ( B , C ) , _const ( C , _stateid ( illinois ) ) ) )
how long is the river flows through north carolina ?	_answer ( A , ( _len ( B , A ) , _river ( B ) , _traverse ( B , C ) , _const ( C , _stateid ( ' north carolina ' ) ) ) )
what is the lowest point of the smallest state that borders north carolina ?	_answer ( A , _lowest ( A , ( _place ( A ) , _loc ( A , B ) , _smallest ( B , ( _state ( B ) , _next_to ( B , C ) , _const ( C , _stateid ( ' north carolina ' ) ) ) ) ) ) )
what is the highest mountain in state border vermont ?	_answer ( A , _highest ( A , ( _mountain ( A ) , _loc ( A , B ) , _state ( B ) , _next_to ( B , C ) , _const ( C , _stateid ( vermont ) ) ) ) )
what is the biggest city in state has the longest river ?	_answer ( A , _largest ( A , ( _city ( A ) , _loc ( A , B ) , _longest ( C , ( _state ( B ) , _loc ( C , B ) , _river ( C ) ) ) ) ) )
what states have rivers named the biggest rivers in montana ?	_answer ( A , ( _state ( A ) , _loc ( B , A ) , _longest ( B , ( _river ( B ) , _loc ( B , C ) , _const ( C , _stateid ( montana ) ) ) ) ) )
what are the neighboring states for states border pennsylvania ?	_answer ( A , ( _next_to ( A , B ) , _state ( A ) , _state ( B ) , _next_to ( B , C ) , _const ( C , _stateid ( pennsylvania ) ) ) )
what is the population of the capital of montana ?	_answer ( A , ( _population ( B , A ) , _capital ( B ) , _loc ( B , C ) , _const ( C , _stateid ( montana ) ) ) )
what is capital of state is the city new orleans located in ?	_answer ( A , ( _capital ( A ) , _loc ( A , B ) , _state ( B ) , _city ( C ) , _const ( C , _cityid ( ' new orleans ' , _ ) ) , _loc ( C , B ) ) )
what are the neighboring states for state is the city sacramento located in ?	_answer ( A , ( _next_to ( A , B ) , _state ( A ) , _state ( B ) , _city ( C ) , _const ( C , _cityid ( sacramento , _ ) ) , _loc ( C , B ) ) )
how many states does the neighboring states for nebraska border ?	_answer ( A , _count ( B , ( _state ( B ) , _next_to ( C , D ) , _state ( C ) , _const ( D , _stateid ( nebraska ) ) , _next_to ( C , B ) ) , A ) )
which states border states through which the river runs through montana traverses ?	_answer ( A , ( _state ( A ) , _next_to ( A , B ) , _state ( B ) , _river ( C ) , _traverse ( C , D ) , _const ( D , _stateid ( montana ) ) , _traverse ( C , B ) ) )
what states border state has the shortest river ?	_answer ( A , ( _state ( A ) , _next_to ( A , B ) , _state ( B ) , _loc ( C , B ) , _shortest ( C , _river ( C ) ) ) )
what are the biggest rivers in states border oregon ?	_answer ( A , _longest ( A , ( _river ( A ) , _loc ( A , B ) , _state ( B ) , _next_to ( B , C ) , _const ( C , _stateid ( oregon ) ) ) ) )
how many people live in vermont city has the largest population ?	_answer ( A , ( _population ( B , A ) , _largest ( C , ( _const ( D , _stateid ( vermont ) ) , _city ( B ) , _loc ( B , D ) , _population ( B , C ) ) ) ) )
what states have rivers named river runs through mississippi ?	_answer ( A , ( _state ( A ) , _loc ( B , A ) , _river ( B ) , _traverse ( B , C ) , _const ( C , _stateid ( mississippi ) ) ) )
what is the capital of state has the longest river ?	_answer ( A , ( _capital ( A ) , _loc ( A , B ) , _longest ( C , ( _state ( B ) , _loc ( C , B ) , _river ( C ) ) ) ) )
how long is the the longest river in colorado ?	_answer ( A , ( _len ( B , A ) , _longest ( B , ( _river ( B ) , _loc ( B , C ) , _const ( C , _stateid ( colorado ) ) ) ) , _river ( B ) ) )
how many people live in capitals are in the states that border iowa ?	_answer ( A , ( _population ( B , A ) , _capital ( B ) , _loc ( B , C ) , _state ( C ) , _next_to ( C , D ) , _const ( D , _stateid ( iowa ) ) ) )
what is the area of states have a city named san diego ?	_answer ( A , ( _area ( B , A ) , _state ( B ) , _loc ( C , B ) , _const ( C , _cityid ( ' san diego ' , _ ) ) ) )
what is the capital of state border illinois ?	_answer ( A , ( _capital ( A ) , _loc ( A , B ) , _state ( B ) , _next_to ( B , C ) , _const ( C , _stateid ( illinois ) ) ) )
which state is the city the cities which are in iowa located in ?	_answer ( A , ( _state ( A ) , _city ( B ) , _city ( B ) , _loc ( B , C ) , _const ( C , _stateid ( iowa ) ) , _loc ( B , A ) ) )
how many people live in capitals are in the states that border kansas ?	_answer ( A , ( _population ( B , A ) , _capital ( B ) , _loc ( B , C ) , _state ( C ) , _next_to ( C , D ) , _const ( D , _stateid ( kansas ) ) ) )
could you tell me what is the highest point in the state of the neighboring states for maine ?	_answer ( A , _highest ( A , ( _place ( A ) , _loc ( A , B ) , _state ( B ) , _next_to ( B , C ) , _state ( B ) , _const ( C , _stateid ( maine ) ) ) ) )
what are the biggest rivers in state is new orleans ?	_answer ( A , _longest ( A , ( _river ( A ) , _loc ( A , B ) , _loc ( C , B ) , _state ( B ) , _const ( C , _cityid ( ' new orleans ' , _ ) ) ) ) )
how high is the highest point of the biggest state in continental us ?	_answer ( A , ( _elevation ( B , A ) , _highest ( B , ( _place ( B ) , _loc ( B , C ) , _largest ( C , ( _state ( C ) , _loc ( C , D ) , _const ( D , _countryid ( usa ) ) ) ) ) ) ) )
how many states does state is atlanta border ?	_answer ( A , _count ( B , ( _state ( B ) , _loc ( D , C ) , _state ( C ) , _const ( D , _cityid ( atlanta , _ ) ) , _next_to ( C , B ) ) , A ) )
could you tell me what is the highest point in the state of states border alabama ?	_answer ( A , _highest ( A , ( _place ( A ) , _loc ( A , B ) , _state ( B ) , _state ( B ) , _next_to ( B , C ) , _const ( C , _stateid ( alabama ) ) ) ) )
what states have a city named capitals are in the states that border delaware ?	_answer ( A , ( _state ( A ) , _loc ( B , A ) , _capital ( B ) , _loc ( B , C ) , _state ( C ) , _next_to ( C , D ) , _const ( D , _stateid ( delaware ) ) ) )
which state is the city the capital of montana located in ?	_answer ( A , ( _state ( A ) , _city ( B ) , _capital ( B ) , _loc ( B , C ) , _const ( C , _stateid ( montana ) ) , _loc ( B , A ) ) )
what states have rivers named all the rivers in louisiana ?	_answer ( A , ( _state ( A ) , _loc ( B , A ) , _river ( B ) , _loc ( B , C ) , _const ( C , _stateid ( louisiana ) ) ) )
what are the biggest rivers in state is mount mckinley ?	_answer ( A , _longest ( A , ( _river ( A ) , _loc ( A , B ) , _loc ( C , B ) , _state ( B ) , _const ( C , _placeid ( ' mount mckinley ' ) ) ) ) )
what are the biggest rivers in the biggest state in continental us ?	_answer ( A , _longest ( A , ( _river ( A ) , _loc ( A , B ) , _largest ( B , ( _state ( B ) , _loc ( B , C ) , _const ( C , _countryid ( usa ) ) ) ) ) ) )
what is the area of states have rivers named mississippi ?	_answer ( A , ( _area ( B , A ) , _state ( B ) , _loc ( C , B ) , _const ( C , _riverid ( mississippi ) ) ) )
what is the population of the biggest city in colorado ?	_answer ( A , ( _population ( B , A ) , _largest ( B , ( _city ( B ) , _loc ( B , C ) , _const ( C , _stateid ( colorado ) ) ) ) ) )
which capitals are in the states that border the biggest state in continental us ?	_answer ( A , ( _capital ( A ) , _loc ( A , B ) , _state ( B ) , _next_to ( B , C ) , _largest ( C , ( _state ( C ) , _loc ( C , D ) , _const ( D , _countryid ( usa ) ) ) ) ) )
what are the neighboring states for the smallest state that borders kansas ?	_answer ( A , ( _next_to ( A , B ) , _state ( A ) , _smallest ( B , ( _state ( B ) , _next_to ( B , C ) , _const ( C , _stateid ( kansas ) ) ) ) ) )
in which state is the cities which are in georgia ?	_answer ( A , ( _loc ( B , A ) , _state ( A ) , _city ( B ) , _loc ( B , C ) , _const ( C , _stateid ( georgia ) ) ) )
what is capital of states border states through which the mississippi traverses ?	_answer ( A , ( _capital ( A ) , _loc ( A , B ) , _state ( B ) , _next_to ( B , C ) , _state ( C ) , _const ( D , _riverid ( mississippi ) ) , _traverse ( D , C ) ) )
how many citizens in the biggest state in continental us ?	_answer ( A , ( _population ( B , A ) , _largest ( B , ( _state ( B ) , _loc ( B , C ) , _const ( C , _countryid ( usa ) ) ) ) ) )
what is the biggest city in states border georgia ?	_answer ( A , _largest ( A , ( _city ( A ) , _loc ( A , B ) , _state ( B ) , _next_to ( B , C ) , _const ( C , _stateid ( georgia ) ) ) ) )
what is the lowest point of state has the largest population density ?	_answer ( A , _lowest ( A , ( _place ( A ) , _loc ( A , B ) , _largest ( C , ( _state ( B ) , _density ( B , C ) ) ) ) ) )
which states does the river flows through vermont run through ?	_answer ( A , ( _state ( A ) , _river ( B ) , _traverse ( B , C ) , _const ( C , _stateid ( vermont ) ) , _river ( B ) , _traverse ( B , A ) ) )
what is the lowest point in states border california ?	_answer ( A , _lowest ( A , ( _place ( A ) , _loc ( A , B ) , _state ( B ) , _next_to ( B , C ) , _const ( C , _stateid ( california ) ) ) ) )
what states border states border states through which the colorado traverses ?	_answer ( A , ( _state ( A ) , _next_to ( A , B ) , _state ( B ) , _next_to ( B , C ) , _state ( C ) , _const ( D , _riverid ( colorado ) ) , _traverse ( D , C ) ) )
where is the major cities in new york ?	_answer ( A , ( _loc ( B , A ) , _major ( B ) , _city ( B ) , _loc ( B , C ) , _const ( C , _stateid ( ' new york ' ) ) ) )
what is the population of the major cities in hawaii ?	_answer ( A , ( _population ( B , A ) , _major ( B ) , _city ( B ) , _loc ( B , C ) , _const ( C , _stateid ( hawaii ) ) ) )
what river flows through states does the longest river cross ?	_answer ( A , ( _river ( A ) , _traverse ( A , B ) , _state ( B ) , _longest ( C , _river ( C ) ) , _traverse ( C , B ) ) )
give me the cities which are in state is the city atlanta located in ?	_answer ( A , ( _city ( A ) , _loc ( A , B ) , _state ( B ) , _city ( C ) , _const ( C , _cityid ( atlanta , _ ) ) , _loc ( C , B ) ) )
how long is the river runs through kansas ?	_answer ( A , ( _len ( B , A ) , _river ( B ) , _traverse ( B , C ) , _const ( C , _stateid ( kansas ) ) , _river ( B ) ) )
how long is the rivers are in new york ?	_answer ( A , ( _len ( B , A ) , _river ( B ) , _loc ( B , C ) , _const ( C , _stateid ( ' new york ' ) ) ) )
what river flows through state is new orleans ?	_answer ( A , ( _river ( A ) , _traverse ( A , B ) , _loc ( C , B ) , _state ( B ) , _const ( C , _cityid ( ' new orleans ' , _ ) ) ) )
which states does the the rivers in the state of tennessee run through ?	_answer ( A , ( _state ( A ) , _river ( B ) , _loc ( B , C ) , _state ( C ) , _const ( C , _stateid ( tennessee ) ) , _river ( B ) , _traverse ( B , A ) ) )
which state is the city the cities which are in louisiana located in ?	_answer ( A , ( _state ( A ) , _city ( B ) , _city ( B ) , _loc ( B , C ) , _const ( C , _stateid ( louisiana ) ) , _loc ( B , A ) ) )
what is the most populous city in state has the smallest population density ?	_answer ( B , _largest ( A , ( _population ( B , A ) , _city ( B ) , _loc ( B , C ) , _smallest ( D , ( _state ( C ) , _density ( C , D ) ) ) ) ) )
what is the area of states border colorado ?	_answer ( A , ( _area ( B , A ) , _state ( B ) , _next_to ( B , C ) , _const ( C , _stateid ( colorado ) ) ) )
which states border states through which the the longest river in hawaii traverses ?	_answer ( A , ( _state ( A ) , _next_to ( A , B ) , _state ( B ) , _longest ( C , ( _river ( C ) , _loc ( C , D ) , _const ( D , _stateid ( hawaii ) ) ) ) , _traverse ( C , B ) ) )
what is the population of the capital of new york ?	_answer ( A , ( _population ( B , A ) , _capital ( B ) , _loc ( B , C ) , _const ( C , _stateid ( ' new york ' ) ) ) )
how many people live in the capital of new york ?	_answer ( A , ( _population ( B , A ) , _capital ( B ) , _loc ( B , C ) , _const ( C , _stateid ( ' new york ' ) ) ) )
what are the major cities in the neighboring states for alabama ?	_answer ( A , ( _major ( A ) , _city ( A ) , _loc ( A , B ) , _next_to ( B , C ) , _state ( B ) , _const ( C , _stateid ( alabama ) ) ) )
what states have rivers named the longest river in arizona ?	_answer ( A , ( _state ( A ) , _loc ( B , A ) , _longest ( B , ( _river ( B ) , _loc ( B , C ) , _const ( C , _stateid ( arizona ) ) ) ) ) )
what state is the city san diego located in city has the largest population ?	_answer ( A , _largest ( B , ( _state ( C ) , _city ( D ) , _const ( D , _cityid ( ' san diego ' , _ ) ) , _loc ( D , C ) , _city ( A ) , _loc ( A , C ) , _population ( A , B ) ) ) )
what the smallest state that borders alaska city has the largest population ?	_answer ( A , _largest ( B , ( _smallest ( C , ( _state ( C ) , _next_to ( C , D ) , _const ( D , _stateid ( alaska ) ) ) ) , _city ( A ) , _loc ( A , C ) , _population ( A , B ) ) ) )
in which state is the major cities in alabama ?	_answer ( A , ( _loc ( B , A ) , _state ( A ) , _major ( B ) , _city ( B ) , _loc ( B , C ) , _const ( C , _stateid ( alabama ) ) ) )
what is the population of the cities which are in texas ?	_answer ( A , ( _population ( B , A ) , _city ( B ) , _loc ( B , C ) , _const ( C , _stateid ( texas ) ) ) )
which state is the city the capital of new york located in ?	_answer ( A , ( _state ( A ) , _city ( B ) , _capital ( B ) , _loc ( B , C ) , _const ( C , _stateid ( ' new york ' ) ) , _loc ( B , A ) ) )
which states border states through which the river runs through colorado traverses ?	_answer ( A , ( _state ( A ) , _next_to ( A , B ) , _state ( B ) , _river ( C ) , _traverse ( C , D ) , _const ( D , _stateid ( colorado ) ) , _traverse ( C , B ) ) )
how many states have a city called capitals are in the states that border pennsylvania ?	_answer ( A , _count ( B , ( _state ( B ) , _loc ( C , B ) , _capital ( C ) , _loc ( C , D ) , _state ( D ) , _next_to ( D , E ) , _const ( E , _stateid ( pennsylvania ) ) ) , A ) )
what is the population of capitals are in the states that border kansas ?	_answer ( A , ( _population ( B , A ) , _capital ( B ) , _loc ( B , C ) , _state ( C ) , _next_to ( C , D ) , _const ( D , _stateid ( kansas ) ) ) )
what is the lowest point in state is the largest city in georgia in ?	_answer ( A , _lowest ( A , ( _place ( A ) , _loc ( A , B ) , _state ( B ) , _largest ( C , ( _city ( C ) , _loc ( C , D ) , _const ( D , _stateid ( georgia ) ) ) ) , _loc ( C , B ) ) ) )
where is capitals are in the states that border vermont ?	_answer ( A , ( _loc ( B , A ) , _capital ( B ) , _loc ( B , C ) , _state ( C ) , _next_to ( C , D ) , _const ( D , _stateid ( vermont ) ) ) )
give me the cities which are in state has the shortest river ?	_answer ( A , ( _city ( A ) , _loc ( A , B ) , _state ( B ) , _loc ( C , B ) , _shortest ( C , _river ( C ) ) ) )
name all the rivers in state has the longest river ?	_answer ( A , ( _river ( A ) , _loc ( A , B ) , _longest ( C , ( _state ( B ) , _loc ( C , B ) , _river ( C ) ) ) ) )
how many people live in the cities which are in florida ?	_answer ( A , ( _population ( B , A ) , _city ( B ) , _loc ( B , C ) , _const ( C , _stateid ( florida ) ) ) )
what is the most populous city in state is new orleans ?	_answer ( B , _largest ( A , ( _population ( B , A ) , _city ( B ) , _loc ( B , C ) , _loc ( D , C ) , _state ( C ) , _const ( D , _cityid ( ' new orleans ' , _ ) ) ) ) )
what is the population of the major cities in pennsylvania ?	_answer ( A , ( _population ( B , A ) , _major ( B ) , _city ( B ) , _loc ( B , C ) , _const ( C , _stateid ( pennsylvania ) ) ) )
which capitals are in the states that border state has the longest river ?	_answer ( A , ( _capital ( A ) , _loc ( A , B ) , _state ( B ) , _next_to ( B , C ) , _longest ( D , ( _state ( C ) , _loc ( D , C ) , _river ( D ) ) ) ) )
what states have a city named the capital of rhode island ?	_answer ( A , ( _state ( A ) , _loc ( B , A ) , _capital ( B ) , _loc ( B , C ) , _const ( C , _stateid ( ' rhode island ' ) ) ) )
where is the capital of hawaii ?	_answer ( A , ( _loc ( B , A ) , _capital ( B ) , _loc ( B , C ) , _const ( C , _stateid ( hawaii ) ) ) )
give me the cities which are in the neighboring states for rhode island ?	_answer ( A , ( _city ( A ) , _loc ( A , B ) , _next_to ( B , C ) , _state ( B ) , _const ( C , _stateid ( ' rhode island ' ) ) ) )
which state is the city the cities which are in georgia located in ?	_answer ( A , ( _state ( A ) , _city ( B ) , _city ( B ) , _loc ( B , C ) , _const ( C , _stateid ( georgia ) ) , _loc ( B , A ) ) )
what states have a city named the major cities in montana ?	_answer ( A , ( _state ( A ) , _loc ( B , A ) , _major ( B ) , _city ( B ) , _loc ( B , C ) , _const ( C , _stateid ( montana ) ) ) )
what rivers are in state has the shortest river ?	_answer ( A , ( _river ( A ) , _loc ( A , B ) , _state ( B ) , _loc ( C , B ) , _shortest ( C , _river ( C ) ) ) )
how long is the the rivers in the state of north carolina ?	_answer ( A , ( _len ( B , A ) , _river ( B ) , _loc ( B , C ) , _state ( C ) , _const ( C , _stateid ( ' north carolina ' ) ) , _river ( B ) ) )
give me the cities which are in state is mount mckinley ?	_answer ( A , ( _city ( A ) , _loc ( A , B ) , _loc ( C , B ) , _state ( B ) , _const ( C , _placeid ( ' mount mckinley ' ) ) ) )
how many states have a city called the major cities in alabama ?	_answer ( A , _count ( B , ( _state ( B ) , _loc ( C , B ) , _major ( C ) , _city ( C ) , _loc ( C , D ) , _const ( D , _stateid ( alabama ) ) ) , A ) )
what is the longest river in state that borders delaware is the largest ?	_answer ( A , _longest ( A , ( _river ( A ) , _loc ( A , B ) , _largest ( B , ( _state ( B ) , _next_to ( B , C ) , _const ( C , _stateid ( delaware ) ) ) ) ) ) )
what state that borders state is rochester is the largest ?	_answer ( A , _largest ( A , ( _state ( A ) , _next_to ( A , B ) , _loc ( C , B ) , _state ( B ) , _const ( C , _cityid ( rochester , _ ) ) ) ) )
how many states have a city called the cities which are in pennsylvania ?	_answer ( A , _count ( B , ( _state ( B ) , _loc ( C , B ) , _city ( C ) , _loc ( C , D ) , _const ( D , _stateid ( pennsylvania ) ) ) , A ) )
how many major cities are in state is mount mckinley ?	_answer ( A , _count ( B , ( _major ( B ) , _city ( B ) , _loc ( B , C ) , _loc ( D , C ) , _state ( C ) , _const ( D , _placeid ( ' mount mckinley ' ) ) ) , A ) )
where is the major cities in kentucky ?	_answer ( A , ( _loc ( B , A ) , _major ( B ) , _city ( B ) , _loc ( B , C ) , _const ( C , _stateid ( kentucky ) ) ) )
what states have rivers named all the rivers in new york ?	_answer ( A , ( _state ( A ) , _loc ( B , A ) , _river ( B ) , _loc ( B , C ) , _const ( C , _stateid ( ' new york ' ) ) ) )
how long is the the longest river that runs through a state that borders kansas ?	_answer ( A , ( _len ( B , A ) , _longest ( B , ( _river ( B ) , _traverse ( B , C ) , _state ( C ) , _next_to ( C , D ) , _const ( D , _stateid ( kansas ) ) ) ) ) )
