what is the highest point in florida ?	_answer ( A , _highest ( A , ( _place ( A ) , _loc ( A , B ) , _const ( B , _stateid ( florida ) ) ) ) )
what are the high points of states surrounding mississippi ?	_answer ( A , ( _high_point ( B , A ) , _loc ( A , B ) , _state ( B ) , _next_to ( B , C ) , _const ( C , _stateid ( mississippi ) ) ) )
what state has the shortest river ?	_answer ( A , ( _state ( A ) , _loc ( B , A ) , _shortest ( B , _river ( B ) ) ) )
what is the tallest mountain in the united states ?	_answer ( A , _highest ( A , ( _mountain ( A ) , _loc ( A , B ) , _const ( B , _countryid ( usa ) ) ) ) )
what is the capital of maine ?	_answer ( A , ( _capital ( A ) , _loc ( A , B ) , _const ( B , _stateid ( maine ) ) ) )
what are the populations of states through which the mississippi river run ?	_answer ( A , ( _population ( B , A ) , _state ( B ) , _const ( C , _riverid ( mississippi ) ) , _river ( C ) , _traverse ( C , B ) ) )
name all the lakes of us ?	_answer ( A , ( _lake ( A ) , _loc ( A , B ) , _const ( B , _countryid ( usa ) ) ) )
which states border states through which the mississippi traverses ?	_answer ( A , ( _state ( A ) , _next_to ( A , B ) , _state ( B ) , _const ( C , _riverid ( mississippi ) ) , _traverse ( C , B ) ) )
what is the highest mountain in alaska ?	_answer ( A , _highest ( A , ( _mountain ( A ) , _loc ( A , B ) , _const ( B , _stateid ( alaska ) ) ) ) )
what is the population of illinois ?	_answer ( A , ( _population ( B , A ) , _const ( B , _stateid ( illinois ) ) ) )
name all the rivers in colorado ?	_answer ( A , ( _river ( A ) , _loc ( A , B ) , _const ( B , _stateid ( colorado ) ) ) )
in which state does the highest point in usa exist ?	_answer ( A , ( _loc ( B , A ) , _state ( A ) , _highest ( B , ( _place ( B ) , _loc ( B , C ) , _const ( C , _countryid ( usa ) ) ) ) ) )
which state is the city denver located in ?	_answer ( A , ( _state ( A ) , _city ( B ) , _const ( B , _cityid ( denver , _ ) ) , _loc ( B , A ) ) )
what is the lowest point in texas ?	_answer ( A , _lowest ( A , ( _place ( A ) , _loc ( A , B ) , _const ( B , _stateid ( texas ) ) ) ) )
how many states have a city called rochester ?	_answer ( A , _count ( B , ( _state ( B ) , _loc ( C , B ) , _const ( C , _cityid ( rochester , _ ) ) ) , A ) )
which capitals are in the states that border texas ?	_answer ( A , ( _capital ( A ) , _loc ( A , B ) , _state ( B ) , _next_to ( B , C ) , _const ( C , _stateid ( texas ) ) ) )
how many people live in austin ?	_answer ( A , ( _population ( B , A ) , _const ( B , _cityid ( austin , _ ) ) ) )
what states have rivers named colorado ?	_answer ( A , ( _state ( A ) , _loc ( B , A ) , _const ( B , _riverid ( colorado ) ) ) )
what is the size of texas ?	_answer ( A , ( _size ( B , A ) , _const ( B , _stateid ( texas ) ) ) )
what is the shortest river in the usa ?	_answer ( A , _shortest ( A , ( _river ( A ) , _loc ( A , B ) , _const ( B , _countryid ( usa ) ) ) ) )
what are the major cities of the us ?	_answer ( A , ( _major ( A ) , _city ( A ) , _loc ( A , B ) , _const ( B , _countryid ( usa ) ) ) )
which state border kentucky ?	_answer ( A , ( _state ( A ) , _next_to ( A , B ) , _const ( B , _stateid ( kentucky ) ) ) )
what is the population of oregon ?	_answer ( A , ( _population ( B , A ) , _const ( B , _stateid ( oregon ) ) ) )
what states have a city named austin ?	_answer ( A , ( _state ( A ) , _loc ( B , A ) , _const ( B , _cityid ( austin , _ ) ) ) )
what is the highest elevation in south carolina ?	_answer ( A , _highest ( A , ( _place ( A ) , _loc ( A , B ) , _const ( B , _stateid ( ' south carolina ' ) ) ) ) )
how many people live in austin texas ?	_answer ( A , ( _population ( B , A ) , _const ( B , _cityid ( austin , tx ) ) ) )
what are the rivers in the state of texas ?	_answer ( A , ( _river ( A ) , _loc ( A , B ) , _state ( B ) , _const ( B , _stateid ( texas ) ) ) )
what is the lowest point of colorado ?	_answer ( A , _lowest ( A , ( _place ( A ) , _loc ( A , B ) , _const ( B , _stateid ( colorado ) ) ) ) )
what is the population of atlanta ?	_answer ( A , ( _population ( B , A ) , _const ( B , _cityid ( atlanta , _ ) ) ) )
what rivers are in utah ?	_answer ( A , ( _river ( A ) , _loc ( A , B ) , _const ( B , _stateid ( utah ) ) ) )
what river runs through the most states ?	_answer ( A , _most ( A , B , ( _river ( A ) , _traverse ( A , B ) , _state ( B ) ) ) )
what is the population of sacramento ?	_answer ( A , ( _population ( B , A ) , _const ( B , _cityid ( sacramento , _ ) ) ) )
could you tell me what is the highest point in the state of oregon ?	_answer ( A , _highest ( A , ( _place ( A ) , _loc ( A , B ) , _state ( B ) , _const ( B , _stateid ( oregon ) ) ) ) )
which states does the mississippi river run through ?	_answer ( A , ( _state ( A ) , _const ( B , _riverid ( mississippi ) ) , _river ( B ) , _traverse ( B , A ) ) )
what are the major cities in the smallest state in the us ?	_answer ( A , ( _major ( A ) , _city ( A ) , _loc ( A , B ) , _smallest ( B , ( _state ( B ) , _loc ( B , C ) , _const ( C , _countryid ( usa ) ) ) ) ) )
how high is guadalupe peak ?	_answer ( A , ( _elevation ( B , A ) , _const ( B , _placeid ( ' guadalupe peak ' ) ) ) )
what river runs through illinois ?	_answer ( A , ( _river ( A ) , _traverse ( A , B ) , _const ( B , _stateid ( illinois ) ) ) )
how long is the mississippi river ?	_answer ( A , ( _len ( B , A ) , _const ( B , _riverid ( mississippi ) ) , _river ( B ) ) )
how high is the highest point in the largest state ?	_answer ( A , ( _elevation ( B , A ) , _highest ( B , ( _place ( B ) , _loc ( B , C ) , _largest ( C , _state ( C ) ) ) ) ) )
what is the area of south carolina ?	_answer ( A , ( _area ( B , A ) , _const ( B , _stateid ( ' south carolina ' ) ) ) )
what are the states through which the longest river runs ?	_answer ( A , ( _state ( A ) , _longest ( B , ( _river ( B ) , _traverse ( B , A ) ) ) ) )
where is new orleans ?	_answer ( A , ( _loc ( B , A ) , _const ( B , _cityid ( ' new orleans ' , _ ) ) ) )
in what state is mount mckinley ?	_answer ( A , ( _loc ( B , A ) , _state ( A ) , _const ( B , _placeid ( ' mount mckinley ' ) ) ) )
what state has highest elevation ?	_answer ( A , ( _state ( A ) , _loc ( B , A ) , _highest ( B , _place ( B ) ) ) )
what is the size of california ?	_answer ( A , ( _size ( B , A ) , _const ( B , _stateid ( california ) ) ) )
what is the smallest state that borders texas ?	_answer ( A , _smallest ( A , ( _state ( A ) , _next_to ( A , B ) , _const ( B , _stateid ( texas ) ) ) ) )
how many citizens in alabama ?	_answer ( A , ( _population ( B , A ) , _const ( B , _stateid ( alabama ) ) ) )
in which state is rochester ?	_answer ( A , ( _loc ( B , A ) , _state ( A ) , _const ( B , _cityid ( rochester , _ ) ) ) )
how many states in the us does the shortest river run through ?	_answer ( A , _count ( B , ( _state ( B ) , _loc ( B , C ) , _const ( C , _countryid ( usa ) ) , _shortest ( D , _river ( D ) ) , _traverse ( D , B ) ) , A ) )
what is the biggest state in continental us ?	_answer ( A , _largest ( A , ( _state ( A ) , _loc ( A , B ) , _const ( B , _countryid ( usa ) ) ) ) )
what is the area of the largest state ?	_answer ( A , ( _area ( B , A ) , _largest ( B , _state ( B ) ) ) )
where is mount whitney ?	_answer ( A , ( _loc ( B , A ) , _const ( B , _placeid ( ' mount whitney ' ) ) ) )
how many states does iowa border ?	_answer ( A , _count ( B , ( _state ( B ) , _const ( C , _stateid ( iowa ) ) , _next_to ( C , B ) ) , A ) )
which states does the longest river cross ?	_answer ( A , ( _state ( A ) , _longest ( B , _river ( B ) ) , _traverse ( B , A ) ) )
what river flows through kansas ?	_answer ( A , ( _river ( A ) , _traverse ( A , B ) , _const ( B , _stateid ( kansas ) ) ) )
what is the population of austin texas ?	_answer ( A , ( _population ( B , A ) , _const ( B , _cityid ( austin , tx ) ) ) )
what is the capital of vermont ?	_answer ( A , ( _capital ( A ) , _loc ( A , B ) , _const ( B , _stateid ( vermont ) ) ) )
which states border colorado ?	_answer ( A , ( _state ( A ) , _next_to ( A , B ) , _const ( B , _stateid ( colorado ) ) ) )
how long is the mississippi ?	_answer ( A , ( _len ( B , A ) , _const ( B , _riverid ( mississippi ) ) ) )
what state has the largest population density ?	_answer ( A , _largest ( B , ( _state ( A ) , _density ( A , B ) ) ) )
what states border georgia ?	_answer ( A , ( _state ( A ) , _next_to ( A , B ) , _const ( B , _stateid ( georgia ) ) ) )
what is the capital of pennsylvania ?	_answer ( A , ( _capital ( A ) , _loc ( A , B ) , _const ( B , _stateid ( pennsylvania ) ) ) )
what are the biggest rivers in texas ?	_answer ( A , _longest ( A , ( _river ( A ) , _loc ( A , B ) , _const ( B , _stateid ( texas ) ) ) ) )
what is the longest river in the united states ?	_answer ( A , _longest ( A , ( _river ( A ) , _loc ( A , B ) , _const ( B , _countryid ( usa ) ) ) ) )
what is the capital of utah ?	_answer ( A , ( _capital ( A ) , _loc ( A , B ) , _const ( B , _stateid ( utah ) ) ) )
what state has the smallest population density ?	_answer ( A , _smallest ( B , ( _state ( A ) , _density ( A , B ) ) ) )
which capitals are not major cities ?	_answer ( A , ( _capital ( A ) , \+ ( _major ( A ) , _city ( A ) ) ) )
what is the biggest city in nebraska ?	_answer ( A , _largest ( A , ( _city ( A ) , _loc ( A , B ) , _const ( B , _stateid ( nebraska ) ) ) ) )
what is the population of texas ?	_answer ( A , ( _population ( B , A ) , _const ( B , _stateid ( texas ) ) ) )
what is the shortest river in the united states ?	_answer ( A , _shortest ( A , ( _river ( A ) , _loc ( A , B ) , _const ( B , _countryid ( usa ) ) ) ) )
what is the population of rhode island ?	_answer ( A , ( _population ( B , A ) , _const ( B , _stateid ( ' rhode island ' ) ) ) )
what is the state with the lowest point ?	_answer ( A , ( _state ( A ) , _loc ( B , A ) , _lowest ( B , _place ( B ) ) ) )
what is the longest river in new york ?	_answer ( A , _longest ( A , ( _river ( A ) , _loc ( A , B ) , _const ( B , _stateid ( ' new york ' ) ) ) ) )
what is the longest river that runs through a state that borders tennessee ?	_answer ( A , _longest ( A , ( _river ( A ) , _traverse ( A , B ) , _state ( B ) , _next_to ( B , C ) , _const ( C , _stateid ( tennessee ) ) ) ) )
how many major cities are in arizona ?	_answer ( A , _count ( B , ( _major ( B ) , _city ( B ) , _loc ( B , C ) , _const ( C , _stateid ( arizona ) ) ) , A ) )
what are the neighboring states for michigan ?	_answer ( A , ( _next_to ( A , B ) , _state ( A ) , _const ( B , _stateid ( michigan ) ) ) )
what state that borders texas is the largest ?	_answer ( A , _largest ( A , ( _state ( A ) , _next_to ( A , B ) , _const ( B , _stateid ( texas ) ) ) ) )
what is the shortest river ?	_answer ( A , _shortest ( A , _river ( A ) ) )
how many states border the state that borders the most states ?	_answer ( A , _count ( B , ( _state ( B ) , _next_to ( B , C ) , _most ( C , D , ( _state ( C ) , _next_to ( C , D ) , _state ( D ) ) ) ) , A ) )
which state is the largest city in montana in ?	_answer ( A , ( _state ( A ) , _largest ( B , ( _city ( B ) , _loc ( B , C ) , _const ( C , _stateid ( montana ) ) ) ) , _loc ( B , A ) ) )
what is the population of washington dc ?	_answer ( A , ( _population ( B , A ) , _const ( B , _cityid ( washington , dc ) ) ) )
what is the most populous city in texas ?	_answer ( B , _largest ( A , ( _population ( B , A ) , _city ( B ) , _loc ( B , C ) , _const ( C , _stateid ( texas ) ) ) ) )
what is the capital of hawaii ?	_answer ( A , ( _capital ( A ) , _loc ( A , B ) , _const ( B , _stateid ( hawaii ) ) ) )
what is capital of iowa ?	_answer ( A , ( _capital ( A ) , _loc ( A , B ) , _const ( B , _stateid ( iowa ) ) ) )
where is san diego ?	_answer ( A , ( _loc ( B , A ) , _const ( B , _cityid ( ' san diego ' , _ ) ) ) )
what are the major cities in delaware ?	_answer ( A , ( _major ( A ) , _city ( A ) , _loc ( A , B ) , _const ( B , _stateid ( delaware ) ) ) )
what is the lowest point in louisiana ?	_answer ( A , _lowest ( A , ( _place ( A ) , _loc ( A , B ) , _const ( B , _stateid ( louisiana ) ) ) ) )
which state has the highest peak in the country ?	_answer ( A , _highest ( B , ( _state ( A ) , _loc ( B , A ) , _mountain ( B ) ) ) )
what texas city has the largest population ?	_answer ( A , _largest ( B , ( _const ( C , _stateid ( texas ) ) , _city ( A ) , _loc ( A , C ) , _population ( A , B ) ) ) )
what capital is the largest in the us ?	_answer ( A , _largest ( A , ( _capital ( A ) , _loc ( A , B ) , _const ( B , _countryid ( usa ) ) ) ) )
what is the population of new york ?	_answer ( A , ( _population ( B , A ) , _const ( B , _stateid ( ' new york ' ) ) ) )
what is the population of the capital of the smallest state ?	_answer ( A , ( _population ( B , A ) , _capital ( B ) , _loc ( B , C ) , _smallest ( C , _state ( C ) ) ) )
what is the area of alaska ?	_answer ( A , ( _area ( B , A ) , _const ( B , _stateid ( alaska ) ) ) )
what is the population of california ?	_answer ( A , ( _population ( B , A ) , _const ( B , _stateid ( california ) ) ) )
which state has the longest river ?	_answer ( A , _longest ( B , ( _state ( A ) , _loc ( B , A ) , _river ( B ) ) ) )
what is the capital of texas ?	_answer ( A , ( _capital ( A ) , _loc ( A , B ) , _const ( B , _stateid ( texas ) ) ) )
give me the cities which are in texas ?	_answer ( A , ( _city ( A ) , _loc ( A , B ) , _const ( B , _stateid ( texas ) ) ) )
what states border kentucky ?	_answer ( A , ( _state ( A ) , _next_to ( A , B ) , _const ( B , _stateid ( kentucky ) ) ) )
how high is the highest point of florida ?	_answer ( A , ( _elevation ( B , A ) , _highest ( B , ( _place ( B ) , _loc ( B , C ) , _const ( C , _stateid ( florida ) ) ) ) ) )
what are the major cities in north carolina ?	_answer ( A , ( _major ( A ) , _city ( A ) , _loc ( A , B ) , _const ( B , _stateid ( ' north carolina ' ) ) ) )
what is the highest point in the state with capital des moines ?	_answer ( A , _highest ( A , ( _place ( A ) , _loc ( A , B ) , _state ( B ) , _loc ( C , B ) , _capital ( C ) , _const ( C , _cityid ( ' des moines ' , _ ) ) ) ) )
what is the lowest point in california ?	_answer ( A , _lowest ( A , ( _place ( A ) , _loc ( A , B ) , _const ( B , _stateid ( california ) ) ) ) )
what is the biggest city in wyoming ?	_answer ( A , _largest ( A , ( _city ( A ) , _loc ( A , B ) , _const ( B , _stateid ( wyoming ) ) ) ) )
what is the largest state bordering texas ?	_answer ( A , _largest ( A , ( _state ( A ) , _next_to ( A , B ) , _const ( B , _stateid ( texas ) ) ) ) )
what is the smallest city in hawaii ?	_answer ( A , _smallest ( A , ( _city ( A ) , _loc ( A , B ) , _const ( B , _stateid ( hawaii ) ) ) ) )
what is the area of the states ?	_answer ( A , ( _area ( B , A ) , _state ( B ) ) )
what is the area of idaho ?	_answer ( A , ( _area ( B , A ) , _const ( B , _stateid ( idaho ) ) ) )
what state has the most rivers running through it ?	_answer ( A , _most ( A , B , ( _state ( A ) , _loc ( B , A ) , _river ( B ) , _traverse ( B , A ) ) ) )
what is the population of springfield missouri ?	_answer ( A , ( _population ( B , A ) , _const ( B , _cityid ( springfield , mo ) ) ) )
what is the most populated state bordering oklahoma ?	_answer ( A , _largest ( B , ( _population ( A , B ) , _state ( A ) , _next_to ( A , C ) , _const ( C , _stateid ( oklahoma ) ) ) ) )
what is the number of neighboring states for kentucky ?	_answer ( A , _count ( B , ( _state ( B ) , _next_to ( B , C ) , _const ( C , _stateid ( kentucky ) ) ) , A ) )
what is the average population per square km in pennsylvania ?	_answer ( A , ( _density ( B , A ) , _const ( B , _stateid ( pennsylvania ) ) ) )
what state has the highest population density ?	_answer ( A , _largest ( B , ( _state ( A ) , _density ( A , B ) ) ) )
what is the tallest mountain in america ?	_answer ( A , _highest ( A , ( _mountain ( A ) , _loc ( A , B ) , _const ( B , _countryid ( usa ) ) ) ) )
what is the highest point of the state with the largest area ?	_answer ( A , _highest ( A , ( _place ( A ) , _loc ( A , B ) , _largest ( C , ( _state ( B ) , _area ( B , C ) ) ) ) ) )
what are the states ?	_answer ( A , _state ( A ) )
how many rivers in washington ?	_answer ( A , _count ( B , ( _river ( B ) , _loc ( B , C ) , _const ( C , _stateid ( washington ) ) ) , A ) )
what are the populations of the states through which the mississippi river run ?	_answer ( A , ( _population ( B , A ) , _state ( B ) , _const ( C , _riverid ( mississippi ) ) , _river ( C ) , _traverse ( C , B ) ) )
what is the biggest river in illinois ?	_answer ( A , _largest ( A , ( _river ( A ) , _loc ( A , B ) , _const ( B , _stateid ( illinois ) ) ) ) )
what is the capital of michigan ?	_answer ( A , ( _capital ( A ) , _loc ( A , B ) , _const ( B , _stateid ( michigan ) ) ) )
what is the total population of the states that border texas ?	_answer ( A , _sum ( C , ( _state ( C ) , _next_to ( D , C ) , _const ( D , _stateid ( texas ) ) ) , _population ( C ) , A ) )
what states border rhode island ?	_answer ( A , ( _state ( A ) , _next_to ( A , B ) , _const ( B , _stateid ( ' rhode island ' ) ) ) )
what is the biggest city in oregon ?	_answer ( A , _largest ( A , ( _city ( A ) , _loc ( A , B ) , _const ( B , _stateid ( oregon ) ) ) ) )
what is the lowest point in wisconsin ?	_answer ( A , _lowest ( A , ( _place ( A ) , _loc ( A , B ) , _const ( B , _stateid ( wisconsin ) ) ) ) )
what are the rivers in the state of indiana ?	_answer ( A , ( _river ( A ) , _loc ( A , B ) , _state ( B ) , _const ( B , _stateid ( indiana ) ) ) )
what is the population of austin ?	_answer ( A , ( _population ( B , A ) , _const ( B , _cityid ( austin , _ ) ) ) )
what is the smallest city in arkansas ?	_answer ( A , _smallest ( A , ( _city ( A ) , _loc ( A , B ) , _const ( B , _stateid ( arkansas ) ) ) ) )
give me the longest river that passes through the us ?	_answer ( A , _longest ( A , ( _river ( A ) , _traverse ( A , B ) , _const ( B , _countryid ( usa ) ) ) ) )
how long is the missouri river ?	_answer ( A , ( _len ( B , A ) , _const ( B , _riverid ( missouri ) ) , _river ( B ) ) )
which state has the largest city ?	_answer ( A , _largest ( B , ( _state ( A ) , _loc ( B , A ) , _city ( B ) ) ) )
what is the lowest elevation in pennsylvania ?	_answer ( A , _lowest ( A , ( _place ( A ) , _loc ( A , B ) , _const ( B , _stateid ( pennsylvania ) ) ) ) )
what is the longest river in the state with the highest point ?	_answer ( A , _longest ( A , ( _river ( A ) , _loc ( A , B ) , _state ( B ) , _loc ( C , B ) , _highest ( C , _place ( C ) ) ) ) )
what states does the colorado river run through ?	_answer ( A , ( _state ( A ) , _const ( B , _riverid ( colorado ) ) , _river ( B ) , _traverse ( B , A ) ) )
what are the states that the potomac run through ?	_answer ( A , ( _state ( A ) , _const ( B , _riverid ( potomac ) ) , _traverse ( B , A ) ) )
what is the biggest city in the usa ?	_answer ( A , _largest ( A , ( _city ( A ) , _loc ( A , B ) , _const ( B , _countryid ( usa ) ) ) ) )
what state has no rivers ?	_answer ( A , ( _state ( A ) , \+ ( _loc ( B , A ) , _river ( B ) ) ) )
what is the highest point in rhode island ?	_answer ( A , _highest ( A , ( _place ( A ) , _loc ( A , B ) , _const ( B , _stateid ( ' rhode island ' ) ) ) ) )
name the states which have no surrounding states ?	_answer ( A , ( _state ( A ) , \+ ( _next_to ( A , B ) , _state ( B ) ) ) )
what is the population of atlanta ga ?	_answer ( A , ( _population ( B , A ) , _const ( B , _cityid ( atlanta , _ ) ) ) )
how many square kilometers in the us ?	_answer ( A , ( _area ( B , A ) , _const ( B , _countryid ( usa ) ) ) )
what is the population of idaho ?	_answer ( A , ( _population ( B , A ) , _const ( B , _stateid ( idaho ) ) ) )
what is the adjacent state of california ?	_answer ( A , ( _next_to ( A , B ) , _state ( A ) , _const ( B , _stateid ( california ) ) ) )
what is the smallest state through which the longest river runs ?	_answer ( A , _smallest ( A , ( _state ( A ) , _longest ( B , _river ( B ) ) , _traverse ( B , A ) ) ) )
what are the names of the major cities in illinois ?	_answer ( A , ( _major ( A ) , _city ( A ) , _loc ( A , B ) , _const ( B , _stateid ( illinois ) ) ) )
how many states does the colorado river run through ?	_answer ( A , _count ( B , ( _state ( B ) , _const ( C , _riverid ( colorado ) ) , _river ( C ) , _traverse ( C , B ) ) , A ) )
how many states does the colorado river flow through ?	_answer ( A , _count ( B , ( _state ( B ) , _const ( C , _riverid ( colorado ) ) , _river ( C ) , _traverse ( C , B ) ) , A ) )
what are the major cities in kansas ?	_answer ( A , ( _major ( A ) , _city ( A ) , _loc ( A , B ) , _const ( B , _stateid ( kansas ) ) ) )
which states border texas ?	_answer ( A , ( _state ( A ) , _next_to ( A , B ) , _const ( B , _stateid ( texas ) ) ) )
how many people live in new york ?	_answer ( A , ( _population ( B , A ) , _const ( B , _stateid ( ' new york ' ) ) ) )
what are the largest cities in the states that border the largest state ?	_answer ( A , _largest ( A , ( _city ( A ) , _loc ( A , B ) , _state ( B ) , _next_to ( B , C ) , _largest ( C , _state ( C ) ) ) ) )
which states have points that are higher than the highest point in texas ?	_answer ( A , ( _state ( A ) , _place ( B ) , _loc ( B , A ) , _higher ( B , C ) , _highest ( C , ( _place ( C ) , _loc ( C , D ) , _const ( D , _stateid ( texas ) ) ) ) ) )
what is the river that cross over ohio ?	_answer ( A , ( _river ( A ) , _traverse ( A , B ) , _const ( B , _stateid ( ohio ) ) ) )
what is the largest city in michigan ?	_answer ( A , _largest ( A , ( _city ( A ) , _loc ( A , B ) , _const ( B , _stateid ( michigan ) ) ) ) )
how many rivers are in the state with the highest point ?	_answer ( A , _count ( B , ( _river ( B ) , _loc ( B , C ) , _state ( C ) , _loc ( D , C ) , _highest ( D , _place ( D ) ) ) , A ) )
what cities are located in pennsylvania ?	_answer ( A , ( _city ( A ) , _loc ( A , B ) , _const ( B , _stateid ( pennsylvania ) ) ) )
what is the state with the lowest population ?	_answer ( A , _smallest ( B , ( _state ( A ) , _population ( A , B ) ) ) )
what is the highest point in each state whose lowest point is sea level ?	_answer ( A , ( _high_point ( B , A ) , _state ( B ) , _low_point ( B , C ) , _elevation ( C , 0.0 ) ) )
give me the cities in usa ?	_answer ( A , ( _city ( A ) , _loc ( A , B ) , _const ( B , _countryid ( usa ) ) ) )
how many states does the missouri river run through ?	_answer ( A , _count ( B , ( _state ( B ) , _const ( C , _riverid ( missouri ) ) , _river ( C ) , _traverse ( C , B ) ) , A ) )
what state has the city with the largest population ?	_answer ( A , ( _state ( A ) , _loc ( B , A ) , _largest ( C , ( _city ( B ) , _population ( B , C ) ) ) ) )
which is the shortest river ?	_answer ( A , _shortest ( A , _river ( A ) ) )
how many states border alaska ?	_answer ( A , _count ( B , ( _state ( B ) , _next_to ( B , C ) , _const ( C , _stateid ( alaska ) ) ) , A ) )
what is the population of dallas ?	_answer ( A , ( _population ( B , A ) , _const ( B , _cityid ( dallas , _ ) ) ) )
where is san jose ?	_answer ( A , ( _loc ( B , A ) , _const ( B , _cityid ( ' san jose ' , _ ) ) ) )
what states border states that border colorado ?	_answer ( A , ( _state ( A ) , _next_to ( A , B ) , _state ( B ) , _next_to ( B , C ) , _const ( C , _stateid ( colorado ) ) ) )
what rivers flow through the state with the largest population ?	_answer ( A , ( _river ( A ) , _traverse ( A , B ) , _largest ( C , ( _state ( B ) , _population ( B , C ) ) ) ) )
whats the largest city ?	_answer ( A , _largest ( A , _city ( A ) ) )
what is the capital of the alabama state ?	_answer ( A , ( _capital ( A ) , _loc ( A , B ) , _const ( B , _stateid ( alabama ) ) , _state ( B ) ) )
what states border arkansas ?	_answer ( A , ( _state ( A ) , _next_to ( A , B ) , _const ( B , _stateid ( arkansas ) ) ) )
what is the population of denver ?	_answer ( A , ( _population ( B , A ) , _const ( B , _cityid ( denver , _ ) ) ) )
what is the longest river in america ?	_answer ( A , _longest ( A , ( _river ( A ) , _loc ( A , B ) , _const ( B , _countryid ( usa ) ) ) ) )
where is massachusetts ?	_answer ( A , ( _loc ( B , A ) , _const ( B , _stateid ( massachusetts ) ) ) )
what state has the smallest area ?	_answer ( A , _smallest ( B , ( _state ( A ) , _area ( A , B ) ) ) )
what major rivers run through illinois ?	_answer ( A , ( _major ( A ) , _river ( A ) , _traverse ( A , B ) , _const ( B , _stateid ( illinois ) ) ) )
how many cities does the usa have ?	_answer ( A , _count ( B , ( _city ( B ) , _const ( C , _countryid ( usa ) ) , _loc ( B , C ) ) , A ) )
how many people live in california ?	_answer ( A , ( _population ( B , A ) , _const ( B , _stateid ( california ) ) ) )
what are the major rivers in the us ?	_answer ( A , ( _major ( A ) , _river ( A ) , _loc ( A , B ) , _const ( B , _countryid ( usa ) ) ) )
how many states does the mississippi river run through ?	_answer ( A , _count ( B , ( _state ( B ) , _const ( C , _riverid ( mississippi ) ) , _river ( C ) , _traverse ( C , B ) ) , A ) )
what is the area of texas ?	_answer ( A , ( _area ( B , A ) , _const ( B , _stateid ( texas ) ) ) )
what is the length of the river that traverses the most states ?	_answer ( A , ( _len ( B , A ) , _most ( B , C , ( _river ( B ) , _traverse ( B , C ) , _state ( C ) ) ) ) )
what is the length of the longest river in the usa ?	_answer ( A , ( _len ( B , A ) , _longest ( B , ( _river ( B ) , _loc ( B , C ) , _const ( C , _countryid ( usa ) ) ) ) ) )
can you tell me the capital of texas ?	_answer ( A , ( _capital ( A ) , _loc ( A , B ) , _const ( B , _stateid ( texas ) ) ) )
what is the largest city in minnesota by population ?	_answer ( A , _largest ( B , ( _city ( A ) , _loc ( A , C ) , _const ( C , _stateid ( minnesota ) ) , _population ( A , B ) ) ) )
what is the smallest state in the usa ?	_answer ( A , _smallest ( A , ( _state ( A ) , _loc ( A , B ) , _const ( B , _countryid ( usa ) ) ) ) )
what states neighbor maine ?	_answer ( A , ( _state ( A ) , _next_to ( A , B ) , _const ( B , _stateid ( maine ) ) ) )
what states high point are higher than that of colorado ?	_answer ( A , ( _state ( A ) , _high_point ( A , B ) , _higher ( B , C ) , _high_point ( D , C ) , _const ( D , _stateid ( colorado ) ) ) )
what is the highest mountain in texas ?	_answer ( A , _highest ( A , ( _mountain ( A ) , _loc ( A , B ) , _const ( B , _stateid ( texas ) ) ) ) )
what are the major cities in texas ?	_answer ( A , ( _major ( A ) , _city ( A ) , _loc ( A , B ) , _const ( B , _stateid ( texas ) ) ) )
what are the states that border the state with the greatest population ?	_answer ( A , ( _state ( A ) , _next_to ( B , A ) , _largest ( C , ( _state ( B ) , _population ( B , C ) ) ) ) )
what rivers run through colorado ?	_answer ( A , ( _river ( A ) , _traverse ( A , B ) , _const ( B , _stateid ( colorado ) ) ) )
how many rivers are there in us ?	_answer ( A , _count ( B , ( _river ( B ) , _loc ( B , C ) , _const ( C , _countryid ( usa ) ) ) , A ) )
how many rivers are in new york ?	_answer ( A , _count ( B , ( _river ( B ) , _loc ( B , C ) , _const ( C , _stateid ( ' new york ' ) ) ) , A ) )
which rivers are in alaska ?	_answer ( A , ( _river ( A ) , _loc ( A , B ) , _const ( B , _stateid ( alaska ) ) ) )
what is the longest river flowing through new york ?	_answer ( A , _longest ( A , ( _river ( A ) , _traverse ( A , B ) , _const ( B , _stateid ( ' new york ' ) ) ) ) )
what rivers run through west virginia ?	_answer ( A , ( _river ( A ) , _traverse ( A , B ) , _const ( B , _stateid ( ' west virginia ' ) ) ) )
what are the capitals of the states that border texas ?	_answer ( A , ( _capital ( A ) , _loc ( A , B ) , _state ( B ) , _next_to ( B , C ) , _const ( C , _stateid ( texas ) ) ) )
what is the area of california ?	_answer ( A , ( _area ( B , A ) , _const ( B , _stateid ( california ) ) ) )
how many states have a city named springfield ?	_answer ( A , _count ( B , ( _state ( B ) , _loc ( C , B ) , _const ( C , _cityid ( springfield , _ ) ) ) , A ) )
what is the biggest city in texas ?	_answer ( A , _largest ( A , ( _city ( A ) , _loc ( A , B ) , _const ( B , _stateid ( texas ) ) ) ) )
how many cities named austin are there in the usa ?	_answer ( A , _count ( B , ( _city ( B ) , _const ( B , _cityid ( austin , _ ) ) , _loc ( B , C ) , _const ( C , _countryid ( usa ) ) ) , A ) )
what is the highest point in the state with capital the names of the major cities in new york ?	_answer ( A , _highest ( A , ( _place ( A ) , _loc ( A , B ) , _state ( B ) , _loc ( C , B ) , _capital ( C ) , _major ( C ) , _city ( C ) , _loc ( C , D ) , _const ( D , _stateid ( ' new york ' ) ) ) ) )
what states have rivers named rivers are in pennsylvania ?	_answer ( A , ( _state ( A ) , _loc ( B , A ) , _river ( B ) , _loc ( B , C ) , _const ( C , _stateid ( pennsylvania ) ) ) )
what river runs through states have a city named austin ?	_answer ( A , ( _river ( A ) , _traverse ( A , B ) , _state ( B ) , _loc ( C , B ) , _const ( C , _cityid ( austin , _ ) ) ) )
what are the neighboring states for state has the longest river ?	_answer ( A , ( _next_to ( A , B ) , _state ( A ) , _longest ( C , ( _state ( B ) , _loc ( C , B ) , _river ( C ) ) ) ) )
which state is the city the capital of ohio located in ?	_answer ( A , ( _state ( A ) , _city ( B ) , _capital ( B ) , _loc ( B , C ) , _const ( C , _stateid ( ohio ) ) , _loc ( B , A ) ) )
name all the rivers in states border kansas ?	_answer ( A , ( _river ( A ) , _loc ( A , B ) , _state ( B ) , _next_to ( B , C ) , _const ( C , _stateid ( kansas ) ) ) )
how many states does the rivers run through nebraska flow through ?	_answer ( A , _count ( B , ( _state ( B ) , _river ( C ) , _traverse ( C , D ) , _const ( D , _stateid ( nebraska ) ) , _river ( C ) , _traverse ( C , B ) ) , A ) )
how many cities named the capital of the rhode island state are there in the usa ?	_answer ( A , _count ( B , ( _city ( B ) , _capital ( B ) , _loc ( B , D ) , _const ( D , _stateid ( ' rhode island ' ) ) , _state ( D ) , _loc ( B , C ) , _const ( C , _countryid ( usa ) ) ) , A ) )
which states border state has the smallest area ?	_answer ( A , ( _state ( A ) , _next_to ( A , B ) , _smallest ( C , ( _state ( B ) , _area ( B , C ) ) ) ) )
which states border states through which the rivers run through idaho traverses ?	_answer ( A , ( _state ( A ) , _next_to ( A , B ) , _state ( B ) , _river ( C ) , _traverse ( C , D ) , _const ( D , _stateid ( idaho ) ) , _traverse ( C , B ) ) )
how many cities named the capital of louisiana are there in the usa ?	_answer ( A , _count ( B , ( _city ( B ) , _capital ( B ) , _loc ( B , D ) , _const ( D , _stateid ( louisiana ) ) , _loc ( B , C ) , _const ( C , _countryid ( usa ) ) ) , A ) )
what are the populations of the states through which the rivers run through georgia run ?	_answer ( A , ( _population ( B , A ) , _state ( B ) , _river ( C ) , _traverse ( C , D ) , _const ( D , _stateid ( georgia ) ) , _river ( C ) , _traverse ( C , B ) ) )
how long is the the longest river that runs through a state that borders wyoming ?	_answer ( A , ( _len ( B , A ) , _longest ( B , ( _river ( B ) , _traverse ( B , C ) , _state ( C ) , _next_to ( C , D ) , _const ( D , _stateid ( wyoming ) ) ) ) , _river ( B ) ) )
what is the population of delaware city has the largest population ga ?	_answer ( A , ( _population ( B , A ) , _largest ( C , ( _const ( D , _stateid ( delaware ) ) , _city ( B ) , _loc ( B , D ) , _population ( B , C ) ) ) ) )
what is the largest city in the states which have no surrounding states ?	_answer ( A , _largest ( A , ( _city ( A ) , _loc ( A , B ) , _state ( B ) , \+ ( _next_to ( B , C ) , _state ( C ) ) ) ) )
in which state is the smallest city in south carolina ?	_answer ( A , ( _loc ( B , A ) , _state ( A ) , _smallest ( B , ( _city ( B ) , _loc ( B , C ) , _const ( C , _stateid ( ' south carolina ' ) ) ) ) ) )
what are the populations of the states through which the river flows through wyoming run ?	_answer ( A , ( _population ( B , A ) , _state ( B ) , _river ( C ) , _traverse ( C , D ) , _const ( D , _stateid ( wyoming ) ) , _river ( C ) , _traverse ( C , B ) ) )
how many people live in the biggest state in continental us ?	_answer ( A , ( _population ( B , A ) , _largest ( B , ( _state ( B ) , _loc ( B , C ) , _const ( C , _countryid ( usa ) ) ) ) ) )
what the smallest state that borders delaware city has the largest population ?	_answer ( A , _largest ( B , ( _smallest ( C , ( _state ( C ) , _next_to ( C , D ) , _const ( D , _stateid ( delaware ) ) ) ) , _city ( A ) , _loc ( A , C ) , _population ( A , B ) ) ) )
what is the biggest river in the states ?	_answer ( A , _largest ( A , ( _river ( A ) , _loc ( A , B ) , _state ( B ) ) ) )
what river flows through the biggest state in continental us ?	_answer ( A , ( _river ( A ) , _traverse ( A , B ) , _largest ( B , ( _state ( B ) , _loc ( B , C ) , _const ( C , _countryid ( usa ) ) ) ) ) )
what states have a city named the major cities in new york ?	_answer ( A , ( _state ( A ) , _loc ( B , A ) , _major ( B ) , _city ( B ) , _loc ( B , C ) , _const ( C , _stateid ( ' new york ' ) ) ) )
what are the states that the the longest river flowing through colorado run through ?	_answer ( A , ( _state ( A ) , _longest ( B , ( _river ( B ) , _traverse ( B , C ) , _const ( C , _stateid ( colorado ) ) ) ) , _traverse ( B , A ) ) )
which states border states through which the the rivers in the state of nebraska traverses ?	_answer ( A , ( _state ( A ) , _next_to ( A , B ) , _state ( B ) , _river ( C ) , _loc ( C , D ) , _state ( D ) , _const ( D , _stateid ( nebraska ) ) , _traverse ( C , B ) ) )
what is the area of states border pennsylvania ?	_answer ( A , ( _area ( B , A ) , _state ( B ) , _next_to ( B , C ) , _const ( C , _stateid ( pennsylvania ) ) ) )
what states does the the biggest river in illinois run through ?	_answer ( A , ( _state ( A ) , _largest ( B , ( _river ( B ) , _loc ( B , C ) , _const ( C , _stateid ( illinois ) ) ) ) , _river ( B ) , _traverse ( B , A ) ) )
give me the cities which are in states does the potomac run through ?	_answer ( A , ( _city ( A ) , _loc ( A , B ) , _state ( B ) , _const ( C , _riverid ( potomac ) ) , _river ( C ) , _traverse ( C , B ) ) )
how many states does the all the rivers in arkansas flow through ?	_answer ( A , _count ( B , ( _state ( B ) , _river ( C ) , _loc ( C , D ) , _const ( D , _stateid ( arkansas ) ) , _river ( C ) , _traverse ( C , B ) ) , A ) )
what states have a city named the smallest city in mississippi ?	_answer ( A , ( _state ( A ) , _loc ( B , A ) , _smallest ( B , ( _city ( B ) , _loc ( B , C ) , _const ( C , _stateid ( mississippi ) ) ) ) ) )
how many states does the river flows through utah flow through ?	_answer ( A , _count ( B , ( _state ( B ) , _river ( C ) , _traverse ( C , D ) , _const ( D , _stateid ( utah ) ) , _river ( C ) , _traverse ( C , B ) ) , A ) )
what are the states that the the rivers in the state of north carolina run through ?	_answer ( A , ( _state ( A ) , _river ( B ) , _loc ( B , C ) , _state ( C ) , _const ( C , _stateid ( ' north carolina ' ) ) , _traverse ( B , A ) ) )
what are the states that the rivers run through georgia run through ?	_answer ( A , ( _state ( A ) , _river ( B ) , _traverse ( B , C ) , _const ( C , _stateid ( georgia ) ) , _traverse ( B , A ) ) )
which state is the largest city in the states that the mississippi river run through in ?	_answer ( A , ( _state ( A ) , _largest ( B , ( _city ( B ) , _loc ( B , C ) , _state ( C ) , _const ( D , _riverid ( mississippi ) ) , _traverse ( D , C ) ) ) , _loc ( B , A ) ) )
which states does the the rivers in the state of illinois run through ?	_answer ( A , ( _state ( A ) , _river ( B ) , _loc ( B , C ) , _state ( C ) , _const ( C , _stateid ( illinois ) ) , _river ( B ) , _traverse ( B , A ) ) )
how many states have a city named the smallest city in tennessee ?	_answer ( A , _count ( B , ( _state ( B ) , _loc ( C , B ) , _smallest ( C , ( _city ( C ) , _loc ( C , D ) , _const ( D , _stateid ( tennessee ) ) ) ) ) , A ) )
how many states does the the shortest river in the united states run through ?	_answer ( A , _count ( B , ( _state ( B ) , _shortest ( C , ( _river ( C ) , _loc ( C , D ) , _const ( D , _countryid ( usa ) ) ) ) , _river ( C ) , _traverse ( C , B ) ) , A ) )
how many cities named the biggest city in alabama are there in the usa ?	_answer ( A , _count ( B , ( _city ( B ) , _largest ( B , ( _city ( B ) , _loc ( B , D ) , _const ( D , _stateid ( alabama ) ) ) ) , _loc ( B , C ) , _const ( C , _countryid ( usa ) ) ) , A ) )
what is the population of the major cities in arkansas ga ?	_answer ( A , ( _population ( B , A ) , _major ( B ) , _city ( B ) , _loc ( B , C ) , _const ( C , _stateid ( arkansas ) ) ) )
can you tell me the capital of state has the highest peak in the country ?	_answer ( A , ( _capital ( A ) , _loc ( A , B ) , _highest ( C , ( _state ( B ) , _loc ( C , B ) , _mountain ( C ) ) ) ) )
how many states have a city called the biggest city in idaho ?	_answer ( A , _count ( B , ( _state ( B ) , _loc ( C , B ) , _largest ( C , ( _city ( C ) , _loc ( C , D ) , _const ( D , _stateid ( idaho ) ) ) ) ) , A ) )
how many states have a city named the largest city in alabama by population ?	_answer ( A , _count ( B , ( _state ( B ) , _loc ( C , B ) , _largest ( D , ( _city ( C ) , _loc ( C , E ) , _const ( E , _stateid ( alabama ) ) , _population ( C , D ) ) ) ) , A ) )
what are the capitals of the states that border state is san jose ?	_answer ( A , ( _capital ( A ) , _loc ( A , B ) , _state ( B ) , _next_to ( B , C ) , _loc ( D , C ) , _state ( C ) , _const ( D , _cityid ( ' san jose ' , _ ) ) ) )
how many states have a city called the names of the major cities in utah ?	_answer ( A , _count ( B , ( _state ( B ) , _loc ( C , B ) , _major ( C ) , _city ( C ) , _loc ( C , D ) , _const ( D , _stateid ( utah ) ) ) , A ) )
how many rivers are in the adjacent state of rhode island ?	_answer ( A , _count ( B , ( _river ( B ) , _loc ( B , C ) , _next_to ( C , D ) , _state ( C ) , _const ( D , _stateid ( ' rhode island ' ) ) ) , A ) )
how many states does the major rivers run through north carolina flow through ?	_answer ( A , _count ( B , ( _state ( B ) , _major ( C ) , _river ( C ) , _traverse ( C , D ) , _const ( D , _stateid ( ' north carolina ' ) ) , _river ( C ) , _traverse ( C , B ) ) , A ) )
what states have rivers named the longest river in the state with the highest point ?	_answer ( A , ( _state ( A ) , _loc ( B , A ) , _longest ( B , ( _river ( B ) , _loc ( B , C ) , _state ( C ) , _loc ( D , C ) , _highest ( D , _place ( D ) ) ) ) ) )
how many states does the the rivers in the state of vermont flow through ?	_answer ( A , _count ( B , ( _state ( B ) , _river ( C ) , _loc ( C , D ) , _state ( D ) , _const ( D , _stateid ( vermont ) ) , _river ( C ) , _traverse ( C , B ) ) , A ) )
what major rivers run through state has the largest city ?	_answer ( A , ( _major ( A ) , _river ( A ) , _traverse ( A , B ) , _largest ( C , ( _state ( B ) , _loc ( C , B ) , _city ( C ) ) ) ) )
what is the population of s the largest city ga ?	_answer ( A , ( _population ( B , A ) , _largest ( B , _city ( B ) ) ) )
what are the neighboring states for states border west virginia ?	_answer ( A , ( _next_to ( A , B ) , _state ( A ) , _state ( B ) , _next_to ( B , C ) , _const ( C , _stateid ( ' west virginia ' ) ) ) )
what is the biggest city in the smallest state through which the longest river runs ?	_answer ( A , _largest ( A , ( _city ( A ) , _loc ( A , B ) , _smallest ( B , ( _state ( B ) , _longest ( C , _river ( C ) ) , _traverse ( C , B ) ) ) ) ) )
what is the population of the largest city in south carolina by population ?	_answer ( A , ( _population ( B , A ) , _largest ( C , ( _city ( B ) , _loc ( B , D ) , _const ( D , _stateid ( ' south carolina ' ) ) , _population ( B , C ) ) ) ) )
how long is the the rivers in the state of florida ?	_answer ( A , ( _len ( B , A ) , _river ( B ) , _loc ( B , C ) , _state ( C ) , _const ( C , _stateid ( florida ) ) ) )
what rivers run through the states through which the longest river runs ?	_answer ( A , ( _river ( A ) , _traverse ( A , B ) , _state ( B ) , _longest ( C , ( _river ( C ) , _traverse ( C , B ) ) ) ) )
what states have a city named the major cities in arizona ?	_answer ( A , ( _state ( A ) , _loc ( B , A ) , _major ( B ) , _city ( B ) , _loc ( B , C ) , _const ( C , _stateid ( arizona ) ) ) )
in which state is the biggest city in oregon ?	_answer ( A , ( _loc ( B , A ) , _state ( A ) , _largest ( B , ( _city ( B ) , _loc ( B , C ) , _const ( C , _stateid ( oregon ) ) ) ) ) )
what the smallest state in the usa city has the largest population ?	_answer ( A , _largest ( B , ( _smallest ( C , ( _state ( C ) , _loc ( C , D ) , _const ( D , _countryid ( usa ) ) ) ) , _city ( A ) , _loc ( A , C ) , _population ( A , B ) ) ) )
how many states have a city named the cities which are in colorado ?	_answer ( A , _count ( B , ( _state ( B ) , _loc ( C , B ) , _city ( C ) , _loc ( C , D ) , _const ( D , _stateid ( colorado ) ) ) , A ) )
how many rivers in state is mount mckinley ?	_answer ( A , _count ( B , ( _river ( B ) , _loc ( B , C ) , _loc ( D , C ) , _state ( C ) , _const ( D , _placeid ( ' mount mckinley ' ) ) ) , A ) )
how many cities named the largest city in south carolina by population are there in the usa ?	_answer ( A , _count ( B , ( _city ( B ) , _largest ( D , ( _city ( B ) , _loc ( B , E ) , _const ( E , _stateid ( ' south carolina ' ) ) , _population ( B , D ) ) ) , _loc ( B , C ) , _const ( C , _countryid ( usa ) ) ) , A ) )
what is the biggest city in the states that the potomac run through ?	_answer ( A , _largest ( A , ( _city ( A ) , _loc ( A , B ) , _state ( B ) , _const ( C , _riverid ( potomac ) ) , _traverse ( C , B ) ) ) )
how long is the the longest river in wisconsin ?	_answer ( A , ( _len ( B , A ) , _longest ( B , ( _river ( B ) , _loc ( B , C ) , _const ( C , _stateid ( wisconsin ) ) ) ) , _river ( B ) ) )
what is the population of states have rivers named missouri river ?	_answer ( A , ( _population ( B , A ) , _state ( B ) , _loc ( C , B ) , _const ( C , _riverid ( missouri ) ) ) )
what are the states that the all the rivers in colorado run through ?	_answer ( A , ( _state ( A ) , _river ( B ) , _loc ( B , C ) , _const ( C , _stateid ( colorado ) ) , _traverse ( B , A ) ) )
what is the capital of the states border oklahoma state ?	_answer ( A , ( _capital ( A ) , _loc ( A , B ) , _state ( B ) , _next_to ( B , C ) , _const ( C , _stateid ( oklahoma ) ) , _state ( B ) ) )
what is the population of the major cities in maine ga ?	_answer ( A , ( _population ( B , A ) , _major ( B ) , _city ( B ) , _loc ( B , C ) , _const ( C , _stateid ( maine ) ) ) )
which states border states through which the the rivers in the state of oregon traverses ?	_answer ( A , ( _state ( A ) , _next_to ( A , B ) , _state ( B ) , _river ( C ) , _loc ( C , D ) , _state ( D ) , _const ( D , _stateid ( oregon ) ) , _traverse ( C , B ) ) )
how many states does the the longest river in america run through ?	_answer ( A , _count ( B , ( _state ( B ) , _longest ( C , ( _river ( C ) , _loc ( C , D ) , _const ( D , _countryid ( usa ) ) ) ) , _river ( C ) , _traverse ( C , B ) ) , A ) )
how long is the rivers are in michigan ?	_answer ( A , ( _len ( B , A ) , _river ( B ) , _loc ( B , C ) , _const ( C , _stateid ( michigan ) ) , _river ( B ) ) )
what is the highest point in the state with capital the capital of oregon ?	_answer ( A , _highest ( A , ( _place ( A ) , _loc ( A , B ) , _state ( B ) , _loc ( C , B ) , _capital ( C ) , _capital ( C ) , _loc ( C , D ) , _const ( D , _stateid ( oregon ) ) ) ) )
how long is the rivers flow through the state with the largest population ?	_answer ( A , ( _len ( B , A ) , _river ( B ) , _traverse ( B , C ) , _largest ( D , ( _state ( C ) , _population ( C , D ) ) ) , _river ( B ) ) )
which states does the rivers are in wyoming run through ?	_answer ( A , ( _state ( A ) , _river ( B ) , _loc ( B , C ) , _const ( C , _stateid ( wyoming ) ) , _river ( B ) , _traverse ( B , A ) ) )
in which state is the smallest city in montana ?	_answer ( A , ( _loc ( B , A ) , _state ( A ) , _smallest ( B , ( _city ( B ) , _loc ( B , C ) , _const ( C , _stateid ( montana ) ) ) ) ) )
where is the largest city in hawaii by population ?	_answer ( A , ( _loc ( B , A ) , _largest ( C , ( _city ( B ) , _loc ( B , D ) , _const ( D , _stateid ( hawaii ) ) , _population ( B , C ) ) ) ) )
how many states border the states ?	_answer ( A , _count ( B , ( _state ( B ) , _next_to ( B , C ) , _state ( C ) ) , A ) )
how many states have a city named capitals are in the states that border montana ?	_answer ( A , _count ( B , ( _state ( B ) , _loc ( C , B ) , _capital ( C ) , _loc ( C , D ) , _state ( D ) , _next_to ( D , E ) , _const ( E , _stateid ( montana ) ) ) , A ) )
how many people live in the largest city in south carolina by population ?	_answer ( A , ( _population ( B , A ) , _largest ( C , ( _city ( B ) , _loc ( B , D ) , _const ( D , _stateid ( ' south carolina ' ) ) , _population ( B , C ) ) ) ) )
how many states does the the longest river in the state with the highest point run through ?	_answer ( A , _count ( B , ( _state ( B ) , _longest ( C , ( _river ( C ) , _loc ( C , D ) , _state ( D ) , _loc ( E , D ) , _highest ( E , _place ( E ) ) ) ) , _river ( C ) , _traverse ( C , B ) ) , A ) )
what is the highest elevation in the smallest state in the usa ?	_answer ( A , _highest ( A , ( _place ( A ) , _loc ( A , B ) , _smallest ( B , ( _state ( B ) , _loc ( B , C ) , _const ( C , _countryid ( usa ) ) ) ) ) ) )
what is the largest city in state is the city denver located in by population ?	_answer ( A , _largest ( B , ( _city ( A ) , _loc ( A , C ) , _state ( C ) , _city ( D ) , _const ( D , _cityid ( denver , _ ) ) , _loc ( D , C ) , _population ( A , B ) ) ) )
how many major cities are in state has the most rivers running through it ?	_answer ( A , _count ( B , ( _major ( B ) , _city ( B ) , _loc ( B , C ) , _most ( C , D , ( _state ( C ) , _loc ( D , C ) , _river ( D ) , _traverse ( D , C ) ) ) ) , A ) )
how many people live in the capital of louisiana ?	_answer ( A , ( _population ( B , A ) , _capital ( B ) , _loc ( B , C ) , _const ( C , _stateid ( louisiana ) ) ) )
how many states does the the shortest river in the usa run through ?	_answer ( A , _count ( B , ( _state ( B ) , _shortest ( C , ( _river ( C ) , _loc ( C , D ) , _const ( D , _countryid ( usa ) ) ) ) , _river ( C ) , _traverse ( C , B ) ) , A ) )
what is the biggest city in states border colorado ?	_answer ( A , _largest ( A , ( _city ( A ) , _loc ( A , B ) , _state ( B ) , _next_to ( B , C ) , _const ( C , _stateid ( colorado ) ) ) ) )
which states does the the major rivers in the us run through ?	_answer ( A , ( _state ( A ) , _major ( B ) , _river ( B ) , _loc ( B , C ) , _const ( C , _countryid ( usa ) ) , _river ( B ) , _traverse ( B , A ) ) )
what are the populations of the states through which the the longest river flowing through massachusetts run ?	_answer ( A , ( _population ( B , A ) , _state ( B ) , _longest ( C , ( _river ( C ) , _traverse ( C , D ) , _const ( D , _stateid ( massachusetts ) ) ) ) , _river ( C ) , _traverse ( C , B ) ) )
in which state is the capital of ohio ?	_answer ( A , ( _loc ( B , A ) , _state ( A ) , _capital ( B ) , _loc ( B , C ) , _const ( C , _stateid ( ohio ) ) ) )
what are the populations of states through which the rivers run through california run ?	_answer ( A , ( _population ( B , A ) , _state ( B ) , _river ( C ) , _traverse ( C , D ) , _const ( D , _stateid ( california ) ) , _river ( C ) , _traverse ( C , B ) ) )
what is the smallest state that borders the adjacent state of idaho ?	_answer ( A , _smallest ( A , ( _state ( A ) , _next_to ( A , B ) , _next_to ( B , C ) , _state ( B ) , _const ( C , _stateid ( idaho ) ) ) ) )
how long is the rivers are in mississippi ?	_answer ( A , ( _len ( B , A ) , _river ( B ) , _loc ( B , C ) , _const ( C , _stateid ( mississippi ) ) ) )
how many states does the the longest river that runs through a state that borders maine flow through ?	_answer ( A , _count ( B , ( _state ( B ) , _longest ( C , ( _river ( C ) , _traverse ( C , D ) , _state ( D ) , _next_to ( D , E ) , _const ( E , _stateid ( maine ) ) ) ) , _river ( C ) , _traverse ( C , B ) ) , A ) )
what are the states that the rivers run through louisiana run through ?	_answer ( A , ( _state ( A ) , _river ( B ) , _traverse ( B , C ) , _const ( C , _stateid ( louisiana ) ) , _traverse ( B , A ) ) )
what are the populations of states through which the all the rivers in oklahoma run ?	_answer ( A , ( _population ( B , A ) , _state ( B ) , _river ( C ) , _loc ( C , D ) , _const ( D , _stateid ( oklahoma ) ) , _river ( C ) , _traverse ( C , B ) ) )
what are the rivers in the state of the smallest state that borders delaware ?	_answer ( A , ( _river ( A ) , _loc ( A , B ) , _state ( B ) , _smallest ( B , ( _state ( B ) , _next_to ( B , C ) , _const ( C , _stateid ( delaware ) ) ) ) ) )
how long is the the longest river that runs through a state that borders delaware ?	_answer ( A , ( _len ( B , A ) , _longest ( B , ( _river ( B ) , _traverse ( B , C ) , _state ( C ) , _next_to ( C , D ) , _const ( D , _stateid ( delaware ) ) ) ) , _river ( B ) ) )
what states does the rivers run through kansas run through ?	_answer ( A , ( _state ( A ) , _river ( B ) , _traverse ( B , C ) , _const ( C , _stateid ( kansas ) ) , _river ( B ) , _traverse ( B , A ) ) )
which states have points that are higher than the highest point in states does the missouri river run through ?	_answer ( A , ( _state ( A ) , _place ( B ) , _loc ( B , A ) , _higher ( B , C ) , _highest ( C , ( _place ( C ) , _loc ( C , D ) , _state ( D ) , _const ( E , _riverid ( missouri ) ) , _river ( E ) , _traverse ( E , D ) ) ) ) )
what is the lowest point in state is mount mckinley ?	_answer ( A , _lowest ( A , ( _place ( A ) , _loc ( A , B ) , _loc ( C , B ) , _state ( B ) , _const ( C , _placeid ( ' mount mckinley ' ) ) ) ) )
what cities are located in states border states that border massachusetts ?	_answer ( A , ( _city ( A ) , _loc ( A , B ) , _state ( B ) , _next_to ( B , C ) , _state ( C ) , _next_to ( C , D ) , _const ( D , _stateid ( massachusetts ) ) ) )
what is the highest point in the state with capital wisconsin city has the largest population ?	_answer ( A , _highest ( A , ( _place ( A ) , _loc ( A , B ) , _state ( B ) , _loc ( C , B ) , _capital ( C ) , _largest ( D , ( _const ( E , _stateid ( wisconsin ) ) , _city ( C ) , _loc ( C , E ) , _population ( C , D ) ) ) ) ) )
where is the cities in usa ?	_answer ( A , ( _loc ( B , A ) , _city ( B ) , _loc ( B , C ) , _const ( C , _countryid ( usa ) ) ) )
what is the total population of the states that border state is new orleans ?	_answer ( A , _sum ( C , ( _state ( C ) , _next_to ( D , C ) , _loc ( E , D ) , _state ( D ) , _const ( E , _cityid ( ' new orleans ' , _ ) ) ) , _population ( C ) , A ) )
what are the names of the major cities in the smallest state through which the longest river runs ?	_answer ( A , ( _major ( A ) , _city ( A ) , _loc ( A , B ) , _smallest ( B , ( _state ( B ) , _longest ( C , _river ( C ) ) , _traverse ( C , B ) ) ) ) )
give me the cities which are in state has the shortest river ?	_answer ( A , ( _city ( A ) , _loc ( A , B ) , _state ( B ) , _loc ( C , B ) , _shortest ( C , _river ( C ) ) ) )
what is the total population of the states that border states border montana ?	_answer ( A , _sum ( C , ( _state ( C ) , _next_to ( D , C ) , _state ( D ) , _next_to ( D , E ) , _const ( E , _stateid ( montana ) ) ) , _population ( C ) , A ) )
what is the average population per square km in states high point are higher than that of idaho ?	_answer ( A , ( _density ( B , A ) , _state ( B ) , _high_point ( B , C ) , _higher ( C , D ) , _high_point ( E , D ) , _const ( E , _stateid ( idaho ) ) ) )
what is the smallest city in the adjacent state of iowa ?	_answer ( A , _smallest ( A , ( _city ( A ) , _loc ( A , B ) , _next_to ( B , C ) , _state ( B ) , _const ( C , _stateid ( iowa ) ) ) ) )
what is the population of the largest cities in the states that border the largest state ?	_answer ( A , ( _population ( B , A ) , _largest ( B , ( _city ( B ) , _loc ( B , C ) , _state ( C ) , _next_to ( C , D ) , _largest ( D , _state ( D ) ) ) ) ) )
what are the major cities in the states ?	_answer ( A , ( _major ( A ) , _city ( A ) , _loc ( A , B ) , _state ( B ) ) )
what states does the the longest river in idaho run through ?	_answer ( A , ( _state ( A ) , _longest ( B , ( _river ( B ) , _loc ( B , C ) , _const ( C , _stateid ( idaho ) ) ) ) , _river ( B ) , _traverse ( B , A ) ) )
could you tell me what is the highest point in the state of state border rhode island ?	_answer ( A , _highest ( A , ( _place ( A ) , _loc ( A , B ) , _state ( B ) , _state ( B ) , _next_to ( B , C ) , _const ( C , _stateid ( ' rhode island ' ) ) ) ) )
what are the populations of states through which the the shortest river run ?	_answer ( A , ( _population ( B , A ) , _state ( B ) , _shortest ( C , _river ( C ) ) , _river ( C ) , _traverse ( C , B ) ) )
what is the population of the capitals of the states that border oregon ?	_answer ( A , ( _population ( B , A ) , _capital ( B ) , _loc ( B , C ) , _state ( C ) , _next_to ( C , D ) , _const ( D , _stateid ( oregon ) ) ) )
what cities are located in the smallest state in the usa ?	_answer ( A , ( _city ( A ) , _loc ( A , B ) , _smallest ( B , ( _state ( B ) , _loc ( B , C ) , _const ( C , _countryid ( usa ) ) ) ) ) )
what is the biggest river in state has the city with the largest population ?	_answer ( A , _largest ( A , ( _river ( A ) , _loc ( A , B ) , _state ( B ) , _loc ( C , B ) , _largest ( D , ( _city ( C ) , _population ( C , D ) ) ) ) ) )
which states border states through which the rivers run through california traverses ?	_answer ( A , ( _state ( A ) , _next_to ( A , B ) , _state ( B ) , _river ( C ) , _traverse ( C , D ) , _const ( D , _stateid ( california ) ) , _traverse ( C , B ) ) )
how many cities named the names of the major cities in nebraska are there in the usa ?	_answer ( A , _count ( B , ( _city ( B ) , _major ( B ) , _city ( B ) , _loc ( B , D ) , _const ( D , _stateid ( nebraska ) ) , _loc ( B , C ) , _const ( C , _countryid ( usa ) ) ) , A ) )
what is the highest point in the state with capital cities are located in north carolina ?	_answer ( A , _highest ( A , ( _place ( A ) , _loc ( A , B ) , _state ( B ) , _loc ( C , B ) , _capital ( C ) , _city ( C ) , _loc ( C , D ) , _const ( D , _stateid ( ' north carolina ' ) ) ) ) )
what is the population of the capital of south carolina ga ?	_answer ( A , ( _population ( B , A ) , _capital ( B ) , _loc ( B , C ) , _const ( C , _stateid ( ' south carolina ' ) ) ) )
what is the highest point in the state with capital the major cities in west virginia ?	_answer ( A , _highest ( A , ( _place ( A ) , _loc ( A , B ) , _state ( B ) , _loc ( C , B ) , _capital ( C ) , _major ( C ) , _city ( C ) , _loc ( C , D ) , _const ( D , _stateid ( ' west virginia ' ) ) ) ) )
what states have a city named capital of massachusetts ?	_answer ( A , ( _state ( A ) , _loc ( B , A ) , _capital ( B ) , _loc ( B , C ) , _const ( C , _stateid ( massachusetts ) ) ) )
how many states have a city named the major cities in indiana ?	_answer ( A , _count ( B , ( _state ( B ) , _loc ( C , B ) , _major ( C ) , _city ( C ) , _loc ( C , D ) , _const ( D , _stateid ( indiana ) ) ) , A ) )
what is the average population per square km in the smallest state through which the longest river runs ?	_answer ( A , ( _density ( B , A ) , _smallest ( B , ( _state ( B ) , _longest ( C , _river ( C ) ) , _traverse ( C , B ) ) ) ) )
where is the capital of the arizona state ?	_answer ( A , ( _loc ( B , A ) , _capital ( B ) , _loc ( B , C ) , _const ( C , _stateid ( arizona ) ) , _state ( C ) ) )
which state is the city the largest city in kansas by population located in ?	_answer ( A , ( _state ( A ) , _city ( B ) , _largest ( C , ( _city ( B ) , _loc ( B , D ) , _const ( D , _stateid ( kansas ) ) , _population ( B , C ) ) ) , _loc ( B , A ) ) )
what are the populations of the states through which the major rivers run through nebraska run ?	_answer ( A , ( _population ( B , A ) , _state ( B ) , _major ( C ) , _river ( C ) , _traverse ( C , D ) , _const ( D , _stateid ( nebraska ) ) , _river ( C ) , _traverse ( C , B ) ) )
how many cities named capitals are in the states that border oklahoma are there in the usa ?	_answer ( A , _count ( B , ( _city ( B ) , _capital ( B ) , _loc ( B , D ) , _state ( D ) , _next_to ( D , E ) , _const ( E , _stateid ( oklahoma ) ) , _loc ( B , C ) , _const ( C , _countryid ( usa ) ) ) , A ) )
what rivers run through states have points that are higher than the highest point in utah ?	_answer ( A , ( _river ( A ) , _traverse ( A , B ) , _state ( B ) , _place ( C ) , _loc ( C , B ) , _higher ( C , D ) , _highest ( D , ( _place ( D ) , _loc ( D , E ) , _const ( E , _stateid ( utah ) ) ) ) ) )
which states does the the longest river that runs through a state that borders ohio run through ?	_answer ( A , ( _state ( A ) , _longest ( B , ( _river ( B ) , _traverse ( B , C ) , _state ( C ) , _next_to ( C , D ) , _const ( D , _stateid ( ohio ) ) ) ) , _river ( B ) , _traverse ( B , A ) ) )
what is the highest point in the state with capital the capital of west virginia ?	_answer ( A , _highest ( A , ( _place ( A ) , _loc ( A , B ) , _state ( B ) , _loc ( C , B ) , _capital ( C ) , _capital ( C ) , _loc ( C , D ) , _const ( D , _stateid ( ' west virginia ' ) ) ) ) )
which states does the the longest river flowing through arkansas run through ?	_answer ( A , ( _state ( A ) , _longest ( B , ( _river ( B ) , _traverse ( B , C ) , _const ( C , _stateid ( arkansas ) ) ) ) , _river ( B ) , _traverse ( B , A ) ) )
what is the population of the cities which are in indiana ga ?	_answer ( A , ( _population ( B , A ) , _city ( B ) , _loc ( B , C ) , _const ( C , _stateid ( indiana ) ) ) )
which state is the city the capital of the oregon state located in ?	_answer ( A , ( _state ( A ) , _city ( B ) , _capital ( B ) , _loc ( B , C ) , _const ( C , _stateid ( oregon ) ) , _state ( C ) , _loc ( B , A ) ) )
how many cities named the smallest city in vermont are there in the usa ?	_answer ( A , _count ( B , ( _city ( B ) , _smallest ( B , ( _city ( B ) , _loc ( B , D ) , _const ( D , _stateid ( vermont ) ) ) ) , _loc ( B , C ) , _const ( C , _countryid ( usa ) ) ) , A ) )
what is the lowest elevation in states have rivers named potomac ?	_answer ( A , _lowest ( A , ( _place ( A ) , _loc ( A , B ) , _state ( B ) , _loc ( C , B ) , _const ( C , _riverid ( potomac ) ) ) ) )
how many states have a city named cities are located in georgia ?	_answer ( A , _count ( B , ( _state ( B ) , _loc ( C , B ) , _city ( C ) , _loc ( C , D ) , _const ( D , _stateid ( georgia ) ) ) , A ) )
how many states have a city named the capital of texas ?	_answer ( A , _count ( B , ( _state ( B ) , _loc ( C , B ) , _capital ( C ) , _loc ( C , D ) , _const ( D , _stateid ( texas ) ) ) , A ) )
how many states have a city called the biggest city in michigan ?	_answer ( A , _count ( B , ( _state ( B ) , _loc ( C , B ) , _largest ( C , ( _city ( C ) , _loc ( C , D ) , _const ( D , _stateid ( michigan ) ) ) ) ) , A ) )
what is the population of the smallest city in wisconsin ?	_answer ( A , ( _population ( B , A ) , _smallest ( B , ( _city ( B ) , _loc ( B , C ) , _const ( C , _stateid ( wisconsin ) ) ) ) ) )
what states does the all the rivers in arkansas run through ?	_answer ( A , ( _state ( A ) , _river ( B ) , _loc ( B , C ) , _const ( C , _stateid ( arkansas ) ) , _river ( B ) , _traverse ( B , A ) ) )
which state border states border ohio ?	_answer ( A , ( _state ( A ) , _next_to ( A , B ) , _state ( B ) , _next_to ( B , C ) , _const ( C , _stateid ( ohio ) ) ) )
what is the river that cross over the biggest state in continental us ?	_answer ( A , ( _river ( A ) , _traverse ( A , B ) , _largest ( B , ( _state ( B ) , _loc ( B , C ) , _const ( C , _countryid ( usa ) ) ) ) ) )
how many rivers in the state with the lowest population ?	_answer ( A , _count ( B , ( _river ( B ) , _loc ( B , C ) , _smallest ( D , ( _state ( C ) , _population ( C , D ) ) ) ) , A ) )
what is the most populated state bordering the state with the lowest population ?	_answer ( A , _largest ( B , ( _population ( A , B ) , _state ( A ) , _next_to ( A , C ) , _smallest ( D , ( _state ( C ) , _population ( C , D ) ) ) ) ) )
how many rivers are in the state with the lowest population ?	_answer ( A , _count ( B , ( _river ( B ) , _loc ( B , C ) , _smallest ( D , ( _state ( C ) , _population ( C , D ) ) ) ) , A ) )
what is the population of the cities which are in iowa ?	_answer ( A , ( _population ( B , A ) , _city ( B ) , _loc ( B , C ) , _const ( C , _stateid ( iowa ) ) ) )
what states border states have rivers named missouri river ?	_answer ( A , ( _state ( A ) , _next_to ( A , B ) , _state ( B ) , _loc ( C , B ) , _const ( C , _riverid ( missouri ) ) ) )
what is the longest river that runs through a state that borders state has highest elevation ?	_answer ( A , _longest ( A , ( _river ( A ) , _traverse ( A , B ) , _state ( B ) , _next_to ( B , C ) , _state ( C ) , _loc ( D , C ) , _highest ( D , _place ( D ) ) ) ) )
what states have a city named cities are located in mississippi ?	_answer ( A , ( _state ( A ) , _loc ( B , A ) , _city ( B ) , _loc ( B , C ) , _const ( C , _stateid ( mississippi ) ) ) )
what is the capital of the largest state bordering massachusetts ?	_answer ( A , ( _capital ( A ) , _loc ( A , B ) , _largest ( B , ( _state ( B ) , _next_to ( B , C ) , _const ( C , _stateid ( massachusetts ) ) ) ) ) )
how long is the all the rivers in west virginia ?	_answer ( A , ( _len ( B , A ) , _river ( B ) , _loc ( B , C ) , _const ( C , _stateid ( ' west virginia ' ) ) , _river ( B ) ) )
what is the highest point in the state with capital the cities in usa ?	_answer ( A , _highest ( A , ( _place ( A ) , _loc ( A , B ) , _state ( B ) , _loc ( C , B ) , _capital ( C ) , _city ( C ) , _loc ( C , D ) , _const ( D , _countryid ( usa ) ) ) ) )
what are the populations of the states through which the the major rivers in the us run ?	_answer ( A , ( _population ( B , A ) , _state ( B ) , _major ( C ) , _river ( C ) , _loc ( C , D ) , _const ( D , _countryid ( usa ) ) , _river ( C ) , _traverse ( C , B ) ) )
which state border the states ?	_answer ( A , ( _state ( A ) , _next_to ( A , B ) , _state ( B ) ) )
how many people live in michigan city has the largest population ?	_answer ( A , ( _population ( B , A ) , _largest ( C , ( _const ( D , _stateid ( michigan ) ) , _city ( B ) , _loc ( B , D ) , _population ( B , C ) ) ) ) )
what is the area of states have a city named new orleans ?	_answer ( A , ( _area ( B , A ) , _state ( B ) , _loc ( C , B ) , _const ( C , _cityid ( ' new orleans ' , _ ) ) ) )
how long is the the river that cross over wisconsin ?	_answer ( A , ( _len ( B , A ) , _river ( B ) , _traverse ( B , C ) , _const ( C , _stateid ( wisconsin ) ) ) )
how many rivers are in the largest state bordering kentucky ?	_answer ( A , _count ( B , ( _river ( B ) , _loc ( B , C ) , _largest ( C , ( _state ( C ) , _next_to ( C , D ) , _const ( D , _stateid ( kentucky ) ) ) ) ) , A ) )
what are the neighboring states for state is the city denver located in ?	_answer ( A , ( _next_to ( A , B ) , _state ( A ) , _state ( B ) , _city ( C ) , _const ( C , _cityid ( denver , _ ) ) , _loc ( C , B ) ) )
give me the cities which are in states does the missouri river run through ?	_answer ( A , ( _city ( A ) , _loc ( A , B ) , _state ( B ) , _const ( C , _riverid ( missouri ) ) , _river ( C ) , _traverse ( C , B ) ) )
how many states have a city called the biggest city in utah ?	_answer ( A , _count ( B , ( _state ( B ) , _loc ( C , B ) , _largest ( C , ( _city ( C ) , _loc ( C , D ) , _const ( D , _stateid ( utah ) ) ) ) ) , A ) )
what is the highest point in the state with capital the capital of the alaska state ?	_answer ( A , _highest ( A , ( _place ( A ) , _loc ( A , B ) , _state ( B ) , _loc ( C , B ) , _capital ( C ) , _capital ( C ) , _loc ( C , D ) , _const ( D , _stateid ( alaska ) ) , _state ( D ) ) ) )
where is the capital of louisiana ?	_answer ( A , ( _loc ( B , A ) , _capital ( B ) , _loc ( B , C ) , _const ( C , _stateid ( louisiana ) ) ) )
what is capital of states border arizona ?	_answer ( A , ( _capital ( A ) , _loc ( A , B ) , _state ( B ) , _next_to ( B , C ) , _const ( C , _stateid ( arizona ) ) ) )
what are the populations of the states through which the the rivers in the state of oregon run ?	_answer ( A , ( _population ( B , A ) , _state ( B ) , _river ( C ) , _loc ( C , D ) , _state ( D ) , _const ( D , _stateid ( oregon ) ) , _river ( C ) , _traverse ( C , B ) ) )
which state is the city the major cities in iowa located in ?	_answer ( A , ( _state ( A ) , _city ( B ) , _major ( B ) , _city ( B ) , _loc ( B , C ) , _const ( C , _stateid ( iowa ) ) , _loc ( B , A ) ) )
what states does the the shortest river run through ?	_answer ( A , ( _state ( A ) , _shortest ( B , _river ( B ) ) , _river ( B ) , _traverse ( B , A ) ) )
could you tell me what is the highest point in the state of states have rivers named colorado ?	_answer ( A , _highest ( A , ( _place ( A ) , _loc ( A , B ) , _state ( B ) , _state ( B ) , _loc ( C , B ) , _const ( C , _riverid ( colorado ) ) ) ) )
what state is the largest city in montana in city has the largest population ?	_answer ( A , _largest ( B , ( _state ( C ) , _largest ( D , ( _city ( D ) , _loc ( D , E ) , _const ( E , _stateid ( montana ) ) ) ) , _loc ( D , C ) , _city ( A ) , _loc ( A , C ) , _population ( A , B ) ) ) )
which states border states through which the the rivers in the state of iowa traverses ?	_answer ( A , ( _state ( A ) , _next_to ( A , B ) , _state ( B ) , _river ( C ) , _loc ( C , D ) , _state ( D ) , _const ( D , _stateid ( iowa ) ) , _traverse ( C , B ) ) )
what is the highest point in the state with capital capital is the largest in the us ?	_answer ( A , _highest ( A , ( _place ( A ) , _loc ( A , B ) , _state ( B ) , _loc ( C , B ) , _capital ( C ) , _largest ( C , ( _capital ( C ) , _loc ( C , D ) , _const ( D , _countryid ( usa ) ) ) ) ) ) )
what is the longest river in states border states through which the mississippi traverses ?	_answer ( A , _longest ( A , ( _river ( A ) , _loc ( A , B ) , _state ( B ) , _next_to ( B , C ) , _state ( C ) , _const ( D , _riverid ( mississippi ) ) , _traverse ( D , C ) ) ) )
which state is the city the capital of georgia located in ?	_answer ( A , ( _state ( A ) , _city ( B ) , _capital ( B ) , _loc ( B , C ) , _const ( C , _stateid ( georgia ) ) , _loc ( B , A ) ) )
which state is the largest city in the states that border the state with the greatest population in ?	_answer ( A , ( _state ( A ) , _largest ( B , ( _city ( B ) , _loc ( B , C ) , _state ( C ) , _next_to ( D , C ) , _largest ( E , ( _state ( D ) , _population ( D , E ) ) ) ) ) , _loc ( B , A ) ) )
what is the lowest point of the biggest state in continental us ?	_answer ( A , _lowest ( A , ( _place ( A ) , _loc ( A , B ) , _largest ( B , ( _state ( B ) , _loc ( B , C ) , _const ( C , _countryid ( usa ) ) ) ) ) ) )
what is the population of capitals are in the states that border delaware ?	_answer ( A , ( _population ( B , A ) , _capital ( B ) , _loc ( B , C ) , _state ( C ) , _next_to ( C , D ) , _const ( D , _stateid ( delaware ) ) ) )
what states border states that border the states that the missouri river run through ?	_answer ( A , ( _state ( A ) , _next_to ( A , B ) , _state ( B ) , _next_to ( B , C ) , _state ( C ) , _const ( D , _riverid ( missouri ) ) , _traverse ( D , C ) ) )
which state is the city the capital of illinois located in ?	_answer ( A , ( _state ( A ) , _city ( B ) , _capital ( B ) , _loc ( B , C ) , _const ( C , _stateid ( illinois ) ) , _loc ( B , A ) ) )
what is the largest city in states have a city named dallas ?	_answer ( A , _largest ( A , ( _city ( A ) , _loc ( A , B ) , _state ( B ) , _loc ( C , B ) , _const ( C , _cityid ( dallas , _ ) ) ) ) )
what are the biggest rivers in states border ohio ?	_answer ( A , _longest ( A , ( _river ( A ) , _loc ( A , B ) , _state ( B ) , _next_to ( B , C ) , _const ( C , _stateid ( ohio ) ) ) ) )
in which state is the largest cities in the states that border the largest state ?	_answer ( A , ( _loc ( B , A ) , _state ( A ) , _largest ( B , ( _city ( B ) , _loc ( B , C ) , _state ( C ) , _next_to ( C , D ) , _largest ( D , _state ( D ) ) ) ) ) )
what is the largest city in the states that the mississippi run through ?	_answer ( A , _largest ( A , ( _city ( A ) , _loc ( A , B ) , _state ( B ) , _const ( C , _riverid ( mississippi ) ) , _traverse ( C , B ) ) ) )
what is the highest point in the state with capital the biggest city in oregon ?	_answer ( A , _highest ( A , ( _place ( A ) , _loc ( A , B ) , _state ( B ) , _loc ( C , B ) , _capital ( C ) , _largest ( C , ( _city ( C ) , _loc ( C , D ) , _const ( D , _stateid ( oregon ) ) ) ) ) ) )
how many states have a city named the major cities in the smallest state in the us ?	_answer ( A , _count ( B , ( _state ( B ) , _loc ( C , B ) , _major ( C ) , _city ( C ) , _loc ( C , D ) , _smallest ( D , ( _state ( D ) , _loc ( D , E ) , _const ( E , _countryid ( usa ) ) ) ) ) , A ) )
how many people live in the biggest city in michigan ?	_answer ( A , ( _population ( B , A ) , _largest ( B , ( _city ( B ) , _loc ( B , C ) , _const ( C , _stateid ( michigan ) ) ) ) ) )
what is the population of the biggest state in continental us ?	_answer ( A , ( _population ( B , A ) , _largest ( B , ( _state ( B ) , _loc ( B , C ) , _const ( C , _countryid ( usa ) ) ) ) ) )
how many rivers in state has highest elevation ?	_answer ( A , _count ( B , ( _river ( B ) , _loc ( B , C ) , _state ( C ) , _loc ( D , C ) , _highest ( D , _place ( D ) ) ) , A ) )
what is the population of the smallest city in arkansas ?	_answer ( A , ( _population ( B , A ) , _smallest ( B , ( _city ( B ) , _loc ( B , C ) , _const ( C , _stateid ( arkansas ) ) ) ) ) )
could you tell me what is the highest point in the state of the biggest state in continental us ?	_answer ( A , _highest ( A , ( _place ( A ) , _loc ( A , B ) , _state ( B ) , _largest ( B , ( _state ( B ) , _loc ( B , C ) , _const ( C , _countryid ( usa ) ) ) ) ) ) )
what is the population of the major cities of the us ga ?	_answer ( A , ( _population ( B , A ) , _major ( B ) , _city ( B ) , _loc ( B , C ) , _const ( C , _countryid ( usa ) ) ) )
how many rivers are in state is mount mckinley ?	_answer ( A , _count ( B , ( _river ( B ) , _loc ( B , C ) , _loc ( D , C ) , _state ( C ) , _const ( D , _placeid ( ' mount mckinley ' ) ) ) , A ) )
how many states does the the biggest rivers in oklahoma flow through ?	_answer ( A , _count ( B , ( _state ( B ) , _longest ( C , ( _river ( C ) , _loc ( C , D ) , _const ( D , _stateid ( oklahoma ) ) ) ) , _river ( C ) , _traverse ( C , B ) ) , A ) )
what is the highest elevation in the states which have no surrounding states ?	_answer ( A , _highest ( A , ( _place ( A ) , _loc ( A , B ) , _state ( B ) , \+ ( _next_to ( B , C ) , _state ( C ) ) ) ) )
what is the population of the capitals of the states that border georgia ga ?	_answer ( A , ( _population ( B , A ) , _capital ( B ) , _loc ( B , C ) , _state ( C ) , _next_to ( C , D ) , _const ( D , _stateid ( georgia ) ) ) )
how many states border state is the city san diego located in ?	_answer ( A , _count ( B , ( _state ( B ) , _next_to ( B , C ) , _state ( C ) , _city ( D ) , _const ( D , _cityid ( ' san diego ' , _ ) ) , _loc ( D , C ) ) , A ) )
what is the highest point in the state with capital the biggest city in minnesota ?	_answer ( A , _highest ( A , ( _place ( A ) , _loc ( A , B ) , _state ( B ) , _loc ( C , B ) , _capital ( C ) , _largest ( C , ( _city ( C ) , _loc ( C , D ) , _const ( D , _stateid ( minnesota ) ) ) ) ) ) )
what is the highest elevation in states border idaho ?	_answer ( A , _highest ( A , ( _place ( A ) , _loc ( A , B ) , _state ( B ) , _next_to ( B , C ) , _const ( C , _stateid ( idaho ) ) ) ) )
how many cities named the major cities in north carolina are there in the usa ?	_answer ( A , _count ( B , ( _city ( B ) , _major ( B ) , _city ( B ) , _loc ( B , D ) , _const ( D , _stateid ( ' north carolina ' ) ) , _loc ( B , C ) , _const ( C , _countryid ( usa ) ) ) , A ) )
what are the high points of states surrounding states border states through which the missouri river traverses ?	_answer ( A , ( _high_point ( B , A ) , _loc ( A , B ) , _state ( B ) , _next_to ( B , C ) , _state ( C ) , _next_to ( C , D ) , _state ( D ) , _const ( E , _riverid ( missouri ) ) , _traverse ( E , D ) ) )
can you tell me the capital of states border states through which the colorado traverses ?	_answer ( A , ( _capital ( A ) , _loc ( A , B ) , _state ( B ) , _next_to ( B , C ) , _state ( C ) , _const ( D , _riverid ( colorado ) ) , _traverse ( D , C ) ) )
in which state is cities are located in utah ?	_answer ( A , ( _loc ( B , A ) , _state ( A ) , _city ( B ) , _loc ( B , C ) , _const ( C , _stateid ( utah ) ) ) )
which states have points that are higher than the highest point in state has highest elevation ?	_answer ( A , ( _state ( A ) , _place ( B ) , _loc ( B , A ) , _higher ( B , C ) , _highest ( C , ( _place ( C ) , _loc ( C , D ) , _state ( D ) , _loc ( E , D ) , _highest ( E , _place ( E ) ) ) ) ) )
what are the states that the the biggest river in louisiana run through ?	_answer ( A , ( _state ( A ) , _largest ( B , ( _river ( B ) , _loc ( B , C ) , _const ( C , _stateid ( louisiana ) ) ) ) , _traverse ( B , A ) ) )
what are the capitals of the states that border state has highest elevation ?	_answer ( A , ( _capital ( A ) , _loc ( A , B ) , _state ( B ) , _next_to ( B , C ) , _state ( C ) , _loc ( D , C ) , _highest ( D , _place ( D ) ) ) )
which states border the neighboring states for michigan ?	_answer ( A , ( _state ( A ) , _next_to ( A , B ) , _next_to ( B , C ) , _state ( B ) , _const ( C , _stateid ( michigan ) ) ) )
what is the biggest river in the neighboring states for idaho ?	_answer ( A , _largest ( A , ( _river ( A ) , _loc ( A , B ) , _next_to ( B , C ) , _state ( B ) , _const ( C , _stateid ( idaho ) ) ) ) )
how many states border state is the city dallas located in ?	_answer ( A , _count ( B , ( _state ( B ) , _next_to ( B , C ) , _state ( C ) , _city ( D ) , _const ( D , _cityid ( dallas , _ ) ) , _loc ( D , C ) ) , A ) )
what are the populations of states through which the the rivers in the state of hawaii run ?	_answer ( A , ( _population ( B , A ) , _state ( B ) , _river ( C ) , _loc ( C , D ) , _state ( D ) , _const ( D , _stateid ( hawaii ) ) , _river ( C ) , _traverse ( C , B ) ) )
how many cities named the capital of pennsylvania are there in the usa ?	_answer ( A , _count ( B , ( _city ( B ) , _capital ( B ) , _loc ( B , D ) , _const ( D , _stateid ( pennsylvania ) ) , _loc ( B , C ) , _const ( C , _countryid ( usa ) ) ) , A ) )
what is the population of the capital of the mississippi state ?	_answer ( A , ( _population ( B , A ) , _capital ( B ) , _loc ( B , C ) , _const ( C , _stateid ( mississippi ) ) , _state ( C ) ) )
how many states does the all the rivers in kansas run through ?	_answer ( A , _count ( B , ( _state ( B ) , _river ( C ) , _loc ( C , D ) , _const ( D , _stateid ( kansas ) ) , _river ( C ) , _traverse ( C , B ) ) , A ) )
what is the population of the capital of hawaii ?	_answer ( A , ( _population ( B , A ) , _capital ( B ) , _loc ( B , C ) , _const ( C , _stateid ( hawaii ) ) ) )
how many states does the rivers run through montana run through ?	_answer ( A , _count ( B , ( _state ( B ) , _river ( C ) , _traverse ( C , D ) , _const ( D , _stateid ( montana ) ) , _river ( C ) , _traverse ( C , B ) ) , A ) )
what major rivers run through states border states through which the colorado traverses ?	_answer ( A , ( _major ( A ) , _river ( A ) , _traverse ( A , B ) , _state ( B ) , _next_to ( B , C ) , _state ( C ) , _const ( D , _riverid ( colorado ) ) , _traverse ( D , C ) ) )
what is the largest state bordering states border states through which the potomac traverses ?	_answer ( A , _largest ( A , ( _state ( A ) , _next_to ( A , B ) , _state ( B ) , _next_to ( B , C ) , _state ( C ) , _const ( D , _riverid ( potomac ) ) , _traverse ( D , C ) ) ) )
how many people live in the capital of delaware ?	_answer ( A , ( _population ( B , A ) , _capital ( B ) , _loc ( B , C ) , _const ( C , _stateid ( delaware ) ) ) )
what is the largest state bordering the state with the lowest point ?	_answer ( A , _largest ( A , ( _state ( A ) , _next_to ( A , B ) , _state ( B ) , _loc ( C , B ) , _lowest ( C , _place ( C ) ) ) ) )
what states does the the longest river in kansas run through ?	_answer ( A , ( _state ( A ) , _longest ( B , ( _river ( B ) , _loc ( B , C ) , _const ( C , _stateid ( kansas ) ) ) ) , _river ( B ) , _traverse ( B , A ) ) )
what is the adjacent state of states neighbor vermont ?	_answer ( A , ( _next_to ( A , B ) , _state ( A ) , _state ( B ) , _next_to ( B , C ) , _const ( C , _stateid ( vermont ) ) ) )
what states have a city named capital of oklahoma ?	_answer ( A , ( _state ( A ) , _loc ( B , A ) , _capital ( B ) , _loc ( B , C ) , _const ( C , _stateid ( oklahoma ) ) ) )
what is the highest elevation in state has the smallest area ?	_answer ( A , _highest ( A , ( _place ( A ) , _loc ( A , B ) , _smallest ( C , ( _state ( B ) , _area ( B , C ) ) ) ) ) )
which states border states through which the river runs through florida traverses ?	_answer ( A , ( _state ( A ) , _next_to ( A , B ) , _state ( B ) , _river ( C ) , _traverse ( C , D ) , _const ( D , _stateid ( florida ) ) , _traverse ( C , B ) ) )
what rivers are in state has the smallest area ?	_answer ( A , ( _river ( A ) , _loc ( A , B ) , _smallest ( C , ( _state ( B ) , _area ( B , C ) ) ) ) )
how many states does the the longest river that passes through the us flow through ?	_answer ( A , _count ( B , ( _state ( B ) , _longest ( C , ( _river ( C ) , _traverse ( C , D ) , _const ( D , _countryid ( usa ) ) ) ) , _river ( C ) , _traverse ( C , B ) ) , A ) )
what is the biggest river in state has highest elevation ?	_answer ( A , _largest ( A , ( _river ( A ) , _loc ( A , B ) , _state ( B ) , _loc ( C , B ) , _highest ( C , _place ( C ) ) ) ) )
how many states have a city called the capital of alaska ?	_answer ( A , _count ( B , ( _state ( B ) , _loc ( C , B ) , _capital ( C ) , _loc ( C , D ) , _const ( D , _stateid ( alaska ) ) ) , A ) )
how many cities named the biggest city in the usa are there in the usa ?	_answer ( A , _count ( B , ( _city ( B ) , _largest ( B , ( _city ( B ) , _loc ( B , D ) , _const ( D , _countryid ( usa ) ) ) ) , _loc ( B , C ) , _const ( C , _countryid ( usa ) ) ) , A ) )
what states have a city named capitals are in the states that border hawaii ?	_answer ( A , ( _state ( A ) , _loc ( B , A ) , _capital ( B ) , _loc ( B , C ) , _state ( C ) , _next_to ( C , D ) , _const ( D , _stateid ( hawaii ) ) ) )
what is the highest point in the state with capital the capital of the wisconsin state ?	_answer ( A , _highest ( A , ( _place ( A ) , _loc ( A , B ) , _state ( B ) , _loc ( C , B ) , _capital ( C ) , _capital ( C ) , _loc ( C , D ) , _const ( D , _stateid ( wisconsin ) ) , _state ( D ) ) ) )
what states have a city named the major cities in north carolina ?	_answer ( A , ( _state ( A ) , _loc ( B , A ) , _major ( B ) , _city ( B ) , _loc ( B , C ) , _const ( C , _stateid ( ' north carolina ' ) ) ) )
how many rivers are in the neighboring states for georgia ?	_answer ( A , _count ( B , ( _river ( B ) , _loc ( B , C ) , _next_to ( C , D ) , _state ( C ) , _const ( D , _stateid ( georgia ) ) ) , A ) )
which states does the river flows through wisconsin run through ?	_answer ( A , ( _state ( A ) , _river ( B ) , _traverse ( B , C ) , _const ( C , _stateid ( wisconsin ) ) , _river ( B ) , _traverse ( B , A ) ) )
how many states have a city named capitals are not major cities ?	_answer ( A , _count ( B , ( _state ( B ) , _loc ( C , B ) , _capital ( C ) , \+ ( _major ( C ) , _city ( C ) ) ) , A ) )
which states does the the longest river flowing through montana run through ?	_answer ( A , ( _state ( A ) , _longest ( B , ( _river ( B ) , _traverse ( B , C ) , _const ( C , _stateid ( montana ) ) ) ) , _river ( B ) , _traverse ( B , A ) ) )
what are the states that the the rivers in the state of rhode island run through ?	_answer ( A , ( _state ( A ) , _river ( B ) , _loc ( B , C ) , _state ( C ) , _const ( C , _stateid ( ' rhode island ' ) ) , _traverse ( B , A ) ) )
what are the high points of states surrounding states border arkansas ?	_answer ( A , ( _high_point ( B , A ) , _loc ( A , B ) , _state ( B ) , _next_to ( B , C ) , _state ( C ) , _next_to ( C , D ) , _const ( D , _stateid ( arkansas ) ) ) )
what is the population of the capital of wyoming ?	_answer ( A , ( _population ( B , A ) , _capital ( B ) , _loc ( B , C ) , _const ( C , _stateid ( wyoming ) ) ) )
which state is the city the largest city in idaho by population located in ?	_answer ( A , ( _state ( A ) , _city ( B ) , _largest ( C , ( _city ( B ) , _loc ( B , D ) , _const ( D , _stateid ( idaho ) ) , _population ( B , C ) ) ) , _loc ( B , A ) ) )
how many states have a city named capitals are in the states that border ohio ?	_answer ( A , _count ( B , ( _state ( B ) , _loc ( C , B ) , _capital ( C ) , _loc ( C , D ) , _state ( D ) , _next_to ( D , E ) , _const ( E , _stateid ( ohio ) ) ) , A ) )
how many people live in the capital of west virginia ?	_answer ( A , ( _population ( B , A ) , _capital ( B ) , _loc ( B , C ) , _const ( C , _stateid ( ' west virginia ' ) ) ) )
which states have points that are higher than the highest point in the neighboring states for delaware ?	_answer ( A , ( _state ( A ) , _place ( B ) , _loc ( B , A ) , _higher ( B , C ) , _highest ( C , ( _place ( C ) , _loc ( C , D ) , _next_to ( D , E ) , _state ( D ) , _const ( E , _stateid ( delaware ) ) ) ) ) )
what is the lowest point in the adjacent state of montana ?	_answer ( A , _lowest ( A , ( _place ( A ) , _loc ( A , B ) , _next_to ( B , C ) , _state ( B ) , _const ( C , _stateid ( montana ) ) ) ) )
what is the largest city in the most populated state bordering texas ?	_answer ( A , _largest ( A , ( _city ( A ) , _loc ( A , B ) , _largest ( C , ( _population ( B , C ) , _state ( B ) , _next_to ( B , D ) , _const ( D , _stateid ( texas ) ) ) ) ) ) )
what is the size of states does the potomac run through ?	_answer ( A , ( _size ( B , A ) , _state ( B ) , _const ( C , _riverid ( potomac ) ) , _river ( C ) , _traverse ( C , B ) ) )
which states does the the longest river flowing through iowa run through ?	_answer ( A , ( _state ( A ) , _longest ( B , ( _river ( B ) , _traverse ( B , C ) , _const ( C , _stateid ( iowa ) ) ) ) , _river ( B ) , _traverse ( B , A ) ) )
what is the smallest state that borders state has the highest peak in the country ?	_answer ( A , _smallest ( A , ( _state ( A ) , _next_to ( A , B ) , _highest ( C , ( _state ( B ) , _loc ( C , B ) , _mountain ( C ) ) ) ) ) )
what are the populations of the states through which the river flows through ohio run ?	_answer ( A , ( _population ( B , A ) , _state ( B ) , _river ( C ) , _traverse ( C , D ) , _const ( D , _stateid ( ohio ) ) , _river ( C ) , _traverse ( C , B ) ) )
what is the population of capitals are not major cities ga ?	_answer ( A , ( _population ( B , A ) , _capital ( B ) , \+ ( _major ( B ) , _city ( B ) ) ) )
what states have rivers named rivers run through hawaii ?	_answer ( A , ( _state ( A ) , _loc ( B , A ) , _river ( B ) , _traverse ( B , C ) , _const ( C , _stateid ( hawaii ) ) ) )
how many cities named the capitals of the states that border oklahoma are there in the usa ?	_answer ( A , _count ( B , ( _city ( B ) , _capital ( B ) , _loc ( B , D ) , _state ( D ) , _next_to ( D , E ) , _const ( E , _stateid ( oklahoma ) ) , _loc ( B , C ) , _const ( C , _countryid ( usa ) ) ) , A ) )
which capitals are in the states that border state has no rivers ?	_answer ( A , ( _capital ( A ) , _loc ( A , B ) , _state ( B ) , _next_to ( B , C ) , _state ( C ) , \+ ( _loc ( D , C ) , _river ( D ) ) ) )
which state is the city the biggest city in south carolina located in ?	_answer ( A , ( _state ( A ) , _city ( B ) , _largest ( B , ( _city ( B ) , _loc ( B , C ) , _const ( C , _stateid ( ' south carolina ' ) ) ) ) , _loc ( B , A ) ) )
which state is the city the capital of west virginia located in ?	_answer ( A , ( _state ( A ) , _city ( B ) , _capital ( B ) , _loc ( B , C ) , _const ( C , _stateid ( ' west virginia ' ) ) , _loc ( B , A ) ) )
what are the states that the the longest river in washington run through ?	_answer ( A , ( _state ( A ) , _longest ( B , ( _river ( B ) , _loc ( B , C ) , _const ( C , _stateid ( washington ) ) ) ) , _traverse ( B , A ) ) )
which state is the city the largest city in arkansas located in ?	_answer ( A , ( _state ( A ) , _city ( B ) , _largest ( B , ( _city ( B ) , _loc ( B , C ) , _const ( C , _stateid ( arkansas ) ) ) ) , _loc ( B , A ) ) )
what states does the rivers are in ohio run through ?	_answer ( A , ( _state ( A ) , _river ( B ) , _loc ( B , C ) , _const ( C , _stateid ( ohio ) ) , _river ( B ) , _traverse ( B , A ) ) )
how many cities named the smallest city in pennsylvania are there in the usa ?	_answer ( A , _count ( B , ( _city ( B ) , _smallest ( B , ( _city ( B ) , _loc ( B , D ) , _const ( D , _stateid ( pennsylvania ) ) ) ) , _loc ( B , C ) , _const ( C , _countryid ( usa ) ) ) , A ) )
how many states have a city called s the largest city ?	_answer ( A , _count ( B , ( _state ( B ) , _loc ( C , B ) , _largest ( C , _city ( C ) ) ) , A ) )
what is the longest river in state has the highest population density ?	_answer ( A , _longest ( A , ( _river ( A ) , _loc ( A , B ) , _largest ( C , ( _state ( B ) , _density ( B , C ) ) ) ) ) )
what is the highest point in states have points that are higher than the highest point in alaska ?	_answer ( A , _highest ( A , ( _place ( A ) , _loc ( A , B ) , _state ( B ) , _place ( C ) , _loc ( C , B ) , _higher ( C , D ) , _highest ( D , ( _place ( D ) , _loc ( D , E ) , _const ( E , _stateid ( alaska ) ) ) ) ) ) )
how many people live in the capital of mississippi ?	_answer ( A , ( _population ( B , A ) , _capital ( B ) , _loc ( B , C ) , _const ( C , _stateid ( mississippi ) ) ) )
what cities are located in the largest state bordering kansas ?	_answer ( A , ( _city ( A ) , _loc ( A , B ) , _largest ( B , ( _state ( B ) , _next_to ( B , C ) , _const ( C , _stateid ( kansas ) ) ) ) ) )
in which state is the capital of kansas ?	_answer ( A , ( _loc ( B , A ) , _state ( A ) , _capital ( B ) , _loc ( B , C ) , _const ( C , _stateid ( kansas ) ) ) )
how many cities named the capital of georgia are there in the usa ?	_answer ( A , _count ( B , ( _city ( B ) , _capital ( B ) , _loc ( B , D ) , _const ( D , _stateid ( georgia ) ) , _loc ( B , C ) , _const ( C , _countryid ( usa ) ) ) , A ) )
what is the population of the capital of michigan ?	_answer ( A , ( _population ( B , A ) , _capital ( B ) , _loc ( B , C ) , _const ( C , _stateid ( michigan ) ) ) )
which state border the states through which the longest river runs ?	_answer ( A , ( _state ( A ) , _next_to ( A , B ) , _state ( B ) , _longest ( C , ( _river ( C ) , _traverse ( C , B ) ) ) ) )
how many cities named the capital of nebraska are there in the usa ?	_answer ( A , _count ( B , ( _city ( B ) , _capital ( B ) , _loc ( B , D ) , _const ( D , _stateid ( nebraska ) ) , _loc ( B , C ) , _const ( C , _countryid ( usa ) ) ) , A ) )
how many major cities are in the adjacent state of idaho ?	_answer ( A , _count ( B , ( _major ( B ) , _city ( B ) , _loc ( B , C ) , _next_to ( C , D ) , _state ( C ) , _const ( D , _stateid ( idaho ) ) ) , A ) )
how many major cities are in state has no rivers ?	_answer ( A , _count ( B , ( _major ( B ) , _city ( B ) , _loc ( B , C ) , _state ( C ) , \+ ( _loc ( D , C ) , _river ( D ) ) ) , A ) )
how many people live in the biggest city in the usa ?	_answer ( A , ( _population ( B , A ) , _largest ( B , ( _city ( B ) , _loc ( B , C ) , _const ( C , _countryid ( usa ) ) ) ) ) )
what is the highest elevation in states have a city named denver ?	_answer ( A , _highest ( A , ( _place ( A ) , _loc ( A , B ) , _state ( B ) , _loc ( C , B ) , _const ( C , _cityid ( denver , _ ) ) ) ) )
which states border states through which the rivers are in illinois traverses ?	_answer ( A , ( _state ( A ) , _next_to ( A , B ) , _state ( B ) , _river ( C ) , _loc ( C , D ) , _const ( D , _stateid ( illinois ) ) , _traverse ( C , B ) ) )
which states border states through which the the longest river in the united states traverses ?	_answer ( A , ( _state ( A ) , _next_to ( A , B ) , _state ( B ) , _longest ( C , ( _river ( C ) , _loc ( C , D ) , _const ( D , _countryid ( usa ) ) ) ) , _traverse ( C , B ) ) )
how many states have a city named the largest city in massachusetts ?	_answer ( A , _count ( B , ( _state ( B ) , _loc ( C , B ) , _largest ( C , ( _city ( C ) , _loc ( C , D ) , _const ( D , _stateid ( massachusetts ) ) ) ) ) , A ) )
how many states have a city named the smallest city in rhode island ?	_answer ( A , _count ( B , ( _state ( B ) , _loc ( C , B ) , _smallest ( C , ( _city ( C ) , _loc ( C , D ) , _const ( D , _stateid ( ' rhode island ' ) ) ) ) ) , A ) )
what is the total population of the states that border the most populated state bordering california ?	_answer ( A , _sum ( C , ( _state ( C ) , _next_to ( D , C ) , _largest ( E , ( _population ( D , E ) , _state ( D ) , _next_to ( D , F ) , _const ( F , _stateid ( california ) ) ) ) ) , _population ( C ) , A ) )
how long is the the longest river in the state with the highest point ?	_answer ( A , ( _len ( B , A ) , _longest ( B , ( _river ( B ) , _loc ( B , C ) , _state ( C ) , _loc ( D , C ) , _highest ( D , _place ( D ) ) ) ) , _river ( B ) ) )
how many states does the river runs through the most states flow through ?	_answer ( A , _count ( B , ( _state ( B ) , _most ( C , D , ( _river ( C ) , _traverse ( C , D ) , _state ( D ) ) ) , _river ( C ) , _traverse ( C , B ) ) , A ) )
what is the smallest city in state is dallas ?	_answer ( A , _smallest ( A , ( _city ( A ) , _loc ( A , B ) , _loc ( C , B ) , _state ( B ) , _const ( C , _cityid ( dallas , _ ) ) ) ) )
what is the population of the capital of indiana ?	_answer ( A , ( _population ( B , A ) , _capital ( B ) , _loc ( B , C ) , _const ( C , _stateid ( indiana ) ) ) )
how many states have a city called the capitals of the states that border michigan ?	_answer ( A , _count ( B , ( _state ( B ) , _loc ( C , B ) , _capital ( C ) , _loc ( C , D ) , _state ( D ) , _next_to ( D , E ) , _const ( E , _stateid ( michigan ) ) ) , A ) )
how long is the river runs through minnesota ?	_answer ( A , ( _len ( B , A ) , _river ( B ) , _traverse ( B , C ) , _const ( C , _stateid ( minnesota ) ) ) )
what is the area of the smallest state through which the longest river runs ?	_answer ( A , ( _area ( B , A ) , _smallest ( B , ( _state ( B ) , _longest ( C , _river ( C ) ) , _traverse ( C , B ) ) ) ) )
what states does the the biggest river in wisconsin run through ?	_answer ( A , ( _state ( A ) , _largest ( B , ( _river ( B ) , _loc ( B , C ) , _const ( C , _stateid ( wisconsin ) ) ) ) , _river ( B ) , _traverse ( B , A ) ) )
how many people live in the capital of the wisconsin state ?	_answer ( A , ( _population ( B , A ) , _capital ( B ) , _loc ( B , C ) , _const ( C , _stateid ( wisconsin ) ) , _state ( C ) ) )
how long is the the major rivers in the us ?	_answer ( A , ( _len ( B , A ) , _major ( B ) , _river ( B ) , _loc ( B , C ) , _const ( C , _countryid ( usa ) ) , _river ( B ) ) )
what is the river that cross over states neighbor texas ?	_answer ( A , ( _river ( A ) , _traverse ( A , B ) , _state ( B ) , _next_to ( B , C ) , _const ( C , _stateid ( texas ) ) ) )
what major rivers run through the most populated state bordering north carolina ?	_answer ( A , ( _major ( A ) , _river ( A ) , _traverse ( A , B ) , _largest ( C , ( _population ( B , C ) , _state ( B ) , _next_to ( B , D ) , _const ( D , _stateid ( ' north carolina ' ) ) ) ) ) )
how many rivers are in state is the largest city in colorado in ?	_answer ( A , _count ( B , ( _river ( B ) , _loc ( B , C ) , _state ( C ) , _largest ( D , ( _city ( D ) , _loc ( D , E ) , _const ( E , _stateid ( colorado ) ) ) ) , _loc ( D , C ) ) , A ) )
how long is the all the rivers in illinois ?	_answer ( A , ( _len ( B , A ) , _river ( B ) , _loc ( B , C ) , _const ( C , _stateid ( illinois ) ) , _river ( B ) ) )
where is s the largest city ?	_answer ( A , ( _loc ( B , A ) , _largest ( B , _city ( B ) ) ) )
in which state is the major cities of the us ?	_answer ( A , ( _loc ( B , A ) , _state ( A ) , _major ( B ) , _city ( B ) , _loc ( B , C ) , _const ( C , _countryid ( usa ) ) ) )
what states have a city named the major cities in ohio ?	_answer ( A , ( _state ( A ) , _loc ( B , A ) , _major ( B ) , _city ( B ) , _loc ( B , C ) , _const ( C , _stateid ( ohio ) ) ) )
what are the neighboring states for states border states through which the colorado traverses ?	_answer ( A , ( _next_to ( A , B ) , _state ( A ) , _state ( B ) , _next_to ( B , C ) , _state ( C ) , _const ( D , _riverid ( colorado ) ) , _traverse ( D , C ) ) )
what is the total population of the states that border states border arkansas ?	_answer ( A , _sum ( C , ( _state ( C ) , _next_to ( D , C ) , _state ( D ) , _next_to ( D , E ) , _const ( E , _stateid ( arkansas ) ) ) , _population ( C ) , A ) )
which states border states border minnesota ?	_answer ( A , ( _state ( A ) , _next_to ( A , B ) , _state ( B ) , _next_to ( B , C ) , _const ( C , _stateid ( minnesota ) ) ) )
which state is the city the largest cities in the states that border the largest state located in ?	_answer ( A , ( _state ( A ) , _city ( B ) , _largest ( B , ( _city ( B ) , _loc ( B , C ) , _state ( C ) , _next_to ( C , D ) , _largest ( D , _state ( D ) ) ) ) , _loc ( B , A ) ) )
what is the smallest state that borders states high point are higher than that of georgia ?	_answer ( A , _smallest ( A , ( _state ( A ) , _next_to ( A , B ) , _state ( B ) , _high_point ( B , C ) , _higher ( C , D ) , _high_point ( E , D ) , _const ( E , _stateid ( georgia ) ) ) ) )
what is the longest river flowing through the states ?	_answer ( A , _longest ( A , ( _river ( A ) , _traverse ( A , B ) , _state ( B ) ) ) )
what are the states that the the river that cross over vermont run through ?	_answer ( A , ( _state ( A ) , _river ( B ) , _traverse ( B , C ) , _const ( C , _stateid ( vermont ) ) , _traverse ( B , A ) ) )
how long is the the river that cross over kentucky ?	_answer ( A , ( _len ( B , A ) , _river ( B ) , _traverse ( B , C ) , _const ( C , _stateid ( kentucky ) ) , _river ( B ) ) )
what states have rivers named river runs through nebraska ?	_answer ( A , ( _state ( A ) , _loc ( B , A ) , _river ( B ) , _traverse ( B , C ) , _const ( C , _stateid ( nebraska ) ) ) )
what rivers run through state has the smallest area ?	_answer ( A , ( _river ( A ) , _traverse ( A , B ) , _smallest ( C , ( _state ( B ) , _area ( B , C ) ) ) ) )
what is the population of the major cities in vermont ?	_answer ( A , ( _population ( B , A ) , _major ( B ) , _city ( B ) , _loc ( B , C ) , _const ( C , _stateid ( vermont ) ) ) )
how many states have a city called capitals are not major cities ?	_answer ( A , _count ( B , ( _state ( B ) , _loc ( C , B ) , _capital ( C ) , \+ ( _major ( C ) , _city ( C ) ) ) , A ) )
what are the states that the the shortest river in the united states run through ?	_answer ( A , ( _state ( A ) , _shortest ( B , ( _river ( B ) , _loc ( B , C ) , _const ( C , _countryid ( usa ) ) ) ) , _traverse ( B , A ) ) )
what is the population of the major cities in oklahoma ?	_answer ( A , ( _population ( B , A ) , _major ( B ) , _city ( B ) , _loc ( B , C ) , _const ( C , _stateid ( oklahoma ) ) ) )
what are the states that the the longest river in america run through ?	_answer ( A , ( _state ( A ) , _longest ( B , ( _river ( B ) , _loc ( B , C ) , _const ( C , _countryid ( usa ) ) ) ) , _traverse ( B , A ) ) )
what is the adjacent state of the most populated state bordering south carolina ?	_answer ( A , ( _next_to ( A , B ) , _state ( A ) , _largest ( C , ( _population ( B , C ) , _state ( B ) , _next_to ( B , D ) , _const ( D , _stateid ( ' south carolina ' ) ) ) ) ) )
what is the total population of the states that border state is mount mckinley ?	_answer ( A , _sum ( C , ( _state ( C ) , _next_to ( D , C ) , _loc ( E , D ) , _state ( D ) , _const ( E , _placeid ( ' mount mckinley ' ) ) ) , _population ( C ) , A ) )
what are the states that the rivers are in michigan run through ?	_answer ( A , ( _state ( A ) , _river ( B ) , _loc ( B , C ) , _const ( C , _stateid ( michigan ) ) , _traverse ( B , A ) ) )
what is the adjacent state of state has the city with the largest population ?	_answer ( A , ( _next_to ( A , B ) , _state ( A ) , _state ( B ) , _loc ( C , B ) , _largest ( D , ( _city ( C ) , _population ( C , D ) ) ) ) )
where is cities are located in oregon ?	_answer ( A , ( _loc ( B , A ) , _city ( B ) , _loc ( B , C ) , _const ( C , _stateid ( oregon ) ) ) )
what is the longest river that runs through a state that borders state border rhode island ?	_answer ( A , _longest ( A , ( _river ( A ) , _traverse ( A , B ) , _state ( B ) , _next_to ( B , C ) , _state ( C ) , _next_to ( C , D ) , _const ( D , _stateid ( ' rhode island ' ) ) ) ) )
what is the highest point in the state with capital the capital of the alabama state ?	_answer ( A , _highest ( A , ( _place ( A ) , _loc ( A , B ) , _state ( B ) , _loc ( C , B ) , _capital ( C ) , _capital ( C ) , _loc ( C , D ) , _const ( D , _stateid ( alabama ) ) , _state ( D ) ) ) )
how many states have a city named michigan city has the largest population ?	_answer ( A , _count ( B , ( _state ( B ) , _loc ( C , B ) , _largest ( D , ( _const ( E , _stateid ( michigan ) ) , _city ( C ) , _loc ( C , E ) , _population ( C , D ) ) ) ) , A ) )
what states does the the longest river in the state with the highest point run through ?	_answer ( A , ( _state ( A ) , _longest ( B , ( _river ( B ) , _loc ( B , C ) , _state ( C ) , _loc ( D , C ) , _highest ( D , _place ( D ) ) ) ) , _river ( B ) , _traverse ( B , A ) ) )
how long is the rivers run through texas ?	_answer ( A , ( _len ( B , A ) , _river ( B ) , _traverse ( B , C ) , _const ( C , _stateid ( texas ) ) , _river ( B ) ) )
which states have points that are higher than the highest point in states neighbor oklahoma ?	_answer ( A , ( _state ( A ) , _place ( B ) , _loc ( B , A ) , _higher ( B , C ) , _highest ( C , ( _place ( C ) , _loc ( C , D ) , _state ( D ) , _next_to ( D , E ) , _const ( E , _stateid ( oklahoma ) ) ) ) ) )
how long is the the longest river that runs through a state that borders hawaii ?	_answer ( A , ( _len ( B , A ) , _longest ( B , ( _river ( B ) , _traverse ( B , C ) , _state ( C ) , _next_to ( C , D ) , _const ( D , _stateid ( hawaii ) ) ) ) ) )
how many cities named the smallest city in louisiana are there in the usa ?	_answer ( A , _count ( B , ( _city ( B ) , _smallest ( B , ( _city ( B ) , _loc ( B , D ) , _const ( D , _stateid ( louisiana ) ) ) ) , _loc ( B , C ) , _const ( C , _countryid ( usa ) ) ) , A ) )
what is the population of the major cities in mississippi ga ?	_answer ( A , ( _population ( B , A ) , _major ( B ) , _city ( B ) , _loc ( B , C ) , _const ( C , _stateid ( mississippi ) ) ) )
how many rivers in states high point are higher than that of oklahoma ?	_answer ( A , _count ( B , ( _river ( B ) , _loc ( B , C ) , _state ( C ) , _high_point ( C , D ) , _higher ( D , E ) , _high_point ( F , E ) , _const ( F , _stateid ( oklahoma ) ) ) , A ) )
where is the major cities of the us ?	_answer ( A , ( _loc ( B , A ) , _major ( B ) , _city ( B ) , _loc ( B , C ) , _const ( C , _countryid ( usa ) ) ) )
what are the capitals of the states that border states border states that border kansas ?	_answer ( A , ( _capital ( A ) , _loc ( A , B ) , _state ( B ) , _next_to ( B , C ) , _state ( C ) , _next_to ( C , D ) , _state ( D ) , _next_to ( D , E ) , _const ( E , _stateid ( kansas ) ) ) )
how many people live in the biggest city in wyoming ?	_answer ( A , ( _population ( B , A ) , _largest ( B , ( _city ( B ) , _loc ( B , C ) , _const ( C , _stateid ( wyoming ) ) ) ) ) )
what are the populations of the states through which the the biggest river in ohio run ?	_answer ( A , ( _population ( B , A ) , _state ( B ) , _largest ( C , ( _river ( C ) , _loc ( C , D ) , _const ( D , _stateid ( ohio ) ) ) ) , _river ( C ) , _traverse ( C , B ) ) )
what is the highest point in the state with the lowest point ?	_answer ( A , _highest ( A , ( _place ( A ) , _loc ( A , B ) , _state ( B ) , _loc ( C , B ) , _lowest ( C , _place ( C ) ) ) ) )
how long is the rivers run through colorado ?	_answer ( A , ( _len ( B , A ) , _river ( B ) , _traverse ( B , C ) , _const ( C , _stateid ( colorado ) ) , _river ( B ) ) )
how many states does the the rivers in the state of kansas run through ?	_answer ( A , _count ( B , ( _state ( B ) , _river ( C ) , _loc ( C , D ) , _state ( D ) , _const ( D , _stateid ( kansas ) ) , _river ( C ) , _traverse ( C , B ) ) , A ) )
what are the populations of the states through which the the shortest river in the usa run ?	_answer ( A , ( _population ( B , A ) , _state ( B ) , _shortest ( C , ( _river ( C ) , _loc ( C , D ) , _const ( D , _countryid ( usa ) ) ) ) , _river ( C ) , _traverse ( C , B ) ) )
what are the states that the the longest river flowing through pennsylvania run through ?	_answer ( A , ( _state ( A ) , _longest ( B , ( _river ( B ) , _traverse ( B , C ) , _const ( C , _stateid ( pennsylvania ) ) ) ) , _traverse ( B , A ) ) )
which capitals are in the states that border state has the largest city ?	_answer ( A , ( _capital ( A ) , _loc ( A , B ) , _state ( B ) , _next_to ( B , C ) , _largest ( D , ( _state ( C ) , _loc ( D , C ) , _city ( D ) ) ) ) )
what states does the the river that cross over kansas run through ?	_answer ( A , ( _state ( A ) , _river ( B ) , _traverse ( B , C ) , _const ( C , _stateid ( kansas ) ) , _river ( B ) , _traverse ( B , A ) ) )
what states border west virginia city has the largest population ?	_answer ( A , _largest ( B , ( _state ( C ) , _next_to ( C , D ) , _const ( D , _stateid ( ' west virginia ' ) ) , _city ( A ) , _loc ( A , C ) , _population ( A , B ) ) ) )
which states does the the rivers in the state of kansas run through ?	_answer ( A , ( _state ( A ) , _river ( B ) , _loc ( B , C ) , _state ( C ) , _const ( C , _stateid ( kansas ) ) , _river ( B ) , _traverse ( B , A ) ) )
what is capital of states high point are higher than that of alaska ?	_answer ( A , ( _capital ( A ) , _loc ( A , B ) , _state ( B ) , _high_point ( B , C ) , _higher ( C , D ) , _high_point ( E , D ) , _const ( E , _stateid ( alaska ) ) ) )
what are the states that the the rivers in the state of illinois run through ?	_answer ( A , ( _state ( A ) , _river ( B ) , _loc ( B , C ) , _state ( C ) , _const ( C , _stateid ( illinois ) ) , _traverse ( B , A ) ) )
which state is the city the largest city in wisconsin by population located in ?	_answer ( A , ( _state ( A ) , _city ( B ) , _largest ( C , ( _city ( B ) , _loc ( B , D ) , _const ( D , _stateid ( wisconsin ) ) , _population ( B , C ) ) ) , _loc ( B , A ) ) )
what is the largest city in states border vermont ?	_answer ( A , _largest ( A , ( _city ( A ) , _loc ( A , B ) , _state ( B ) , _next_to ( B , C ) , _const ( C , _stateid ( vermont ) ) ) ) )
what is the biggest city in state has the smallest area ?	_answer ( A , _largest ( A , ( _city ( A ) , _loc ( A , B ) , _smallest ( C , ( _state ( B ) , _area ( B , C ) ) ) ) ) )
what states does the the rivers in the state of utah run through ?	_answer ( A , ( _state ( A ) , _river ( B ) , _loc ( B , C ) , _state ( C ) , _const ( C , _stateid ( utah ) ) , _river ( B ) , _traverse ( B , A ) ) )
what state border minnesota city has the largest population ?	_answer ( A , _largest ( B , ( _state ( C ) , _next_to ( C , D ) , _const ( D , _stateid ( minnesota ) ) , _city ( A ) , _loc ( A , C ) , _population ( A , B ) ) ) )
in which state is the biggest city in massachusetts ?	_answer ( A , ( _loc ( B , A ) , _state ( A ) , _largest ( B , ( _city ( B ) , _loc ( B , C ) , _const ( C , _stateid ( massachusetts ) ) ) ) ) )
what is the longest river in states high point are higher than that of maine ?	_answer ( A , _longest ( A , ( _river ( A ) , _loc ( A , B ) , _state ( B ) , _high_point ( B , C ) , _higher ( C , D ) , _high_point ( E , D ) , _const ( E , _stateid ( maine ) ) ) ) )
what states have a city named capital is the largest in the us ?	_answer ( A , ( _state ( A ) , _loc ( B , A ) , _largest ( B , ( _capital ( B ) , _loc ( B , C ) , _const ( C , _countryid ( usa ) ) ) ) ) )
how many states does the rivers are in north carolina flow through ?	_answer ( A , _count ( B , ( _state ( B ) , _river ( C ) , _loc ( C , D ) , _const ( D , _stateid ( ' north carolina ' ) ) , _river ( C ) , _traverse ( C , B ) ) , A ) )
what is the river that cross over state has the largest population density ?	_answer ( A , ( _river ( A ) , _traverse ( A , B ) , _largest ( C , ( _state ( B ) , _density ( B , C ) ) ) ) )
where is capitals are in the states that border nebraska ?	_answer ( A , ( _loc ( B , A ) , _capital ( B ) , _loc ( B , C ) , _state ( C ) , _next_to ( C , D ) , _const ( D , _stateid ( nebraska ) ) ) )
what states neighbor states border states that border washington ?	_answer ( A , ( _state ( A ) , _next_to ( A , B ) , _state ( B ) , _next_to ( B , C ) , _state ( C ) , _next_to ( C , D ) , _const ( D , _stateid ( washington ) ) ) )
how many states have a city called the biggest city in oklahoma ?	_answer ( A , _count ( B , ( _state ( B ) , _loc ( C , B ) , _largest ( C , ( _city ( C ) , _loc ( C , D ) , _const ( D , _stateid ( oklahoma ) ) ) ) ) , A ) )
what are the populations of the states through which the the longest river flowing through tennessee run ?	_answer ( A , ( _population ( B , A ) , _state ( B ) , _longest ( C , ( _river ( C ) , _traverse ( C , D ) , _const ( D , _stateid ( tennessee ) ) ) ) , _river ( C ) , _traverse ( C , B ) ) )
what states have a city named the cities which are in arizona ?	_answer ( A , ( _state ( A ) , _loc ( B , A ) , _city ( B ) , _loc ( B , C ) , _const ( C , _stateid ( arizona ) ) ) )
what are the neighboring states for the states which have no surrounding states ?	_answer ( A , ( _next_to ( A , B ) , _state ( A ) , _state ( B ) , \+ ( _next_to ( B , C ) , _state ( C ) ) ) )
where is capital is the largest in the us ?	_answer ( A , ( _loc ( B , A ) , _largest ( B , ( _capital ( B ) , _loc ( B , C ) , _const ( C , _countryid ( usa ) ) ) ) ) )
what states high point are higher than that of states border states through which the colorado river traverses ?	_answer ( A , ( _state ( A ) , _high_point ( A , B ) , _higher ( B , C ) , _high_point ( D , C ) , _state ( D ) , _next_to ( D , E ) , _state ( E ) , _const ( F , _riverid ( colorado ) ) , _traverse ( F , E ) ) )
which state is the city the capital of the georgia state located in ?	_answer ( A , ( _state ( A ) , _city ( B ) , _capital ( B ) , _loc ( B , C ) , _const ( C , _stateid ( georgia ) ) , _state ( C ) , _loc ( B , A ) ) )
what is the largest state bordering state has the smallest area ?	_answer ( A , _largest ( A , ( _state ( A ) , _next_to ( A , B ) , _smallest ( C , ( _state ( B ) , _area ( B , C ) ) ) ) ) )
what states have rivers named the biggest river in georgia ?	_answer ( A , ( _state ( A ) , _loc ( B , A ) , _largest ( B , ( _river ( B ) , _loc ( B , C ) , _const ( C , _stateid ( georgia ) ) ) ) ) )
how long is the river flows through new york ?	_answer ( A , ( _len ( B , A ) , _river ( B ) , _traverse ( B , C ) , _const ( C , _stateid ( ' new york ' ) ) , _river ( B ) ) )
what is the capital of the state that borders south carolina is the largest state ?	_answer ( A , ( _capital ( A ) , _loc ( A , B ) , _largest ( B , ( _state ( B ) , _next_to ( B , C ) , _const ( C , _stateid ( ' south carolina ' ) ) ) ) , _state ( B ) ) )
how many states does the all the rivers in alaska run through ?	_answer ( A , _count ( B , ( _state ( B ) , _river ( C ) , _loc ( C , D ) , _const ( D , _stateid ( alaska ) ) , _river ( C ) , _traverse ( C , B ) ) , A ) )
what states border states that border state is mount mckinley ?	_answer ( A , ( _state ( A ) , _next_to ( A , B ) , _state ( B ) , _next_to ( B , C ) , _loc ( D , C ) , _state ( C ) , _const ( D , _placeid ( ' mount mckinley ' ) ) ) )
what is the highest mountain in state is the largest city in tennessee in ?	_answer ( A , _highest ( A , ( _mountain ( A ) , _loc ( A , B ) , _state ( B ) , _largest ( C , ( _city ( C ) , _loc ( C , D ) , _const ( D , _stateid ( tennessee ) ) ) ) , _loc ( C , B ) ) ) )
how many states have a city named the biggest city in hawaii ?	_answer ( A , _count ( B , ( _state ( B ) , _loc ( C , B ) , _largest ( C , ( _city ( C ) , _loc ( C , D ) , _const ( D , _stateid ( hawaii ) ) ) ) ) , A ) )
what states have rivers named the rivers in the state of montana ?	_answer ( A , ( _state ( A ) , _loc ( B , A ) , _river ( B ) , _loc ( B , C ) , _state ( C ) , _const ( C , _stateid ( montana ) ) ) )
how many rivers in states border new york ?	_answer ( A , _count ( B , ( _river ( B ) , _loc ( B , C ) , _state ( C ) , _next_to ( C , D ) , _const ( D , _stateid ( ' new york ' ) ) ) , A ) )
in which state is capitals are in the states that border indiana ?	_answer ( A , ( _loc ( B , A ) , _state ( A ) , _capital ( B ) , _loc ( B , C ) , _state ( C ) , _next_to ( C , D ) , _const ( D , _stateid ( indiana ) ) ) )
what is the total population of the states that border the most populated state bordering pennsylvania ?	_answer ( A , _sum ( C , ( _state ( C ) , _next_to ( D , C ) , _largest ( E , ( _population ( D , E ) , _state ( D ) , _next_to ( D , F ) , _const ( F , _stateid ( pennsylvania ) ) ) ) ) , _population ( C ) , A ) )
what are the names of the major cities in state is mount mckinley ?	_answer ( A , ( _major ( A ) , _city ( A ) , _loc ( A , B ) , _loc ( C , B ) , _state ( B ) , _const ( C , _placeid ( ' mount mckinley ' ) ) ) )
what is the total population of the states that border state has the city with the largest population ?	_answer ( A , _sum ( C , ( _state ( C ) , _next_to ( D , C ) , _state ( D ) , _loc ( E , D ) , _largest ( F , ( _city ( E ) , _population ( E , F ) ) ) ) , _population ( C ) , A ) )
how many states does the the biggest rivers in west virginia run through ?	_answer ( A , _count ( B , ( _state ( B ) , _longest ( C , ( _river ( C ) , _loc ( C , D ) , _const ( D , _stateid ( ' west virginia ' ) ) ) ) , _river ( C ) , _traverse ( C , B ) ) , A ) )
what state has no rivers city has the largest population ?	_answer ( A , _largest ( B , ( _state ( C ) , \+ ( _loc ( D , C ) , _river ( D ) ) , _city ( A ) , _loc ( A , C ) , _population ( A , B ) ) ) )
what states have rivers named rivers run through idaho ?	_answer ( A , ( _state ( A ) , _loc ( B , A ) , _river ( B ) , _traverse ( B , C ) , _const ( C , _stateid ( idaho ) ) ) )
what are the populations of states through which the the river that cross over vermont run ?	_answer ( A , ( _population ( B , A ) , _state ( B ) , _river ( C ) , _traverse ( C , D ) , _const ( D , _stateid ( vermont ) ) , _river ( C ) , _traverse ( C , B ) ) )
how long is the rivers are in california ?	_answer ( A , ( _len ( B , A ) , _river ( B ) , _loc ( B , C ) , _const ( C , _stateid ( california ) ) , _river ( B ) ) )
what is the capital of state that borders alaska is the largest ?	_answer ( A , ( _capital ( A ) , _loc ( A , B ) , _largest ( B , ( _state ( B ) , _next_to ( B , C ) , _const ( C , _stateid ( alaska ) ) ) ) ) )
what are the populations of states through which the the rivers in the state of rhode island run ?	_answer ( A , ( _population ( B , A ) , _state ( B ) , _river ( C ) , _loc ( C , D ) , _state ( D ) , _const ( D , _stateid ( ' rhode island ' ) ) , _river ( C ) , _traverse ( C , B ) ) )
what is the average population per square km in states border texas ?	_answer ( A , ( _density ( B , A ) , _state ( B ) , _next_to ( B , C ) , _const ( C , _stateid ( texas ) ) ) )
what is the biggest city in the states ?	_answer ( A , _largest ( A , ( _city ( A ) , _loc ( A , B ) , _state ( B ) ) ) )
what states does the the longest river that runs through a state that borders washington run through ?	_answer ( A , ( _state ( A ) , _longest ( B , ( _river ( B ) , _traverse ( B , C ) , _state ( C ) , _next_to ( C , D ) , _const ( D , _stateid ( washington ) ) ) ) , _river ( B ) , _traverse ( B , A ) ) )
what states have rivers named rivers are in rhode island ?	_answer ( A , ( _state ( A ) , _loc ( B , A ) , _river ( B ) , _loc ( B , C ) , _const ( C , _stateid ( ' rhode island ' ) ) ) )
what the adjacent state of south carolina city has the largest population ?	_answer ( A , _largest ( B , ( _next_to ( C , D ) , _state ( C ) , _const ( D , _stateid ( ' south carolina ' ) ) , _city ( A ) , _loc ( A , C ) , _population ( A , B ) ) ) )
what are the populations of the states through which the the longest river in the united states run ?	_answer ( A , ( _population ( B , A ) , _state ( B ) , _longest ( C , ( _river ( C ) , _loc ( C , D ) , _const ( D , _countryid ( usa ) ) ) ) , _river ( C ) , _traverse ( C , B ) ) )
give me the cities which are in states border oregon ?	_answer ( A , ( _city ( A ) , _loc ( A , B ) , _state ( B ) , _next_to ( B , C ) , _const ( C , _stateid ( oregon ) ) ) )
in which state is the capital of the ohio state ?	_answer ( A , ( _loc ( B , A ) , _state ( A ) , _capital ( B ) , _loc ( B , C ) , _const ( C , _stateid ( ohio ) ) , _state ( C ) ) )
which rivers are in states have points that are higher than the highest point in massachusetts ?	_answer ( A , ( _river ( A ) , _loc ( A , B ) , _state ( B ) , _place ( C ) , _loc ( C , B ) , _higher ( C , D ) , _highest ( D , ( _place ( D ) , _loc ( D , E ) , _const ( E , _stateid ( massachusetts ) ) ) ) ) )
what are the populations of the states through which the major rivers run through mississippi run ?	_answer ( A , ( _population ( B , A ) , _state ( B ) , _major ( C ) , _river ( C ) , _traverse ( C , D ) , _const ( D , _stateid ( mississippi ) ) , _river ( C ) , _traverse ( C , B ) ) )
how many states does the the biggest river in delaware run through ?	_answer ( A , _count ( B , ( _state ( B ) , _largest ( C , ( _river ( C ) , _loc ( C , D ) , _const ( D , _stateid ( delaware ) ) ) ) , _river ( C ) , _traverse ( C , B ) ) , A ) )
what are the populations of the states through which the the longest river in alaska run ?	_answer ( A , ( _population ( B , A ) , _state ( B ) , _longest ( C , ( _river ( C ) , _loc ( C , D ) , _const ( D , _stateid ( alaska ) ) ) ) , _river ( C ) , _traverse ( C , B ) ) )
where is the cities which are in wisconsin ?	_answer ( A , ( _loc ( B , A ) , _city ( B ) , _loc ( B , C ) , _const ( C , _stateid ( wisconsin ) ) ) )
what is the highest point in the state with capital cities are located in colorado ?	_answer ( A , _highest ( A , ( _place ( A ) , _loc ( A , B ) , _state ( B ) , _loc ( C , B ) , _capital ( C ) , _city ( C ) , _loc ( C , D ) , _const ( D , _stateid ( colorado ) ) ) ) )
what are the major cities in the biggest state in continental us ?	_answer ( A , ( _major ( A ) , _city ( A ) , _loc ( A , B ) , _largest ( B , ( _state ( B ) , _loc ( B , C ) , _const ( C , _countryid ( usa ) ) ) ) ) )
what is the population of the major cities in the smallest state in the us ga ?	_answer ( A , ( _population ( B , A ) , _major ( B ) , _city ( B ) , _loc ( B , C ) , _smallest ( C , ( _state ( C ) , _loc ( C , D ) , _const ( D , _countryid ( usa ) ) ) ) ) )
how many people live in states have rivers named potomac ?	_answer ( A , ( _population ( B , A ) , _state ( B ) , _loc ( C , B ) , _const ( C , _riverid ( potomac ) ) ) )
which states border states through which the the rivers in the state of arkansas traverses ?	_answer ( A , ( _state ( A ) , _next_to ( A , B ) , _state ( B ) , _river ( C ) , _loc ( C , D ) , _state ( D ) , _const ( D , _stateid ( arkansas ) ) , _traverse ( C , B ) ) )
what the state with the lowest point city has the largest population ?	_answer ( A , _largest ( B , ( _state ( C ) , _loc ( D , C ) , _lowest ( D , _place ( D ) ) , _city ( A ) , _loc ( A , C ) , _population ( A , B ) ) ) )
which states does the the longest river that passes through the us run through ?	_answer ( A , ( _state ( A ) , _longest ( B , ( _river ( B ) , _traverse ( B , C ) , _const ( C , _countryid ( usa ) ) ) ) , _river ( B ) , _traverse ( B , A ) ) )
what are the populations of states through which the the biggest rivers in arizona run ?	_answer ( A , ( _population ( B , A ) , _state ( B ) , _longest ( C , ( _river ( C ) , _loc ( C , D ) , _const ( D , _stateid ( arizona ) ) ) ) , _river ( C ) , _traverse ( C , B ) ) )
how many states have a city named the biggest city in oklahoma ?	_answer ( A , _count ( B , ( _state ( B ) , _loc ( C , B ) , _largest ( C , ( _city ( C ) , _loc ( C , D ) , _const ( D , _stateid ( oklahoma ) ) ) ) ) , A ) )
what are the populations of states through which the rivers are in minnesota run ?	_answer ( A , ( _population ( B , A ) , _state ( B ) , _river ( C ) , _loc ( C , D ) , _const ( D , _stateid ( minnesota ) ) , _river ( C ) , _traverse ( C , B ) ) )
how long is the river flows through wisconsin ?	_answer ( A , ( _len ( B , A ) , _river ( B ) , _traverse ( B , C ) , _const ( C , _stateid ( wisconsin ) ) , _river ( B ) ) )
where is the biggest city in arizona ?	_answer ( A , ( _loc ( B , A ) , _largest ( B , ( _city ( B ) , _loc ( B , C ) , _const ( C , _stateid ( arizona ) ) ) ) ) )
where is the capital of maine ?	_answer ( A , ( _loc ( B , A ) , _capital ( B ) , _loc ( B , C ) , _const ( C , _stateid ( maine ) ) ) )
what states have a city named the major cities of the us ?	_answer ( A , ( _state ( A ) , _loc ( B , A ) , _major ( B ) , _city ( B ) , _loc ( B , C ) , _const ( C , _countryid ( usa ) ) ) )
how many states does the river flows through pennsylvania run through ?	_answer ( A , _count ( B , ( _state ( B ) , _river ( C ) , _traverse ( C , D ) , _const ( D , _stateid ( pennsylvania ) ) , _river ( C ) , _traverse ( C , B ) ) , A ) )
how long is the the rivers in the state of oregon ?	_answer ( A , ( _len ( B , A ) , _river ( B ) , _loc ( B , C ) , _state ( C ) , _const ( C , _stateid ( oregon ) ) ) )
what states have rivers named river flows through washington ?	_answer ( A , ( _state ( A ) , _loc ( B , A ) , _river ( B ) , _traverse ( B , C ) , _const ( C , _stateid ( washington ) ) ) )
how long is the rivers are in kansas ?	_answer ( A , ( _len ( B , A ) , _river ( B ) , _loc ( B , C ) , _const ( C , _stateid ( kansas ) ) , _river ( B ) ) )
what river runs through states border ohio ?	_answer ( A , ( _river ( A ) , _traverse ( A , B ) , _state ( B ) , _next_to ( B , C ) , _const ( C , _stateid ( ohio ) ) ) )
which states border state has the longest river ?	_answer ( A , ( _state ( A ) , _next_to ( A , B ) , _longest ( C , ( _state ( B ) , _loc ( C , B ) , _river ( C ) ) ) ) )
how high is the highest point of states have rivers named colorado river ?	_answer ( A , ( _elevation ( B , A ) , _highest ( B , ( _place ( B ) , _loc ( B , C ) , _state ( C ) , _loc ( D , C ) , _const ( D , _riverid ( colorado ) ) ) ) ) )
what are the names of the major cities in states neighbor alaska ?	_answer ( A , ( _major ( A ) , _city ( A ) , _loc ( A , B ) , _state ( B ) , _next_to ( B , C ) , _const ( C , _stateid ( alaska ) ) ) )
what are the neighboring states for states does the colorado run through ?	_answer ( A , ( _next_to ( A , B ) , _state ( A ) , _state ( B ) , _const ( C , _riverid ( colorado ) ) , _river ( C ) , _traverse ( C , B ) ) )
what major rivers run through the states that border the state with the greatest population ?	_answer ( A , ( _major ( A ) , _river ( A ) , _traverse ( A , B ) , _state ( B ) , _next_to ( C , B ) , _largest ( D , ( _state ( C ) , _population ( C , D ) ) ) ) )
what is the population of the smallest city in idaho ?	_answer ( A , ( _population ( B , A ) , _smallest ( B , ( _city ( B ) , _loc ( B , C ) , _const ( C , _stateid ( idaho ) ) ) ) ) )
how many rivers are in state has the shortest river ?	_answer ( A , _count ( B , ( _river ( B ) , _loc ( B , C ) , _state ( C ) , _loc ( D , C ) , _shortest ( D , _river ( D ) ) ) , A ) )
how many states does the the shortest river in the united states flow through ?	_answer ( A , _count ( B , ( _state ( B ) , _shortest ( C , ( _river ( C ) , _loc ( C , D ) , _const ( D , _countryid ( usa ) ) ) ) , _river ( C ) , _traverse ( C , B ) ) , A ) )
what is the population of the capital of the tennessee state ?	_answer ( A , ( _population ( B , A ) , _capital ( B ) , _loc ( B , C ) , _const ( C , _stateid ( tennessee ) ) , _state ( C ) ) )
how many states have a city named the biggest city in north carolina ?	_answer ( A , _count ( B , ( _state ( B ) , _loc ( C , B ) , _largest ( C , ( _city ( C ) , _loc ( C , D ) , _const ( D , _stateid ( ' north carolina ' ) ) ) ) ) , A ) )
what states does the major rivers run through texas run through ?	_answer ( A , ( _state ( A ) , _major ( B ) , _river ( B ) , _traverse ( B , C ) , _const ( C , _stateid ( texas ) ) , _river ( B ) , _traverse ( B , A ) ) )
what is the lowest elevation in state has the city with the largest population ?	_answer ( A , _lowest ( A , ( _place ( A ) , _loc ( A , B ) , _state ( B ) , _loc ( C , B ) , _largest ( D , ( _city ( C ) , _population ( C , D ) ) ) ) ) )
how many states have a city called the names of the major cities in washington ?	_answer ( A , _count ( B , ( _state ( B ) , _loc ( C , B ) , _major ( C ) , _city ( C ) , _loc ( C , D ) , _const ( D , _stateid ( washington ) ) ) , A ) )
what major rivers run through the biggest state in continental us ?	_answer ( A , ( _major ( A ) , _river ( A ) , _traverse ( A , B ) , _largest ( B , ( _state ( B ) , _loc ( B , C ) , _const ( C , _countryid ( usa ) ) ) ) ) )
what major rivers run through the state with the lowest point ?	_answer ( A , ( _major ( A ) , _river ( A ) , _traverse ( A , B ) , _state ( B ) , _loc ( C , B ) , _lowest ( C , _place ( C ) ) ) )
what is the population of the smallest city in georgia ?	_answer ( A , ( _population ( B , A ) , _smallest ( B , ( _city ( B ) , _loc ( B , C ) , _const ( C , _stateid ( georgia ) ) ) ) ) )
which state is the city capitals are not major cities located in ?	_answer ( A , ( _state ( A ) , _city ( B ) , _capital ( B ) , \+ ( _major ( B ) , _city ( B ) ) , _loc ( B , A ) ) )
which states border the states which have no surrounding states ?	_answer ( A , ( _state ( A ) , _next_to ( A , B ) , _state ( B ) , \+ ( _next_to ( B , C ) , _state ( C ) ) ) )
what is the highest point in state has the city with the largest population ?	_answer ( A , _highest ( A , ( _place ( A ) , _loc ( A , B ) , _state ( B ) , _loc ( C , B ) , _largest ( D , ( _city ( C ) , _population ( C , D ) ) ) ) ) )
where is the largest city in oregon by population ?	_answer ( A , ( _loc ( B , A ) , _largest ( C , ( _city ( B ) , _loc ( B , D ) , _const ( D , _stateid ( oregon ) ) , _population ( B , C ) ) ) ) )
what is the lowest point of state has the largest city ?	_answer ( A , _lowest ( A , ( _place ( A ) , _loc ( A , B ) , _largest ( C , ( _state ( B ) , _loc ( C , B ) , _city ( C ) ) ) ) ) )
what are the major cities in state has the shortest river ?	_answer ( A , ( _major ( A ) , _city ( A ) , _loc ( A , B ) , _state ( B ) , _loc ( C , B ) , _shortest ( C , _river ( C ) ) ) )
what states have rivers named major rivers run through arkansas ?	_answer ( A , ( _state ( A ) , _loc ( B , A ) , _major ( B ) , _river ( B ) , _traverse ( B , C ) , _const ( C , _stateid ( arkansas ) ) ) )
what is the highest point in states have rivers named colorado river ?	_answer ( A , _highest ( A , ( _place ( A ) , _loc ( A , B ) , _state ( B ) , _loc ( C , B ) , _const ( C , _riverid ( colorado ) ) ) ) )
where is the major cities in ohio ?	_answer ( A , ( _loc ( B , A ) , _major ( B ) , _city ( B ) , _loc ( B , C ) , _const ( C , _stateid ( ohio ) ) ) )
how long is the the biggest river in texas ?	_answer ( A , ( _len ( B , A ) , _largest ( B , ( _river ( B ) , _loc ( B , C ) , _const ( C , _stateid ( texas ) ) ) ) ) )
how many major cities are in state is the city san jose located in ?	_answer ( A , _count ( B , ( _major ( B ) , _city ( B ) , _loc ( B , C ) , _state ( C ) , _city ( D ) , _const ( D , _cityid ( ' san jose ' , _ ) ) , _loc ( D , C ) ) , A ) )
which states border state has the shortest river ?	_answer ( A , ( _state ( A ) , _next_to ( A , B ) , _state ( B ) , _loc ( C , B ) , _shortest ( C , _river ( C ) ) ) )
how many states does the major rivers run through mississippi flow through ?	_answer ( A , _count ( B , ( _state ( B ) , _major ( C ) , _river ( C ) , _traverse ( C , D ) , _const ( D , _stateid ( mississippi ) ) , _river ( C ) , _traverse ( C , B ) ) , A ) )
what river flows through states have rivers named colorado ?	_answer ( A , ( _river ( A ) , _traverse ( A , B ) , _state ( B ) , _loc ( C , B ) , _const ( C , _riverid ( colorado ) ) ) )
how long is the rivers are in ohio ?	_answer ( A , ( _len ( B , A ) , _river ( B ) , _loc ( B , C ) , _const ( C , _stateid ( ohio ) ) , _river ( B ) ) )
what are the populations of the states through which the the river that cross over alaska run ?	_answer ( A , ( _population ( B , A ) , _state ( B ) , _river ( C ) , _traverse ( C , D ) , _const ( D , _stateid ( alaska ) ) , _river ( C ) , _traverse ( C , B ) ) )
what is the largest state bordering states have points that are higher than the highest point in kentucky ?	_answer ( A , _largest ( A , ( _state ( A ) , _next_to ( A , B ) , _state ( B ) , _place ( C ) , _loc ( C , B ) , _higher ( C , D ) , _highest ( D , ( _place ( D ) , _loc ( D , E ) , _const ( E , _stateid ( kentucky ) ) ) ) ) ) )
which rivers are in states does the longest river cross ?	_answer ( A , ( _river ( A ) , _loc ( A , B ) , _state ( B ) , _longest ( C , _river ( C ) ) , _traverse ( C , B ) ) )
what is the highest point in the state with capital the capital of new york ?	_answer ( A , _highest ( A , ( _place ( A ) , _loc ( A , B ) , _state ( B ) , _loc ( C , B ) , _capital ( C ) , _capital ( C ) , _loc ( C , D ) , _const ( D , _stateid ( ' new york ' ) ) ) ) )
which state is the city the capital of kentucky located in ?	_answer ( A , ( _state ( A ) , _city ( B ) , _capital ( B ) , _loc ( B , C ) , _const ( C , _stateid ( kentucky ) ) , _loc ( B , A ) ) )
which states does the the longest river that runs through a state that borders wyoming run through ?	_answer ( A , ( _state ( A ) , _longest ( B , ( _river ( B ) , _traverse ( B , C ) , _state ( C ) , _next_to ( C , D ) , _const ( D , _stateid ( wyoming ) ) ) ) , _river ( B ) , _traverse ( B , A ) ) )
what is the highest mountain in states border states through which the missouri river traverses ?	_answer ( A , _highest ( A , ( _mountain ( A ) , _loc ( A , B ) , _state ( B ) , _next_to ( B , C ) , _state ( C ) , _const ( D , _riverid ( missouri ) ) , _traverse ( D , C ) ) ) )
how many states does the the longest river that runs through a state that borders oklahoma run through ?	_answer ( A , _count ( B , ( _state ( B ) , _longest ( C , ( _river ( C ) , _traverse ( C , D ) , _state ( D ) , _next_to ( D , E ) , _const ( E , _stateid ( oklahoma ) ) ) ) , _river ( C ) , _traverse ( C , B ) ) , A ) )
how long is the rivers run through mississippi ?	_answer ( A , ( _len ( B , A ) , _river ( B ) , _traverse ( B , C ) , _const ( C , _stateid ( mississippi ) ) , _river ( B ) ) )
what states border states that border the smallest state in the usa ?	_answer ( A , ( _state ( A ) , _next_to ( A , B ) , _state ( B ) , _next_to ( B , C ) , _smallest ( C , ( _state ( C ) , _loc ( C , D ) , _const ( D , _countryid ( usa ) ) ) ) ) )
which states does the major rivers run through idaho run through ?	_answer ( A , ( _state ( A ) , _major ( B ) , _river ( B ) , _traverse ( B , C ) , _const ( C , _stateid ( idaho ) ) , _river ( B ) , _traverse ( B , A ) ) )
how many states have a city named the biggest city in delaware ?	_answer ( A , _count ( B , ( _state ( B ) , _loc ( C , B ) , _largest ( C , ( _city ( C ) , _loc ( C , D ) , _const ( D , _stateid ( delaware ) ) ) ) ) , A ) )
how long is the the shortest river in the united states ?	_answer ( A , ( _len ( B , A ) , _shortest ( B , ( _river ( B ) , _loc ( B , C ) , _const ( C , _countryid ( usa ) ) ) ) , _river ( B ) ) )
what is the highest point in the state with capital the capital of north carolina ?	_answer ( A , _highest ( A , ( _place ( A ) , _loc ( A , B ) , _state ( B ) , _loc ( C , B ) , _capital ( C ) , _capital ( C ) , _loc ( C , D ) , _const ( D , _stateid ( ' north carolina ' ) ) ) ) )
what are the major cities in state has the city with the largest population ?	_answer ( A , ( _major ( A ) , _city ( A ) , _loc ( A , B ) , _state ( B ) , _loc ( C , B ) , _largest ( D , ( _city ( C ) , _population ( C , D ) ) ) ) )
how many cities named the biggest city in california are there in the usa ?	_answer ( A , _count ( B , ( _city ( B ) , _largest ( B , ( _city ( B ) , _loc ( B , D ) , _const ( D , _stateid ( california ) ) ) ) , _loc ( B , C ) , _const ( C , _countryid ( usa ) ) ) , A ) )
how many rivers are in state is the largest city in oklahoma in ?	_answer ( A , _count ( B , ( _river ( B ) , _loc ( B , C ) , _state ( C ) , _largest ( D , ( _city ( D ) , _loc ( D , E ) , _const ( E , _stateid ( oklahoma ) ) ) ) , _loc ( D , C ) ) , A ) )
give me the cities which are in the states that border the state with the greatest population ?	_answer ( A , ( _city ( A ) , _loc ( A , B ) , _state ( B ) , _next_to ( C , B ) , _largest ( D , ( _state ( C ) , _population ( C , D ) ) ) ) )
what are the populations of the states through which the the rivers in the state of arizona run ?	_answer ( A , ( _population ( B , A ) , _state ( B ) , _river ( C ) , _loc ( C , D ) , _state ( D ) , _const ( D , _stateid ( arizona ) ) , _river ( C ) , _traverse ( C , B ) ) )
what is the population of the smallest city in wyoming ?	_answer ( A , ( _population ( B , A ) , _smallest ( B , ( _city ( B ) , _loc ( B , C ) , _const ( C , _stateid ( wyoming ) ) ) ) ) )
how long is the is the shortest river ?	_answer ( A , ( _len ( B , A ) , _shortest ( B , _river ( B ) ) , _river ( B ) ) )
how many rivers are in the states ?	_answer ( A , _count ( B , ( _river ( B ) , _loc ( B , C ) , _state ( C ) ) , A ) )
how many rivers are in the largest state bordering indiana ?	_answer ( A , _count ( B , ( _river ( B ) , _loc ( B , C ) , _largest ( C , ( _state ( C ) , _next_to ( C , D ) , _const ( D , _stateid ( indiana ) ) ) ) ) , A ) )
what is the population of the major cities in rhode island ga ?	_answer ( A , ( _population ( B , A ) , _major ( B ) , _city ( B ) , _loc ( B , C ) , _const ( C , _stateid ( ' rhode island ' ) ) ) )
which states border states through which the river runs through utah traverses ?	_answer ( A , ( _state ( A ) , _next_to ( A , B ) , _state ( B ) , _river ( C ) , _traverse ( C , D ) , _const ( D , _stateid ( utah ) ) , _traverse ( C , B ) ) )
what are the populations of states through which the is the shortest river run ?	_answer ( A , ( _population ( B , A ) , _state ( B ) , _shortest ( C , _river ( C ) ) , _river ( C ) , _traverse ( C , B ) ) )
what is the total population of the states that border the adjacent state of ohio ?	_answer ( A , _sum ( C , ( _state ( C ) , _next_to ( D , C ) , _next_to ( D , E ) , _state ( D ) , _const ( E , _stateid ( ohio ) ) ) , _population ( C ) , A ) )
how long is the the longest river that runs through a state that borders kansas ?	_answer ( A , ( _len ( B , A ) , _longest ( B , ( _river ( B ) , _traverse ( B , C ) , _state ( C ) , _next_to ( C , D ) , _const ( D , _stateid ( kansas ) ) ) ) ) )
what are the biggest rivers in the states which have no surrounding states ?	_answer ( A , _longest ( A , ( _river ( A ) , _loc ( A , B ) , _state ( B ) , \+ ( _next_to ( B , C ) , _state ( C ) ) ) ) )
in which state is the major cities in south carolina ?	_answer ( A , ( _loc ( B , A ) , _state ( A ) , _major ( B ) , _city ( B ) , _loc ( B , C ) , _const ( C , _stateid ( ' south carolina ' ) ) ) )
how many citizens in states border states that border washington ?	_answer ( A , ( _population ( B , A ) , _state ( B ) , _next_to ( B , C ) , _state ( C ) , _next_to ( C , D ) , _const ( D , _stateid ( washington ) ) ) )
how many states have a city called the largest city in arizona by population ?	_answer ( A , _count ( B , ( _state ( B ) , _loc ( C , B ) , _largest ( D , ( _city ( C ) , _loc ( C , E ) , _const ( E , _stateid ( arizona ) ) , _population ( C , D ) ) ) ) , A ) )
which states border states through which the the biggest rivers in wisconsin traverses ?	_answer ( A , ( _state ( A ) , _next_to ( A , B ) , _state ( B ) , _longest ( C , ( _river ( C ) , _loc ( C , D ) , _const ( D , _stateid ( wisconsin ) ) ) ) , _traverse ( C , B ) ) )
how many states have a city called the major cities in the smallest state in the us ?	_answer ( A , _count ( B , ( _state ( B ) , _loc ( C , B ) , _major ( C ) , _city ( C ) , _loc ( C , D ) , _smallest ( D , ( _state ( D ) , _loc ( D , E ) , _const ( E , _countryid ( usa ) ) ) ) ) , A ) )
what are the states that the all the rivers in kentucky run through ?	_answer ( A , ( _state ( A ) , _river ( B ) , _loc ( B , C ) , _const ( C , _stateid ( kentucky ) ) , _traverse ( B , A ) ) )
how long is the river runs through nebraska ?	_answer ( A , ( _len ( B , A ) , _river ( B ) , _traverse ( B , C ) , _const ( C , _stateid ( nebraska ) ) ) )
how many states have a city called the names of the major cities in louisiana ?	_answer ( A , _count ( B , ( _state ( B ) , _loc ( C , B ) , _major ( C ) , _city ( C ) , _loc ( C , D ) , _const ( D , _stateid ( louisiana ) ) ) , A ) )
how many cities named capitals are in the states that border georgia are there in the usa ?	_answer ( A , _count ( B , ( _city ( B ) , _capital ( B ) , _loc ( B , D ) , _state ( D ) , _next_to ( D , E ) , _const ( E , _stateid ( georgia ) ) , _loc ( B , C ) , _const ( C , _countryid ( usa ) ) ) , A ) )
what are the populations of states through which the the biggest rivers in massachusetts run ?	_answer ( A , ( _population ( B , A ) , _state ( B ) , _longest ( C , ( _river ( C ) , _loc ( C , D ) , _const ( D , _stateid ( massachusetts ) ) ) ) , _river ( C ) , _traverse ( C , B ) ) )
which capitals are in the states that border the adjacent state of nebraska ?	_answer ( A , ( _capital ( A ) , _loc ( A , B ) , _state ( B ) , _next_to ( B , C ) , _next_to ( C , D ) , _state ( C ) , _const ( D , _stateid ( nebraska ) ) ) )
how many citizens in state has highest elevation ?	_answer ( A , ( _population ( B , A ) , _state ( B ) , _loc ( C , B ) , _highest ( C , _place ( C ) ) ) )
what is the population of the major cities in oregon ?	_answer ( A , ( _population ( B , A ) , _major ( B ) , _city ( B ) , _loc ( B , C ) , _const ( C , _stateid ( oregon ) ) ) )
what is the highest point in the state with capital the largest city in arkansas by population ?	_answer ( A , _highest ( A , ( _place ( A ) , _loc ( A , B ) , _state ( B ) , _loc ( C , B ) , _capital ( C ) , _largest ( D , ( _city ( C ) , _loc ( C , E ) , _const ( E , _stateid ( arkansas ) ) , _population ( C , D ) ) ) ) ) )
how high is the highest point of states border indiana ?	_answer ( A , ( _elevation ( B , A ) , _highest ( B , ( _place ( B ) , _loc ( B , C ) , _state ( C ) , _next_to ( C , D ) , _const ( D , _stateid ( indiana ) ) ) ) ) )
what is the highest elevation in states does the missouri river run through ?	_answer ( A , _highest ( A , ( _place ( A ) , _loc ( A , B ) , _state ( B ) , _const ( C , _riverid ( missouri ) ) , _river ( C ) , _traverse ( C , B ) ) ) )
how many states does the the river that cross over west virginia run through ?	_answer ( A , _count ( B , ( _state ( B ) , _river ( C ) , _traverse ( C , D ) , _const ( D , _stateid ( ' west virginia ' ) ) , _river ( C ) , _traverse ( C , B ) ) , A ) )
how many cities named the capital of the texas state are there in the usa ?	_answer ( A , _count ( B , ( _city ( B ) , _capital ( B ) , _loc ( B , D ) , _const ( D , _stateid ( texas ) ) , _state ( D ) , _loc ( B , C ) , _const ( C , _countryid ( usa ) ) ) , A ) )
name all the rivers in states have points that are higher than the highest point in rhode island ?	_answer ( A , ( _river ( A ) , _loc ( A , B ) , _state ( B ) , _place ( C ) , _loc ( C , B ) , _higher ( C , D ) , _highest ( D , ( _place ( D ) , _loc ( D , E ) , _const ( E , _stateid ( ' rhode island ' ) ) ) ) ) )
what states does the all the rivers in ohio run through ?	_answer ( A , ( _state ( A ) , _river ( B ) , _loc ( B , C ) , _const ( C , _stateid ( ohio ) ) , _river ( B ) , _traverse ( B , A ) ) )
what states have rivers named the major rivers in the us ?	_answer ( A , ( _state ( A ) , _loc ( B , A ) , _major ( B ) , _river ( B ) , _loc ( B , C ) , _const ( C , _countryid ( usa ) ) ) )
what states border states that border states border states that border wyoming ?	_answer ( A , ( _state ( A ) , _next_to ( A , B ) , _state ( B ) , _next_to ( B , C ) , _state ( C ) , _next_to ( C , D ) , _state ( D ) , _next_to ( D , E ) , _const ( E , _stateid ( wyoming ) ) ) )
how many states does the the river that cross over washington flow through ?	_answer ( A , _count ( B , ( _state ( B ) , _river ( C ) , _traverse ( C , D ) , _const ( D , _stateid ( washington ) ) , _river ( C ) , _traverse ( C , B ) ) , A ) )
what is the largest state bordering states border states that border indiana ?	_answer ( A , _largest ( A , ( _state ( A ) , _next_to ( A , B ) , _state ( B ) , _next_to ( B , C ) , _state ( C ) , _next_to ( C , D ) , _const ( D , _stateid ( indiana ) ) ) ) )
how long is the the rivers in the state of tennessee ?	_answer ( A , ( _len ( B , A ) , _river ( B ) , _loc ( B , C ) , _state ( C ) , _const ( C , _stateid ( tennessee ) ) , _river ( B ) ) )
what states does the rivers flow through the state with the largest population run through ?	_answer ( A , ( _state ( A ) , _river ( B ) , _traverse ( B , C ) , _largest ( D , ( _state ( C ) , _population ( C , D ) ) ) , _river ( B ) , _traverse ( B , A ) ) )
what states have a city named the names of the major cities in kentucky ?	_answer ( A , ( _state ( A ) , _loc ( B , A ) , _major ( B ) , _city ( B ) , _loc ( B , C ) , _const ( C , _stateid ( kentucky ) ) ) )
what is the highest point in the biggest state in continental us ?	_answer ( A , _highest ( A , ( _place ( A ) , _loc ( A , B ) , _largest ( B , ( _state ( B ) , _loc ( B , C ) , _const ( C , _countryid ( usa ) ) ) ) ) ) )
what states have a city named the capital of west virginia ?	_answer ( A , ( _state ( A ) , _loc ( B , A ) , _capital ( B ) , _loc ( B , C ) , _const ( C , _stateid ( ' west virginia ' ) ) ) )
what states have a city named the biggest city in the usa ?	_answer ( A , ( _state ( A ) , _loc ( B , A ) , _largest ( B , ( _city ( B ) , _loc ( B , C ) , _const ( C , _countryid ( usa ) ) ) ) ) )
