housing found in two or less neighborhoods	( call SW.listValue ( call SW.countComparative ( call SW.getProperty ( call SW.singleton en.housing_unit ) ( string ! type ) ) ( string neighborhood ) ( string <= ) ( number 2 ) ) )
which housing unit offers a private bath	( call SW.listValue ( call SW.filter ( call SW.filter ( call SW.getProperty ( call SW.singleton en.housing_unit ) ( string ! type ) ) ( string has_private_bath ) ) ( string has_private_bath ) ) )
seeking houses in quiet neighborhoods	( call SW.listValue ( call SW.countSuperlative ( call SW.getProperty ( call SW.singleton en.housing_unit ) ( string ! type ) ) ( string min ) ( string housing_type ) ) )
find housing units with unique housing types	( call SW.listValue ( call SW.countSuperlative ( call SW.getProperty ( call SW.singleton en.housing_unit ) ( string ! type ) ) ( string min ) ( string housing_type ) ) )
housing unit with a posting date at the latest january 2	( call SW.listValue ( call SW.filter ( call SW.getProperty ( call SW.singleton en.housing_unit ) ( string ! type ) ) ( call SW.ensureNumericProperty ( string posting_date ) ) ( string <= ) ( call SW.ensureNumericEntity ( date 2015 1 2 ) ) ) )
apartments with less than 2 units	( call SW.listValue ( call SW.countComparative ( call SW.getProperty ( call SW.singleton en.housing_unit ) ( string ! type ) ) ( string housing_type ) ( string < ) ( number 2 ) ) )
show me the housing with the most space available	( call SW.listValue ( call SW.superlative ( call SW.getProperty ( call SW.singleton en.housing_unit ) ( string ! type ) ) ( string max ) ( call SW.ensureNumericProperty ( string size ) ) ) )
apartments that are dog friendly	( call SW.listValue ( call SW.filter ( call SW.filter ( call SW.getProperty ( call SW.singleton en.housing_unit ) ( string ! type ) ) ( string allows_dogs ) ) ( string allows_dogs ) ) )
list all housing that is smaller than 800 square feet	( call SW.listValue ( call SW.filter ( call SW.getProperty ( call SW.singleton en.housing_unit ) ( string ! type ) ) ( call SW.ensureNumericProperty ( string size ) ) ( string < ) ( call SW.ensureNumericEntity ( number 800 en.square_feet ) ) ) )
what housing units in the midtown east area also allow dogs	( call SW.listValue ( call SW.filter ( call SW.filter ( call SW.getProperty ( call SW.singleton en.housing_unit ) ( string ! type ) ) ( string allows_dogs ) ) ( string neighborhood ) ( string = ) en.neighborhood.midtown_west ) )
find housing unit with the latest posting date	( call SW.listValue ( call SW.superlative ( call SW.getProperty ( call SW.singleton en.housing_unit ) ( string ! type ) ) ( string min ) ( call SW.ensureNumericProperty ( string posting_date ) ) ) )
housing listed in the fewest neighborhoods	( call SW.listValue ( call SW.countSuperlative ( call SW.getProperty ( call SW.singleton en.housing_unit ) ( string ! type ) ) ( string min ) ( string neighborhood ) ) )
neighborhood that has at least 2 apartments	( call SW.listValue ( call SW.countComparative ( call SW.getProperty ( call SW.singleton en.neighborhood ) ( string ! type ) ) ( call SW.reverse ( string neighborhood ) ) ( string >= ) ( number 2 ) ( call SW.getProperty ( call SW.singleton en.housing_unit ) ( string ! type ) ) ) )
housing that rents for at least 1500 per month	( call SW.listValue ( call SW.filter ( call SW.getProperty ( call SW.singleton en.housing_unit ) ( string ! type ) ) ( call SW.ensureNumericProperty ( string rent ) ) ( string >= ) ( call SW.ensureNumericEntity ( number 1500 en.dollar ) ) ) )
housing unit that allows dogs and has a private bath	( call SW.listValue ( call SW.filter ( call SW.filter ( call SW.getProperty ( call SW.singleton en.housing_unit ) ( string ! type ) ) ( string allows_dogs ) ) ( string has_private_bath ) ) )
apartment in a quiet neighborhood	( call SW.listValue ( call SW.countSuperlative ( call SW.getProperty ( call SW.singleton en.housing_unit ) ( string ! type ) ) ( string min ) ( string neighborhood ) ) )
housing posted the same day or after 123 sesame street	( call SW.listValue ( call SW.filter ( call SW.getProperty ( call SW.singleton en.housing_unit ) ( string ! type ) ) ( call SW.ensureNumericProperty ( string posting_date ) ) ( string >= ) ( call SW.ensureNumericEntity ( call SW.getProperty en.housing_unit.123_sesame_street ( string posting_date ) ) ) ) )
apartments at 800 square feet	( call SW.listValue ( call SW.filter ( call SW.filter ( call SW.getProperty ( call SW.singleton en.housing_unit ) ( string ! type ) ) ( string housing_type ) ( string = ) en.housing.apartment ) ( string size ) ( string = ) ( number 800 en.square_feet ) ) )
which housing type allows pets	( call SW.listValue ( call SW.filter ( call SW.getProperty ( call SW.singleton en.housing ) ( string ! type ) ) ( call SW.reverse ( string housing_type ) ) ( string = ) ( call SW.filter ( call SW.getProperty ( call SW.singleton en.housing_unit ) ( string ! type ) ) ( string allows_dogs ) ) ) )
which housing unit is posted before  the posting date of 123 sesame street	( call SW.listValue ( call SW.filter ( call SW.getProperty ( call SW.singleton en.housing_unit ) ( string ! type ) ) ( call SW.ensureNumericProperty ( string posting_date ) ) ( string < ) ( call SW.ensureNumericEntity ( call SW.getProperty en.housing_unit.123_sesame_street ( string posting_date ) ) ) ) )
list all housing units that are apartments	( call SW.listValue ( call SW.filter ( call SW.getProperty ( call SW.singleton en.housing_unit ) ( string ! type ) ) ( string housing_type ) ( string = ) en.housing.apartment ) )
find the housing unit with the most monthly rent	( call SW.listValue ( call SW.superlative ( call SW.getProperty ( call SW.singleton en.housing_unit ) ( string ! type ) ) ( string max ) ( call SW.ensureNumericProperty ( string rent ) ) ) )
unit larger than 800 square feet	( call SW.listValue ( call SW.filter ( call SW.getProperty ( call SW.singleton en.housing_unit ) ( string ! type ) ) ( call SW.ensureNumericProperty ( string size ) ) ( string > ) ( call SW.ensureNumericEntity ( number 800 en.square_feet ) ) ) )
which housing unit is in the area of 123 sesame street	( call SW.listValue ( call SW.filter ( call SW.getProperty ( call SW.singleton en.housing_unit ) ( string ! type ) ) ( string neighborhood ) ( string = ) ( call SW.filter ( call SW.getProperty ( call SW.singleton en.neighborhood ) ( string ! type ) ) ( call SW.reverse ( string neighborhood ) ) ( string = ) en.housing_unit.123_sesame_street ) ) )
find cat friendly housing units with a private bath	( call SW.listValue ( call SW.filter ( call SW.filter ( call SW.getProperty ( call SW.singleton en.housing_unit ) ( string ! type ) ) ( string allows_cats ) ) ( string has_private_bath ) ) )
units larger than 800 square feet	( call SW.listValue ( call SW.filter ( call SW.getProperty ( call SW.singleton en.housing_unit ) ( string ! type ) ) ( call SW.ensureNumericProperty ( string size ) ) ( string > ) ( call SW.ensureNumericEntity ( call SW.concat ( number 800 en.square_feet ) ( number 1000 en.square_feet ) ) ) ) )
800 square foot apartment for 1500 rent	( call SW.listValue ( call SW.filter ( call SW.filter ( call SW.getProperty ( call SW.singleton en.housing_unit ) ( string ! type ) ) ( string rent ) ( string = ) ( number 1500 en.dollar ) ) ( string size ) ( string = ) ( number 800 en.square_feet ) ) )
housing with more square footage than 123 sesame street	( call SW.listValue ( call SW.filter ( call SW.getProperty ( call SW.singleton en.housing_unit ) ( string ! type ) ) ( call SW.ensureNumericProperty ( string size ) ) ( string > ) ( call SW.ensureNumericEntity ( call SW.getProperty en.housing_unit.123_sesame_street ( string size ) ) ) ) )
housing that is not the same kind as 123 sesame street	( call SW.listValue ( call SW.filter ( call SW.getProperty ( call SW.singleton en.housing ) ( string ! type ) ) ( call SW.reverse ( string housing_type ) ) ( string ! = ) en.housing_unit.123_sesame_street ) )
neighborhoods with housing units with private rooms	( call SW.listValue ( call SW.filter ( call SW.getProperty ( call SW.singleton en.neighborhood ) ( string ! type ) ) ( call SW.reverse ( string neighborhood ) ) ( string = ) ( call SW.filter ( call SW.getProperty ( call SW.singleton en.housing_unit ) ( string ! type ) ) ( string has_private_room ) ) ) )
list all housing that have the size of 800 or 1000 square feet	( call SW.listValue ( call SW.concat ( number 800 en.square_feet ) ( number 1000 en.square_feet ) ) )
what is the monthly rent at 123 sesame street	( call SW.listValue ( call SW.getProperty en.housing_unit.123_sesame_street ( string rent ) ) )
housing that accepts dogs	( call SW.listValue ( call SW.filter ( call SW.getProperty ( call SW.singleton en.housing_unit ) ( string ! type ) ) ( string allows_dogs ) ) )
what neighborhood is 123 sesame street in	( call SW.listValue ( call SW.getProperty en.housing_unit.123_sesame_street ( string neighborhood ) ) )
800 square foot apartments	( call SW.listValue ( call SW.filter ( call SW.getProperty ( call SW.singleton en.housing_unit ) ( string ! type ) ) ( call SW.ensureNumericProperty ( string size ) ) ( string <= ) ( call SW.ensureNumericEntity ( number 800 en.square_feet ) ) ) )
dogfriendly housing that is 800 square feet	( call SW.listValue ( call SW.filter ( call SW.filter ( call SW.getProperty ( call SW.singleton en.housing_unit ) ( string ! type ) ) ( string size ) ( string = ) ( number 800 en.square_feet ) ) ( string allows_dogs ) ) )
show only neighborhood units of 800 square feet	( call SW.listValue ( call SW.filter ( call SW.getProperty ( call SW.singleton en.neighborhood ) ( string ! type ) ) ( call SW.reverse ( string neighborhood ) ) ( string = ) ( call SW.filter ( call SW.getProperty ( call SW.singleton en.housing_unit ) ( string ! type ) ) ( string size ) ( string = ) ( number 800 en.square_feet ) ) ) )
housing unit that allows cats	( call SW.listValue ( call SW.filter ( call SW.filter ( call SW.getProperty ( call SW.singleton en.housing_unit ) ( string ! type ) ) ( string allows_cats ) ) ( string allows_cats ) ) )
find a housing that is no more than 800 square feet	( call SW.listValue ( call SW.filter ( call SW.getProperty ( call SW.singleton en.housing_unit ) ( string ! type ) ) ( call SW.ensureNumericProperty ( string size ) ) ( string <= ) ( call SW.ensureNumericEntity ( number 800 en.square_feet ) ) ) )
apartments with at least 2 units	( call SW.listValue ( call SW.countComparative ( call SW.getProperty ( call SW.singleton en.housing ) ( string ! type ) ) ( call SW.reverse ( string housing_type ) ) ( string >= ) ( number 2 ) ( call SW.getProperty ( call SW.singleton en.housing_unit ) ( string ! type ) ) ) )
neighborhood with the fewest amount of housing units	( call SW.listValue ( call SW.countSuperlative ( call SW.getProperty ( call SW.singleton en.neighborhood ) ( string ! type ) ) ( string min ) ( call SW.reverse ( string neighborhood ) ) ( call SW.getProperty ( call SW.singleton en.housing_unit ) ( string ! type ) ) ) )
housing that is not an apartment	( call SW.listValue ( call SW.filter ( call SW.getProperty ( call SW.singleton en.housing_unit ) ( string ! type ) ) ( string housing_type ) ( string ! = ) en.housing.apartment ) )
find housing units posted before 123 sesame street	( call SW.listValue ( call SW.filter ( call SW.getProperty ( call SW.singleton en.housing_unit ) ( string ! type ) ) ( call SW.ensureNumericProperty ( string posting_date ) ) ( string > ) ( call SW.ensureNumericEntity ( call SW.getProperty en.housing_unit.123_sesame_street ( string posting_date ) ) ) ) )
show me places with a private room where cats are welcome	( call SW.listValue ( call SW.filter ( call SW.filter ( call SW.getProperty ( call SW.singleton en.housing_unit ) ( string ! type ) ) ( string allows_cats ) ) ( string has_private_room ) ) )
apartment with rent between 1500 and 2000	( call SW.listValue ( call SW.filter ( call SW.getProperty ( call SW.singleton en.housing_unit ) ( string ! type ) ) ( string rent ) ( string = ) ( call SW.concat ( number 1500 en.dollar ) ( number 2000 en.dollar ) ) ) )
smallest apartments	( call SW.listValue ( call SW.superlative ( call SW.getProperty ( call SW.singleton en.housing_unit ) ( string ! type ) ) ( string min ) ( call SW.ensureNumericProperty ( string size ) ) ) )
find housing units that are same as or lesser than the size of 123 sesame street	( call SW.listValue ( call SW.filter ( call SW.getProperty ( call SW.singleton en.housing_unit ) ( string ! type ) ) ( call SW.ensureNumericProperty ( string size ) ) ( string <= ) ( call SW.ensureNumericEntity ( call SW.getProperty en.housing_unit.123_sesame_street ( string size ) ) ) ) )
which housing unit is more expensive than 123 sesame street	( call SW.listValue ( call SW.filter ( call SW.getProperty ( call SW.singleton en.housing_unit ) ( string ! type ) ) ( call SW.ensureNumericProperty ( string rent ) ) ( string > ) ( call SW.ensureNumericEntity ( call SW.getProperty en.housing_unit.123_sesame_street ( string rent ) ) ) ) )
which housing units are at least 800 square feet in size	( call SW.listValue ( call SW.filter ( call SW.getProperty ( call SW.singleton en.housing_unit ) ( string ! type ) ) ( call SW.ensureNumericProperty ( string size ) ) ( string >= ) ( call SW.ensureNumericEntity ( number 800 en.square_feet ) ) ) )
housing that is beetween 800 and 1000 square feet	( call SW.listValue ( call SW.filter ( call SW.getProperty ( call SW.singleton en.housing_unit ) ( string ! type ) ) ( call SW.ensureNumericProperty ( string size ) ) ( string >= ) ( call SW.ensureNumericEntity ( call SW.concat ( number 800 en.square_feet ) ( number 1000 en.square_feet ) ) ) ) )
apartments with a rent below 1500 a month	( call SW.listValue ( call SW.filter ( call SW.getProperty ( call SW.singleton en.housing_unit ) ( string ! type ) ) ( string rent ) ( string ! = ) ( number 1500 en.dollar ) ) )
housing unit with a post date earlier than january 2	( call SW.listValue ( call SW.filter ( call SW.getProperty ( call SW.singleton en.housing_unit ) ( string ! type ) ) ( call SW.ensureNumericProperty ( string posting_date ) ) ( string < ) ( call SW.ensureNumericEntity ( date 2015 1 2 ) ) ) )
what kind of housing is 123 sesame street	( call SW.listValue ( call SW.getProperty en.housing_unit.123_sesame_street ( string housing_type ) ) )
apartments posted before 123 sesame street was posted	( call SW.listValue ( call SW.filter ( call SW.getProperty ( call SW.singleton en.housing_unit ) ( string ! type ) ) ( call SW.ensureNumericProperty ( string posting_date ) ) ( string < ) ( call SW.ensureNumericEntity ( call SW.getProperty en.housing_unit.123_sesame_street ( string posting_date ) ) ) ) )
housing that is not 1500month	( call SW.listValue ( call SW.filter ( call SW.getProperty ( call SW.singleton en.housing_unit ) ( string ! type ) ) ( string rent ) ( string ! = ) ( number 1500 en.dollar ) ) )
housing that is 1500month and includes a private room	( call SW.listValue ( call SW.filter ( call SW.filter ( call SW.getProperty ( call SW.singleton en.housing_unit ) ( string ! type ) ) ( string rent ) ( string = ) ( number 1500 en.dollar ) ) ( string has_private_room ) ) )
apartments that permit cats	( call SW.listValue ( call SW.filter ( call SW.filter ( call SW.getProperty ( call SW.singleton en.housing_unit ) ( string ! type ) ) ( string allows_cats ) ) ( string housing_type ) ( string = ) en.housing.apartment ) )
housing apartments that allows cats	( call SW.listValue ( call SW.filter ( call SW.filter ( call SW.getProperty ( call SW.singleton en.housing_unit ) ( string ! type ) ) ( string allows_cats ) ) ( string housing_type ) ( string = ) en.housing.apartment ) )
neighborhoods with housing that is 1500month	( call SW.listValue ( call SW.filter ( call SW.getProperty ( call SW.singleton en.neighborhood ) ( string ! type ) ) ( call SW.reverse ( string neighborhood ) ) ( string = ) ( call SW.filter ( call SW.getProperty ( call SW.singleton en.housing_unit ) ( string ! type ) ) ( string rent ) ( string = ) ( number 1500 en.dollar ) ) ) )
housing unit that is 800 or 1000 square feet	( call SW.listValue ( call SW.filter ( call SW.getProperty ( call SW.singleton en.housing_unit ) ( string ! type ) ) ( string size ) ( string = ) ( call SW.concat ( number 800 en.square_feet ) ( number 1000 en.square_feet ) ) ) )
housing units with less than two nieghborhoods	( call SW.listValue ( call SW.countComparative ( call SW.getProperty ( call SW.singleton en.housing_unit ) ( string ! type ) ) ( string neighborhood ) ( string < ) ( number 2 ) ) )
800 square foot apartments in midtown west	( call SW.listValue ( call SW.filter ( call SW.filter ( call SW.getProperty ( call SW.singleton en.housing_unit ) ( string ! type ) ) ( string neighborhood ) ( string = ) en.neighborhood.midtown_west ) ( string size ) ( string = ) ( number 800 en.square_feet ) ) )
seeking apartment or condo	( call SW.listValue ( call SW.concat en.housing.apartment en.housing.condo ) )
housing under 800 square feet	( call SW.listValue ( call SW.filter ( call SW.getProperty ( call SW.singleton en.housing_unit ) ( string ! type ) ) ( call SW.ensureNumericProperty ( string size ) ) ( string < ) ( call SW.ensureNumericEntity ( number 800 en.square_feet ) ) ) )
what neighborhood is the 800 square foot apartment in	( call SW.listValue ( call SW.filter ( call SW.getProperty ( call SW.singleton en.neighborhood ) ( string ! type ) ) ( call SW.reverse ( string neighborhood ) ) ( string = ) ( call SW.filter ( call SW.getProperty ( call SW.singleton en.housing_unit ) ( string ! type ) ) ( string size ) ( string = ) ( number 800 en.square_feet ) ) ) )
housing type of more than two available housings	( call SW.listValue ( call SW.countComparative ( call SW.getProperty ( call SW.singleton en.housing ) ( string ! type ) ) ( call SW.reverse ( string housing_type ) ) ( string > ) ( number 2 ) ( call SW.getProperty ( call SW.singleton en.housing_unit ) ( string ! type ) ) ) )
how large is 123 sesame street	( call SW.listValue ( call SW.getProperty en.housing_unit.123_sesame_street ( string size ) ) )
cheapest places to rent	( call SW.listValue ( call SW.superlative ( call SW.getProperty ( call SW.singleton en.housing_unit ) ( string ! type ) ) ( string min ) ( call SW.ensureNumericProperty ( string rent ) ) ) )
housing that is over 800 square feet or over 1000 square feet	( call SW.listValue ( call SW.filter ( call SW.getProperty ( call SW.singleton en.housing_unit ) ( string ! type ) ) ( call SW.ensureNumericProperty ( string size ) ) ( string > ) ( call SW.ensureNumericEntity ( call SW.concat ( number 800 en.square_feet ) ( number 1000 en.square_feet ) ) ) ) )
housing unit bigger than 800 square feet	( call SW.listValue ( call SW.filter ( call SW.getProperty ( call SW.singleton en.housing_unit ) ( string ! type ) ) ( call SW.ensureNumericProperty ( string size ) ) ( string >= ) ( call SW.ensureNumericEntity ( number 800 en.square_feet ) ) ) )
apartment for rent at 1500	( call SW.listValue ( call SW.filter ( call SW.getProperty ( call SW.singleton en.housing_unit ) ( string ! type ) ) ( string rent ) ( string = ) ( number 1500 en.dollar ) ) )
800 square feet housing unit with a private bath	( call SW.listValue ( call SW.filter ( call SW.filter ( call SW.getProperty ( call SW.singleton en.housing_unit ) ( string ! type ) ) ( string size ) ( string = ) ( number 800 en.square_feet ) ) ( string has_private_bath ) ) )
apartment with a private room	( call SW.listValue ( call SW.filter ( call SW.filter ( call SW.getProperty ( call SW.singleton en.housing_unit ) ( string ! type ) ) ( string housing_type ) ( string = ) en.housing.apartment ) ( string has_private_room ) ) )
neighborhood with the most available housing	( call SW.listValue ( call SW.countSuperlative ( call SW.getProperty ( call SW.singleton en.neighborhood ) ( string ! type ) ) ( string max ) ( call SW.reverse ( string neighborhood ) ) ( call SW.getProperty ( call SW.singleton en.housing_unit ) ( string ! type ) ) ) )
what is the date of 123 sesame street posting	( call SW.listValue ( call SW.getProperty en.housing_unit.123_sesame_street ( string posting_date ) ) )
show me apartments and condos	( call SW.listValue ( call SW.filter ( call SW.getProperty ( call SW.singleton en.housing_unit ) ( string ! type ) ) ( string housing_type ) ( string = ) ( call SW.concat en.housing.apartment en.housing.condo ) ) )
find housing units posted after 123 sesame street	( call SW.listValue ( call SW.filter ( call SW.getProperty ( call SW.singleton en.housing_unit ) ( string ! type ) ) ( call SW.ensureNumericProperty ( string posting_date ) ) ( string < ) ( call SW.ensureNumericEntity ( call SW.getProperty en.housing_unit.123_sesame_street ( string posting_date ) ) ) ) )
housing with 2 surrounding neighborhoods	( call SW.listValue ( call SW.countComparative ( call SW.getProperty ( call SW.singleton en.housing_unit ) ( string ! type ) ) ( string neighborhood ) ( string <= ) ( number 2 ) ) )
show me housing in midtown west where rent is 1500 dollars a month	( call SW.listValue ( call SW.filter ( call SW.filter ( call SW.getProperty ( call SW.singleton en.housing_unit ) ( string ! type ) ) ( string neighborhood ) ( string = ) en.neighborhood.midtown_west ) ( string rent ) ( string = ) ( number 1500 en.dollar ) ) )
housing unit in midtown west that has monthly rent of 1500	( call SW.listValue ( call SW.filter ( call SW.filter ( call SW.getProperty ( call SW.singleton en.housing_unit ) ( string ! type ) ) ( string rent ) ( string = ) ( number 1500 en.dollar ) ) ( string neighborhood ) ( string = ) en.neighborhood.midtown_west ) )
which housing units permit dogs and cats	( call SW.listValue ( call SW.filter ( call SW.filter ( call SW.getProperty ( call SW.singleton en.housing_unit ) ( string ! type ) ) ( string allows_cats ) ) ( string allows_dogs ) ) )
how big is 123 sesame street	( call SW.listValue ( call SW.getProperty en.housing_unit.123_sesame_street ( string size ) ) )
housing in the neighborhood of 123 sesame street	( call SW.listValue ( call SW.filter ( call SW.getProperty ( call SW.singleton en.housing_unit ) ( string ! type ) ) ( string neighborhood ) ( string = ) ( call SW.getProperty en.housing_unit.123_sesame_street ( string neighborhood ) ) ) )
apartments for rent below 1500	( call SW.listValue ( call SW.filter ( call SW.getProperty ( call SW.singleton en.housing_unit ) ( string ! type ) ) ( call SW.ensureNumericProperty ( string rent ) ) ( string <= ) ( call SW.ensureNumericEntity ( number 1500 en.dollar ) ) ) )
show housing types for three or more units	( call SW.listValue ( call SW.countComparative ( call SW.getProperty ( call SW.singleton en.housing ) ( string ! type ) ) ( call SW.reverse ( string housing_type ) ) ( string > ) ( number 2 ) ( call SW.getProperty ( call SW.singleton en.housing_unit ) ( string ! type ) ) ) )
housing types like 123 sesame street or 900 mission avenue	( call SW.listValue ( call SW.filter ( call SW.getProperty ( call SW.singleton en.housing ) ( string ! type ) ) ( call SW.reverse ( string housing_type ) ) ( string = ) ( call SW.concat en.housing_unit.123_sesame_street en.housing_unit.900_mission_ave ) ) )
what housing unit is found in the midtown east neighborhood	( call SW.listValue ( call SW.filter ( call SW.getProperty ( call SW.singleton en.neighborhood ) ( string ! type ) ) ( call SW.reverse ( string neighborhood ) ) ( string = ) ( call SW.filter ( call SW.getProperty ( call SW.singleton en.housing_unit ) ( string ! type ) ) ( string neighborhood ) ( string = ) en.neighborhood.midtown_west ) ) )
housing that is 800 square feet and includes a private bah	( call SW.listValue ( call SW.filter ( call SW.filter ( call SW.getProperty ( call SW.singleton en.housing_unit ) ( string ! type ) ) ( string has_private_bath ) ) ( string size ) ( string = ) ( number 800 en.square_feet ) ) )
which housing unit resembles the size of 123 sesame street	( call SW.listValue ( call SW.filter ( call SW.getProperty ( call SW.singleton en.housing_unit ) ( string ! type ) ) ( call SW.ensureNumericProperty ( string size ) ) ( string <= ) ( call SW.ensureNumericEntity ( call SW.getProperty en.housing_unit.123_sesame_street ( string size ) ) ) ) )
how  many neighbourhoods are there	( call SW.listValue ( call .size ( call SW.getProperty ( call SW.singleton en.neighborhood ) ( string ! type ) ) ) )
private room in midtown west	( call SW.listValue ( call SW.filter ( call SW.filter ( call SW.getProperty ( call SW.singleton en.housing_unit ) ( string ! type ) ) ( string neighborhood ) ( string = ) en.neighborhood.midtown_west ) ( string has_private_room ) ) )
which neighborhoods have dogfriendly housing	( call SW.listValue ( call SW.filter ( call SW.getProperty ( call SW.singleton en.neighborhood ) ( string ! type ) ) ( call SW.reverse ( string neighborhood ) ) ( string = ) ( call SW.filter ( call SW.getProperty ( call SW.singleton en.housing_unit ) ( string ! type ) ) ( string allows_dogs ) ) ) )
locate housing units with private roombath	( call SW.listValue ( call SW.filter ( call SW.filter ( call SW.getProperty ( call SW.singleton en.housing_unit ) ( string ! type ) ) ( string has_private_room ) ) ( string has_private_bath ) ) )
which housing unit is available in the area around mid town west	( call SW.listValue ( call SW.filter ( call SW.filter ( call SW.getProperty ( call SW.singleton en.housing_unit ) ( string ! type ) ) ( string neighborhood ) ( string = ) en.neighborhood.midtown_west ) ( string neighborhood ) ( string = ) en.neighborhood.midtown_west ) )
find housing units with a private room	( call SW.listValue ( call SW.filter ( call SW.filter ( call SW.getProperty ( call SW.singleton en.housing_unit ) ( string ! type ) ) ( string has_private_room ) ) ( string has_private_room ) ) )
show me housing whose rent is 1500 dollars and which provides a private bathroom	( call SW.listValue ( call SW.filter ( call SW.filter ( call SW.getProperty ( call SW.singleton en.housing_unit ) ( string ! type ) ) ( string has_private_bath ) ) ( string rent ) ( string = ) ( number 1500 en.dollar ) ) )
neighborhood of 123 sesame street	( call SW.listValue ( call SW.filter ( call SW.filter ( call SW.getProperty ( call SW.singleton en.neighborhood ) ( string ! type ) ) ( call SW.reverse ( string neighborhood ) ) ( string = ) en.housing_unit.123_sesame_street ) ( call SW.reverse ( string neighborhood ) ) ( string = ) en.housing_unit.123_sesame_street ) )
what is the housing type of the housing unit that allows dogs	( call SW.listValue ( call SW.filter ( call SW.getProperty ( call SW.singleton en.housing ) ( string ! type ) ) ( call SW.reverse ( string housing_type ) ) ( string = ) ( call SW.filter ( call SW.getProperty ( call SW.singleton en.housing_unit ) ( string ! type ) ) ( string allows_dogs ) ) ) )
what is the housing type of the housing unit with a private room	( call SW.listValue ( call SW.filter ( call SW.getProperty ( call SW.singleton en.housing ) ( string ! type ) ) ( call SW.reverse ( string housing_type ) ) ( string = ) ( call SW.filter ( call SW.getProperty ( call SW.singleton en.housing_unit ) ( string ! type ) ) ( string has_private_room ) ) ) )
housing that ranges between 800 and 1000 square feet	( call SW.listValue ( call SW.filter ( call SW.getProperty ( call SW.singleton en.housing_unit ) ( string ! type ) ) ( call SW.ensureNumericProperty ( string size ) ) ( string <= ) ( call SW.ensureNumericEntity ( call SW.concat ( number 800 en.square_feet ) ( number 1000 en.square_feet ) ) ) ) )
apartments that are smaller than 123 sesame street	( call SW.listValue ( call SW.filter ( call SW.getProperty ( call SW.singleton en.housing_unit ) ( string ! type ) ) ( call SW.ensureNumericProperty ( string size ) ) ( string < ) ( call SW.ensureNumericEntity ( call SW.getProperty en.housing_unit.123_sesame_street ( string size ) ) ) ) )
unit with private bath	( call SW.listValue ( call SW.filter ( call SW.getProperty ( call SW.singleton en.housing ) ( string ! type ) ) ( call SW.reverse ( string housing_type ) ) ( string = ) ( call SW.filter ( call SW.getProperty ( call SW.singleton en.housing_unit ) ( string ! type ) ) ( string has_private_bath ) ) ) )
housing in a neighborhood larger than two houses	( call SW.listValue ( call SW.countComparative ( call SW.getProperty ( call SW.singleton en.neighborhood ) ( string ! type ) ) ( call SW.reverse ( string neighborhood ) ) ( string > ) ( number 2 ) ( call SW.getProperty ( call SW.singleton en.housing_unit ) ( string ! type ) ) ) )
what is the phone number of this apartment complex	( call SW.listValue ( call .size ( call SW.getProperty ( call SW.singleton en.housing ) ( string ! type ) ) ) )
housing unit that costs 1500 dollars rent and allows cats	( call SW.listValue ( call SW.filter ( call SW.filter ( call SW.getProperty ( call SW.singleton en.housing_unit ) ( string ! type ) ) ( string rent ) ( string = ) ( number 1500 en.dollar ) ) ( string allows_cats ) ) )
housing unit with the same monthly rent as 123 sesame street	( call SW.listValue ( call SW.filter ( call SW.getProperty ( call SW.singleton en.housing_unit ) ( string ! type ) ) ( string rent ) ( string = ) ( call SW.getProperty en.housing_unit.123_sesame_street ( string rent ) ) ) )
housing not in midtown west	( call SW.listValue ( call SW.filter ( call SW.getProperty ( call SW.singleton en.housing_unit ) ( string ! type ) ) ( string neighborhood ) ( string ! = ) en.neighborhood.midtown_west ) )
which housing unit has houses of apartment kind	( call SW.listValue ( call SW.filter ( call SW.filter ( call SW.getProperty ( call SW.singleton en.housing_unit ) ( string ! type ) ) ( string housing_type ) ( string = ) en.housing.apartment ) ( string housing_type ) ( string = ) en.housing.apartment ) )
housing that allows dogs	( call SW.listValue ( call SW.filter ( call SW.getProperty ( call SW.singleton en.housing ) ( string ! type ) ) ( call SW.reverse ( string housing_type ) ) ( string = ) ( call SW.filter ( call SW.getProperty ( call SW.singleton en.housing_unit ) ( string ! type ) ) ( string allows_dogs ) ) ) )
which housing unit resembles 123 sesame street or 900 mission ave	( call SW.listValue ( call SW.filter ( call SW.getProperty ( call SW.singleton en.housing ) ( string ! type ) ) ( call SW.reverse ( string housing_type ) ) ( string = ) ( call SW.concat en.housing_unit.123_sesame_street en.housing_unit.900_mission_ave ) ) )
housing unit smaller than 800 square feet	( call SW.listValue ( call SW.filter ( call SW.getProperty ( call SW.singleton en.housing_unit ) ( string ! type ) ) ( call SW.ensureNumericProperty ( string size ) ) ( string < ) ( call SW.ensureNumericEntity ( number 800 en.square_feet ) ) ) )
housing that is more than 800 square feet	( call SW.listValue ( call SW.filter ( call SW.getProperty ( call SW.singleton en.housing_unit ) ( string ! type ) ) ( string size ) ( string ! = ) ( number 800 en.square_feet ) ) )
show me housing which posted on or before the day 123 sesame street did	( call SW.listValue ( call SW.filter ( call SW.getProperty ( call SW.singleton en.housing_unit ) ( string ! type ) ) ( call SW.ensureNumericProperty ( string posting_date ) ) ( string <= ) ( call SW.ensureNumericEntity ( call SW.getProperty en.housing_unit.123_sesame_street ( string posting_date ) ) ) ) )
housing unit with a private room and bath	( call SW.listValue ( call SW.filter ( call SW.filter ( call SW.getProperty ( call SW.singleton en.housing_unit ) ( string ! type ) ) ( string has_private_room ) ) ( string has_private_bath ) ) )
housing that posted on the same day at 123 sesame street	( call SW.listValue ( call SW.filter ( call SW.getProperty ( call SW.singleton en.housing_unit ) ( string ! type ) ) ( call SW.ensureNumericProperty ( string posting_date ) ) ( string >= ) ( call SW.ensureNumericEntity ( call SW.getProperty en.housing_unit.123_sesame_street ( string posting_date ) ) ) ) )
which neighborhoods have more than two places available	( call SW.listValue ( call SW.countComparative ( call SW.getProperty ( call SW.singleton en.neighborhood ) ( string ! type ) ) ( call SW.reverse ( string neighborhood ) ) ( string >= ) ( number 2 ) ( call SW.getProperty ( call SW.singleton en.housing_unit ) ( string ! type ) ) ) )
show me housing with 800 square feet of space where cats are acceptable	( call SW.listValue ( call SW.filter ( call SW.filter ( call SW.getProperty ( call SW.singleton en.housing_unit ) ( string ! type ) ) ( string allows_cats ) ) ( string size ) ( string = ) ( number 800 en.square_feet ) ) )
name neighborhoods with two or more housing units	( call SW.listValue ( call SW.countComparative ( call SW.getProperty ( call SW.singleton en.neighborhood ) ( string ! type ) ) ( call SW.reverse ( string neighborhood ) ) ( string >= ) ( number 2 ) ( call SW.getProperty ( call SW.singleton en.housing_unit ) ( string ! type ) ) ) )
apartments with a private room in midtown west	( call SW.listValue ( call SW.filter ( call SW.filter ( call SW.getProperty ( call SW.singleton en.housing_unit ) ( string ! type ) ) ( string neighborhood ) ( string = ) en.neighborhood.midtown_west ) ( string has_private_room ) ) )
how much is 123 sesame street per month	( call SW.listValue ( call SW.getProperty en.housing_unit.123_sesame_street ( string rent ) ) )
what neighborhoods have units with 800 square feet	( call SW.listValue ( call SW.filter ( call SW.getProperty ( call SW.singleton en.neighborhood ) ( string ! type ) ) ( call SW.reverse ( string neighborhood ) ) ( string = ) ( call SW.filter ( call SW.getProperty ( call SW.singleton en.housing_unit ) ( string ! type ) ) ( string size ) ( string = ) ( number 800 en.square_feet ) ) ) )
what neighborhood has housing with a private room	( call SW.listValue ( call SW.filter ( call SW.getProperty ( call SW.singleton en.neighborhood ) ( string ! type ) ) ( call SW.reverse ( string neighborhood ) ) ( string = ) ( call SW.filter ( call SW.getProperty ( call SW.singleton en.housing_unit ) ( string ! type ) ) ( string has_private_room ) ) ) )
apartments that rent for at least 1500	( call SW.listValue ( call SW.filter ( call SW.getProperty ( call SW.singleton en.housing_unit ) ( string ! type ) ) ( call SW.ensureNumericProperty ( string rent ) ) ( string >= ) ( call SW.ensureNumericEntity ( number 1500 en.dollar ) ) ) )
housing that is 1500month or 2000month	( call SW.listValue ( call SW.filter ( call SW.getProperty ( call SW.singleton en.housing_unit ) ( string ! type ) ) ( string rent ) ( string = ) ( call SW.concat ( number 1500 en.dollar ) ( number 2000 en.dollar ) ) ) )
housing that is not 800 square feet	( call SW.listValue ( call SW.filter ( call SW.getProperty ( call SW.singleton en.housing_unit ) ( string ! type ) ) ( string size ) ( string ! = ) ( number 800 en.square_feet ) ) )
apartments with a cheaper rent than 123 sesame street	( call SW.listValue ( call SW.filter ( call SW.getProperty ( call SW.singleton en.housing_unit ) ( string ! type ) ) ( call SW.ensureNumericProperty ( string rent ) ) ( string < ) ( call SW.ensureNumericEntity ( call SW.getProperty en.housing_unit.123_sesame_street ( string rent ) ) ) ) )
apartments with rent above 1500	( call SW.listValue ( call SW.filter ( call SW.getProperty ( call SW.singleton en.housing_unit ) ( string ! type ) ) ( call SW.ensureNumericProperty ( string rent ) ) ( string > ) ( call SW.ensureNumericEntity ( number 1500 en.dollar ) ) ) )
how many neighborhoods	( call SW.listValue ( call .size ( call SW.getProperty ( call SW.singleton en.neighborhood ) ( string ! type ) ) ) )
find housing units with private bath located in the neighborhoods of midtown west	( call SW.listValue ( call SW.filter ( call SW.filter ( call SW.getProperty ( call SW.singleton en.housing_unit ) ( string ! type ) ) ( string has_private_bath ) ) ( string neighborhood ) ( string = ) en.neighborhood.midtown_west ) )
which housing unit is posted on the posting date of 123 sesame street	( call SW.listValue ( call SW.filter ( call SW.getProperty ( call SW.singleton en.housing_unit ) ( string ! type ) ) ( string posting_date ) ( string = ) ( call SW.getProperty en.housing_unit.123_sesame_street ( string posting_date ) ) ) )
housing that is the same size or bigger than 123 sesame street	( call SW.listValue ( call SW.filter ( call SW.getProperty ( call SW.singleton en.housing_unit ) ( string ! type ) ) ( call SW.ensureNumericProperty ( string size ) ) ( string >= ) ( call SW.ensureNumericEntity ( call SW.getProperty en.housing_unit.123_sesame_street ( string size ) ) ) ) )
apartments in the same neighborhood at 123 sesame street	( call SW.listValue ( call SW.filter ( call SW.getProperty ( call SW.singleton en.housing_unit ) ( string ! type ) ) ( string neighborhood ) ( string = ) ( call SW.getProperty en.housing_unit.123_sesame_street ( string neighborhood ) ) ) )
looking for a unit with a private bathroom and dog friendly	( call SW.listValue ( call SW.filter ( call SW.filter ( call SW.getProperty ( call SW.singleton en.housing_unit ) ( string ! type ) ) ( string has_private_bath ) ) ( string allows_dogs ) ) )
housing posted the same day as 123 sesame street	( call SW.listValue ( call SW.filter ( call SW.getProperty ( call SW.singleton en.housing_unit ) ( string ! type ) ) ( string posting_date ) ( string = ) ( call SW.getProperty en.housing_unit.123_sesame_street ( string posting_date ) ) ) )
find housing units that is not an apartment	( call SW.listValue ( call SW.filter ( call SW.getProperty ( call SW.singleton en.housing_unit ) ( string ! type ) ) ( string housing_type ) ( string ! = ) en.housing.apartment ) )
which housing unit in the midtown west area has a private room	( call SW.listValue ( call SW.filter ( call SW.filter ( call SW.getProperty ( call SW.singleton en.housing_unit ) ( string ! type ) ) ( string has_private_room ) ) ( string neighborhood ) ( string = ) en.neighborhood.midtown_west ) )
housing not posted on january 2	( call SW.listValue ( call SW.filter ( call SW.getProperty ( call SW.singleton en.housing_unit ) ( string ! type ) ) ( string posting_date ) ( string ! = ) ( date 2015 1 2 ) ) )
pet friendly 800 square feet housing unit	( call SW.listValue ( call SW.filter ( call SW.filter ( call SW.getProperty ( call SW.singleton en.housing_unit ) ( string ! type ) ) ( string size ) ( string = ) ( number 800 en.square_feet ) ) ( string allows_dogs ) ) )
housing that is at least 1500month	( call SW.listValue ( call SW.filter ( call SW.getProperty ( call SW.singleton en.housing_unit ) ( string ! type ) ) ( call SW.ensureNumericProperty ( string rent ) ) ( string >= ) ( call SW.ensureNumericEntity ( number 1500 en.dollar ) ) ) )
housing posted after 123 sesame street	( call SW.listValue ( call SW.filter ( call SW.getProperty ( call SW.singleton en.housing_unit ) ( string ! type ) ) ( call SW.ensureNumericProperty ( string posting_date ) ) ( string > ) ( call SW.ensureNumericEntity ( call SW.getProperty en.housing_unit.123_sesame_street ( string posting_date ) ) ) ) )
housing units that are at least the same square footage as the housing unit on 123 sesame street	( call SW.listValue ( call SW.filter ( call SW.getProperty ( call SW.singleton en.housing_unit ) ( string ! type ) ) ( call SW.ensureNumericProperty ( string size ) ) ( string >= ) ( call SW.ensureNumericEntity ( call SW.getProperty en.housing_unit.123_sesame_street ( string size ) ) ) ) )
what are the  units that  do  not belong to the area around midtown west	( call SW.listValue ( call SW.filter ( call SW.getProperty ( call SW.singleton en.housing_unit ) ( string ! type ) ) ( string neighborhood ) ( string ! = ) en.neighborhood.midtown_west ) )
units that have a private room	( call SW.listValue ( call SW.filter ( call SW.filter ( call SW.getProperty ( call SW.singleton en.housing_unit ) ( string ! type ) ) ( string has_private_room ) ) ( string has_private_room ) ) )
housing unit that is an aprtment	( call SW.listValue ( call SW.filter ( call SW.filter ( call SW.getProperty ( call SW.singleton en.housing_unit ) ( string ! type ) ) ( string housing_type ) ( string = ) en.housing.apartment ) ( string housing_type ) ( string = ) en.housing.apartment ) )
apartments in midtown west with a rent of 1500 a month	( call SW.listValue ( call SW.filter ( call SW.filter ( call SW.getProperty ( call SW.singleton en.housing_unit ) ( string ! type ) ) ( string neighborhood ) ( string = ) en.neighborhood.midtown_west ) ( string rent ) ( string = ) ( number 1500 en.dollar ) ) )
which housing is no larger than 123 sesame street	( call SW.listValue ( call SW.filter ( call SW.getProperty ( call SW.singleton en.housing_unit ) ( string ! type ) ) ( call SW.ensureNumericProperty ( string size ) ) ( string <= ) ( call SW.ensureNumericEntity ( call SW.getProperty en.housing_unit.123_sesame_street ( string size ) ) ) ) )
what 800 square housing allows dogs	( call SW.listValue ( call SW.filter ( call SW.filter ( call SW.getProperty ( call SW.singleton en.housing_unit ) ( string ! type ) ) ( string allows_dogs ) ) ( string size ) ( string = ) ( number 800 en.square_feet ) ) )
find cat friendly housing units with a private room	( call SW.listValue ( call SW.filter ( call SW.filter ( call SW.getProperty ( call SW.singleton en.housing_unit ) ( string ! type ) ) ( string has_private_room ) ) ( string allows_cats ) ) )
which apartment kind of housing units permits cats in it	( call SW.listValue ( call SW.filter ( call SW.filter ( call SW.getProperty ( call SW.singleton en.housing_unit ) ( string ! type ) ) ( string allows_cats ) ) ( string housing_type ) ( string = ) en.housing.apartment ) )
housing apartments in a midtown west neighborhood	( call SW.listValue ( call SW.filter ( call SW.filter ( call SW.getProperty ( call SW.singleton en.housing_unit ) ( string ! type ) ) ( string neighborhood ) ( string = ) en.neighborhood.midtown_west ) ( string housing_type ) ( string = ) en.housing.apartment ) )
housing unit with size of either 800 or 1000 square feet	( call SW.listValue ( call SW.filter ( call SW.getProperty ( call SW.singleton en.housing_unit ) ( string ! type ) ) ( string size ) ( string = ) ( call SW.concat ( number 800 en.square_feet ) ( number 1000 en.square_feet ) ) ) )
which housing unit permits dogs and has a private bath	( call SW.listValue ( call SW.filter ( call SW.filter ( call SW.getProperty ( call SW.singleton en.housing_unit ) ( string ! type ) ) ( string has_private_bath ) ) ( string allows_dogs ) ) )
what is the neighborhood of the apartment that is pet friendly	( call SW.listValue ( call SW.filter ( call SW.getProperty ( call SW.singleton en.neighborhood ) ( string ! type ) ) ( call SW.reverse ( string neighborhood ) ) ( string = ) ( call SW.filter ( call SW.getProperty ( call SW.singleton en.housing_unit ) ( string ! type ) ) ( string allows_cats ) ) ) )
which housing unit resembles 123 sesame street in size	( call SW.listValue ( call SW.filter ( call SW.getProperty ( call SW.singleton en.housing_unit ) ( string ! type ) ) ( string size ) ( string = ) ( call SW.getProperty en.housing_unit.123_sesame_street ( string size ) ) ) )
find an apartment that is 800 square feet	( call SW.listValue ( call SW.filter ( call SW.filter ( call SW.getProperty ( call SW.singleton en.housing_unit ) ( string ! type ) ) ( string housing_type ) ( string = ) en.housing.apartment ) ( string size ) ( string = ) ( number 800 en.square_feet ) ) )
neighborhoods not near 123 sesame street	( call SW.listValue ( call SW.filter ( call SW.getProperty ( call SW.singleton en.neighborhood ) ( string ! type ) ) ( call SW.reverse ( string neighborhood ) ) ( string ! = ) en.housing_unit.123_sesame_street ) )
list all housing us that are at least 800 or 1000 square feet	( call SW.listValue ( call SW.filter ( call SW.getProperty ( call SW.singleton en.housing_unit ) ( string ! type ) ) ( call SW.ensureNumericProperty ( string size ) ) ( string >= ) ( call SW.ensureNumericEntity ( call SW.concat ( number 800 en.square_feet ) ( number 1000 en.square_feet ) ) ) ) )
apartment that is the same size are 123 sesame street	( call SW.listValue ( call SW.filter ( call SW.getProperty ( call SW.singleton en.housing_unit ) ( string ! type ) ) ( call SW.ensureNumericProperty ( string size ) ) ( string >= ) ( call SW.ensureNumericEntity ( call SW.getProperty en.housing_unit.123_sesame_street ( string size ) ) ) ) )
which housing unit has 1500 dollars as monthly rent	( call SW.listValue ( call SW.filter ( call SW.getProperty ( call SW.singleton en.housing_unit ) ( string ! type ) ) ( string rent ) ( string = ) ( number 1500 en.dollar ) ) )
what is the 123 sesame street housing type	( call SW.listValue ( call SW.getProperty en.housing_unit.123_sesame_street ( string housing_type ) ) )
show me housing with 800 square feet of space	( call SW.listValue ( call SW.filter ( call SW.getProperty ( call SW.singleton en.housing_unit ) ( string ! type ) ) ( string size ) ( string = ) ( number 800 en.square_feet ) ) )
what is the monthly rent of this apartment	( call SW.listValue ( call SW.aggregate ( string sum ) ( call SW.getProperty ( call SW.getProperty ( call SW.singleton en.housing_unit ) ( string ! type ) ) ( string rent ) ) ) )
housing near 123 sesame street	( call SW.listValue ( call SW.getProperty en.housing_unit.123_sesame_street ( string neighborhood ) ) )
apartment with a private room for rent at 1500	( call SW.listValue ( call SW.filter ( call SW.filter ( call SW.getProperty ( call SW.singleton en.housing_unit ) ( string ! type ) ) ( string has_private_room ) ) ( string rent ) ( string = ) ( number 1500 en.dollar ) ) )
which housing units in the neighbourhood permits dogs inside it	( call SW.listValue ( call SW.filter ( call SW.getProperty ( call SW.singleton en.neighborhood ) ( string ! type ) ) ( call SW.reverse ( string neighborhood ) ) ( string = ) ( call SW.filter ( call SW.getProperty ( call SW.singleton en.housing_unit ) ( string ! type ) ) ( string allows_dogs ) ) ) )
what housing units are the same size as those in 123 sesame street	( call SW.listValue ( call SW.filter ( call SW.getProperty ( call SW.singleton en.housing_unit ) ( string ! type ) ) ( call SW.ensureNumericProperty ( string size ) ) ( string >= ) ( call SW.ensureNumericEntity ( call SW.getProperty en.housing_unit.123_sesame_street ( string size ) ) ) ) )
which is the neighborhood shared by most nuumber of housing units	( call SW.listValue ( call SW.countSuperlative ( call SW.getProperty ( call SW.singleton en.neighborhood ) ( string ! type ) ) ( string max ) ( call SW.reverse ( string neighborhood ) ) ( call SW.getProperty ( call SW.singleton en.housing_unit ) ( string ! type ) ) ) )
unit with one housing type	( call SW.listValue ( call SW.countComparative ( call SW.getProperty ( call SW.singleton en.housing_unit ) ( string ! type ) ) ( string housing_type ) ( string < ) ( number 2 ) ) )
which housing unit is bigger by area	( call SW.listValue ( call SW.superlative ( call SW.getProperty ( call SW.singleton en.housing_unit ) ( string ! type ) ) ( string max ) ( call SW.ensureNumericProperty ( string size ) ) ) )
units posted before january 2nd	( call SW.listValue ( call SW.filter ( call SW.getProperty ( call SW.singleton en.housing_unit ) ( string ! type ) ) ( call SW.ensureNumericProperty ( string posting_date ) ) ( string < ) ( call SW.ensureNumericEntity ( date 2015 1 2 ) ) ) )
find 800 square feet sized housing units with a private room	( call SW.listValue ( call SW.filter ( call SW.filter ( call SW.getProperty ( call SW.singleton en.housing_unit ) ( string ! type ) ) ( string has_private_room ) ) ( string size ) ( string = ) ( number 800 en.square_feet ) ) )
find all units available midtown east	( call SW.listValue ( call SW.filter ( call SW.getProperty ( call SW.singleton en.housing_unit ) ( string ! type ) ) ( string neighborhood ) ( string = ) en.neighborhood.midtown_west ) )
find housing that allows cats	( call SW.listValue ( call SW.filter ( call SW.getProperty ( call SW.singleton en.neighborhood ) ( string ! type ) ) ( call SW.reverse ( string neighborhood ) ) ( string = ) ( call SW.filter ( call SW.getProperty ( call SW.singleton en.housing_unit ) ( string ! type ) ) ( string allows_cats ) ) ) )
housing that is bigger than 123 sesame street	( call SW.listValue ( call SW.filter ( call SW.getProperty ( call SW.singleton en.housing_unit ) ( string ! type ) ) ( call SW.ensureNumericProperty ( string size ) ) ( string > ) ( call SW.ensureNumericEntity ( call SW.getProperty en.housing_unit.123_sesame_street ( string size ) ) ) ) )
find housing units with 1500 dollars as rent and is near midtown west	( call SW.listValue ( call SW.filter ( call SW.filter ( call SW.getProperty ( call SW.singleton en.housing_unit ) ( string ! type ) ) ( string rent ) ( string = ) ( number 1500 en.dollar ) ) ( string neighborhood ) ( string = ) en.neighborhood.midtown_west ) )
find housings unit posted on other dates except for january 2nd	( call SW.listValue ( call SW.filter ( call SW.getProperty ( call SW.singleton en.housing_unit ) ( string ! type ) ) ( string posting_date ) ( string ! = ) ( date 2015 1 2 ) ) )
dog and cat friendly housing	( call SW.listValue ( call SW.filter ( call SW.filter ( call SW.getProperty ( call SW.singleton en.housing_unit ) ( string ! type ) ) ( string allows_cats ) ) ( string allows_dogs ) ) )
what kinds of housing include a private room	( call SW.listValue ( call SW.filter ( call SW.getProperty ( call SW.singleton en.housing ) ( string ! type ) ) ( call SW.reverse ( string housing_type ) ) ( string = ) ( call SW.filter ( call SW.getProperty ( call SW.singleton en.housing_unit ) ( string ! type ) ) ( string has_private_room ) ) ) )
housing with posting dates before january 2nd and february 3rd	( call SW.listValue ( call SW.filter ( call SW.getProperty ( call SW.singleton en.housing_unit ) ( string ! type ) ) ( call SW.ensureNumericProperty ( string posting_date ) ) ( string < ) ( call SW.ensureNumericEntity ( call SW.concat ( date 2015 1 2 ) ( date 2015 2 3 ) ) ) ) )
which area has more than two housing units	( call SW.listValue ( call SW.countComparative ( call SW.getProperty ( call SW.singleton en.neighborhood ) ( string ! type ) ) ( call SW.reverse ( string neighborhood ) ) ( string > ) ( number 2 ) ( call SW.getProperty ( call SW.singleton en.housing_unit ) ( string ! type ) ) ) )
find housing units around the neighborhoods of 123 sesame street	( call SW.listValue ( call SW.filter ( call SW.getProperty ( call SW.singleton en.housing_unit ) ( string ! type ) ) ( string neighborhood ) ( string = ) ( call SW.getProperty en.housing_unit.123_sesame_street ( string neighborhood ) ) ) )
housing that is 800 square feet with a private bath	( call SW.listValue ( call SW.filter ( call SW.filter ( call SW.getProperty ( call SW.singleton en.housing_unit ) ( string ! type ) ) ( string size ) ( string = ) ( number 800 en.square_feet ) ) ( string has_private_bath ) ) )
apartments with rent between 1500 and 2000	( call SW.listValue ( call SW.filter ( call SW.getProperty ( call SW.singleton en.housing_unit ) ( string ! type ) ) ( call SW.ensureNumericProperty ( string rent ) ) ( string < ) ( call SW.ensureNumericEntity ( call SW.concat ( number 1500 en.dollar ) ( number 2000 en.dollar ) ) ) ) )
which housing unit has a private room	( call SW.listValue ( call SW.filter ( call SW.filter ( call SW.getProperty ( call SW.singleton en.housing_unit ) ( string ! type ) ) ( string has_private_room ) ) ( string has_private_room ) ) )
apartments with a private room	( call SW.listValue ( call SW.filter ( call SW.filter ( call SW.getProperty ( call SW.singleton en.housing_unit ) ( string ! type ) ) ( string housing_type ) ( string = ) en.housing.apartment ) ( string has_private_room ) ) )
what is the neighborhood of the  housing unit with a private room	( call SW.listValue ( call SW.filter ( call SW.getProperty ( call SW.singleton en.neighborhood ) ( string ! type ) ) ( call SW.reverse ( string neighborhood ) ) ( string = ) ( call SW.filter ( call SW.getProperty ( call SW.singleton en.housing_unit ) ( string ! type ) ) ( string has_private_room ) ) ) )
what housing costs 1500 dollars and is 800 square feet	( call SW.listValue ( call SW.filter ( call SW.filter ( call SW.getProperty ( call SW.singleton en.housing_unit ) ( string ! type ) ) ( string size ) ( string = ) ( number 800 en.square_feet ) ) ( string rent ) ( string = ) ( number 1500 en.dollar ) ) )
which housing unit is posted before jan 2	( call SW.listValue ( call SW.filter ( call SW.getProperty ( call SW.singleton en.housing_unit ) ( string ! type ) ) ( call SW.ensureNumericProperty ( string posting_date ) ) ( string < ) ( call SW.ensureNumericEntity ( call SW.concat ( date 2015 1 2 ) ( date 2015 2 3 ) ) ) ) )
find housing units less than 1000  square feet	( call SW.listValue ( call SW.filter ( call SW.getProperty ( call SW.singleton en.housing_unit ) ( string ! type ) ) ( call SW.ensureNumericProperty ( string size ) ) ( string <= ) ( call SW.ensureNumericEntity ( call SW.concat ( number 800 en.square_feet ) ( number 1000 en.square_feet ) ) ) ) )
name the neighborhood of the housing unit with private bath	( call SW.listValue ( call SW.filter ( call SW.getProperty ( call SW.singleton en.neighborhood ) ( string ! type ) ) ( call SW.reverse ( string neighborhood ) ) ( string = ) ( call SW.filter ( call SW.getProperty ( call SW.singleton en.housing_unit ) ( string ! type ) ) ( string has_private_bath ) ) ) )
find housing units around 123 sesame street	( call SW.listValue ( call SW.filter ( call SW.getProperty ( call SW.singleton en.neighborhood ) ( string ! type ) ) ( call SW.reverse ( string neighborhood ) ) ( string = ) en.housing_unit.123_sesame_street ) )
find all 800 square foot units with private baths	( call SW.listValue ( call SW.filter ( call SW.filter ( call SW.getProperty ( call SW.singleton en.housing_unit ) ( string ! type ) ) ( string has_private_bath ) ) ( string size ) ( string = ) ( number 800 en.square_feet ) ) )
housing that is the same rent as or cheaper than 123 sesame street	( call SW.listValue ( call SW.filter ( call SW.getProperty ( call SW.singleton en.housing_unit ) ( string ! type ) ) ( call SW.ensureNumericProperty ( string rent ) ) ( string <= ) ( call SW.ensureNumericEntity ( call SW.getProperty en.housing_unit.123_sesame_street ( string rent ) ) ) ) )
apartments that allow dogs	( call SW.listValue ( call SW.filter ( call SW.getProperty ( call SW.singleton en.housing_unit ) ( string ! type ) ) ( string allows_dogs ) ) )
housing that is more than 1500month	( call SW.listValue ( call SW.filter ( call SW.getProperty ( call SW.singleton en.housing_unit ) ( string ! type ) ) ( call SW.ensureNumericProperty ( string rent ) ) ( string > ) ( call SW.ensureNumericEntity ( number 1500 en.dollar ) ) ) )
catfriendly apartments with a private room	( call SW.listValue ( call SW.filter ( call SW.filter ( call SW.getProperty ( call SW.singleton en.housing_unit ) ( string ! type ) ) ( string allows_cats ) ) ( string has_private_room ) ) )
neighborhood of 123 sesame street or 900 mission ave	( call SW.listValue ( call SW.filter ( call SW.getProperty ( call SW.singleton en.neighborhood ) ( string ! type ) ) ( call SW.reverse ( string neighborhood ) ) ( string = ) ( call SW.concat en.housing_unit.123_sesame_street en.housing_unit.900_mission_ave ) ) )
housing that is 800 square feet or less	( call SW.listValue ( call SW.filter ( call SW.getProperty ( call SW.singleton en.housing_unit ) ( string ! type ) ) ( call SW.ensureNumericProperty ( string size ) ) ( string <= ) ( call SW.ensureNumericEntity ( number 800 en.square_feet ) ) ) )
looking for apartments	( call SW.listValue ( call SW.filter ( call SW.filter ( call SW.getProperty ( call SW.singleton en.housing_unit ) ( string ! type ) ) ( string housing_type ) ( string = ) en.housing.apartment ) ( string housing_type ) ( string = ) en.housing.apartment ) )
find housing units with maximum size 800 square feet	( call SW.listValue ( call SW.filter ( call SW.getProperty ( call SW.singleton en.housing_unit ) ( string ! type ) ) ( call SW.ensureNumericProperty ( string size ) ) ( string <= ) ( call SW.ensureNumericEntity ( number 800 en.square_feet ) ) ) )
housing at least 800 to 1000 square feet	( call SW.listValue ( call SW.filter ( call SW.getProperty ( call SW.singleton en.housing_unit ) ( string ! type ) ) ( call SW.ensureNumericProperty ( string size ) ) ( string > ) ( call SW.ensureNumericEntity ( call SW.concat ( number 800 en.square_feet ) ( number 1000 en.square_feet ) ) ) ) )
which housing unit with an area of 800 square feet has the facility of a private room	( call SW.listValue ( call SW.filter ( call SW.filter ( call SW.getProperty ( call SW.singleton en.housing_unit ) ( string ! type ) ) ( string size ) ( string = ) ( number 800 en.square_feet ) ) ( string has_private_room ) ) )
housing unit sizes on 123 sesame street	( call SW.listValue ( call SW.filter ( call SW.getProperty ( call SW.singleton en.housing_unit ) ( string ! type ) ) ( string size ) ( string = ) ( call SW.getProperty en.housing_unit.123_sesame_street ( string size ) ) ) )
which housing unit has a rent of 1500 dollars per month	( call SW.listValue ( call SW.filter ( call SW.getProperty ( call SW.singleton en.housing_unit ) ( string ! type ) ) ( call SW.ensureNumericProperty ( string rent ) ) ( string <= ) ( call SW.ensureNumericEntity ( number 1500 en.dollar ) ) ) )
which housing unit has the monthly rent of 123 sesame street	( call SW.listValue ( call SW.filter ( call SW.getProperty ( call SW.singleton en.housing_unit ) ( string ! type ) ) ( string rent ) ( string = ) ( call SW.getProperty en.housing_unit.123_sesame_street ( string rent ) ) ) )
housing units with one housing type	( call SW.listValue ( call SW.countComparative ( call SW.getProperty ( call SW.singleton en.housing_unit ) ( string ! type ) ) ( string housing_type ) ( string < ) ( number 2 ) ) )
pet friendly housing unit	( call SW.listValue ( call SW.filter ( call SW.filter ( call SW.getProperty ( call SW.singleton en.housing_unit ) ( string ! type ) ) ( string allows_cats ) ) ( string allows_cats ) ) )
find 800 square feet housing units of the type apartment	( call SW.listValue ( call SW.filter ( call SW.filter ( call SW.getProperty ( call SW.singleton en.housing_unit ) ( string ! type ) ) ( string size ) ( string = ) ( number 800 en.square_feet ) ) ( string housing_type ) ( string = ) en.housing.apartment ) )
find housing units with the least number of neighborhoods	( call SW.listValue ( call SW.countSuperlative ( call SW.getProperty ( call SW.singleton en.housing_unit ) ( string ! type ) ) ( string min ) ( string neighborhood ) ) )
which housing unit with a rent of 1500 dollars per month has a private room	( call SW.listValue ( call SW.filter ( call SW.filter ( call SW.getProperty ( call SW.singleton en.housing_unit ) ( string ! type ) ) ( string has_private_room ) ) ( string rent ) ( string = ) ( number 1500 en.dollar ) ) )
housing unit with 2 types of housing	( call SW.listValue ( call SW.countComparative ( call SW.getProperty ( call SW.singleton en.housing_unit ) ( string ! type ) ) ( string housing_type ) ( string < ) ( number 2 ) ) )
what is the monthly rent for 123 sesame street	( call SW.listValue ( call SW.filter ( call SW.getProperty ( call SW.singleton en.housing_unit ) ( string ! type ) ) ( call SW.ensureNumericProperty ( string rent ) ) ( string >= ) ( call SW.ensureNumericEntity ( call SW.getProperty en.housing_unit.123_sesame_street ( string rent ) ) ) ) )
smallest available unit	( call SW.listValue ( call SW.superlative ( call SW.getProperty ( call SW.singleton en.housing_unit ) ( string ! type ) ) ( string min ) ( call SW.ensureNumericProperty ( string size ) ) ) )
housing apartments with a private bath	( call SW.listValue ( call SW.filter ( call SW.filter ( call SW.getProperty ( call SW.singleton en.housing_unit ) ( string ! type ) ) ( string housing_type ) ( string = ) en.housing.apartment ) ( string has_private_bath ) ) )
housing that is 1500month with a private room	( call SW.listValue ( call SW.filter ( call SW.filter ( call SW.getProperty ( call SW.singleton en.housing_unit ) ( string ! type ) ) ( string has_private_room ) ) ( string rent ) ( string = ) ( number 1500 en.dollar ) ) )
find housing for less than 1500 dollars	( call SW.listValue ( call SW.filter ( call SW.getProperty ( call SW.singleton en.housing_unit ) ( string ! type ) ) ( call SW.ensureNumericProperty ( string rent ) ) ( string < ) ( call SW.ensureNumericEntity ( number 1500 en.dollar ) ) ) )
housing unit with posting date less than that of 123 sesame street	( call SW.listValue ( call SW.filter ( call SW.getProperty ( call SW.singleton en.housing_unit ) ( string ! type ) ) ( call SW.ensureNumericProperty ( string posting_date ) ) ( string < ) ( call SW.ensureNumericEntity ( call SW.getProperty en.housing_unit.123_sesame_street ( string posting_date ) ) ) ) )
show me housing that is the same type as 123 sesame street	( call SW.listValue ( call SW.filter ( call SW.filter ( call SW.getProperty ( call SW.singleton en.housing ) ( string ! type ) ) ( call SW.reverse ( string housing_type ) ) ( string = ) en.housing_unit.123_sesame_street ) ( call SW.reverse ( string housing_type ) ) ( string = ) en.housing_unit.123_sesame_street ) )
what kinds of housing allow cats	( call SW.listValue ( call SW.filter ( call SW.getProperty ( call SW.singleton en.housing ) ( string ! type ) ) ( call SW.reverse ( string housing_type ) ) ( string = ) ( call SW.filter ( call SW.getProperty ( call SW.singleton en.housing_unit ) ( string ! type ) ) ( string allows_cats ) ) ) )
what is the average rent per month of a housing unit	( call SW.listValue ( call SW.aggregate ( string avg ) ( call SW.getProperty ( call SW.getProperty ( call SW.singleton en.housing_unit ) ( string ! type ) ) ( string rent ) ) ) )
want a housing type like 123 sesame street	( call SW.listValue ( call SW.filter ( call SW.filter ( call SW.getProperty ( call SW.singleton en.housing ) ( string ! type ) ) ( call SW.reverse ( string housing_type ) ) ( string = ) en.housing_unit.123_sesame_street ) ( call SW.reverse ( string housing_type ) ) ( string = ) en.housing_unit.123_sesame_street ) )
what is the neighborhood of 123 sesame street called as	( call SW.listValue ( call SW.filter ( call SW.filter ( call SW.getProperty ( call SW.singleton en.neighborhood ) ( string ! type ) ) ( call SW.reverse ( string neighborhood ) ) ( string = ) en.housing_unit.123_sesame_street ) ( call SW.reverse ( string neighborhood ) ) ( string = ) en.housing_unit.123_sesame_street ) )
apartment between 800 and 1000 square feet	( call SW.listValue ( call SW.filter ( call SW.getProperty ( call SW.singleton en.housing_unit ) ( string ! type ) ) ( call SW.ensureNumericProperty ( string size ) ) ( string <= ) ( call SW.ensureNumericEntity ( call SW.concat ( number 800 en.square_feet ) ( number 1000 en.square_feet ) ) ) ) )
neighborhoods with dogfriendly apartments	( call SW.listValue ( call SW.filter ( call SW.getProperty ( call SW.singleton en.neighborhood ) ( string ! type ) ) ( call SW.reverse ( string neighborhood ) ) ( string = ) ( call SW.filter ( call SW.getProperty ( call SW.singleton en.housing_unit ) ( string ! type ) ) ( string allows_dogs ) ) ) )
which housing unit has 1500 dollars as monthly rent and also has the facility of a private bath	( call SW.listValue ( call SW.filter ( call SW.filter ( call SW.getProperty ( call SW.singleton en.housing_unit ) ( string ! type ) ) ( string rent ) ( string = ) ( number 1500 en.dollar ) ) ( string has_private_bath ) ) )
find housing that is an apartment	( call SW.listValue ( call SW.filter ( call SW.filter ( call SW.getProperty ( call SW.singleton en.housing_unit ) ( string ! type ) ) ( string housing_type ) ( string = ) en.housing.apartment ) ( string housing_type ) ( string = ) en.housing.apartment ) )
dogfriendly housing	( call SW.listValue ( call SW.filter ( call SW.filter ( call SW.getProperty ( call SW.singleton en.housing_unit ) ( string ! type ) ) ( string allows_dogs ) ) ( string allows_dogs ) ) )
what housing units allows dogs	( call SW.listValue ( call SW.filter ( call SW.getProperty ( call SW.singleton en.housing_unit ) ( string ! type ) ) ( string allows_dogs ) ) )
housing units that allow cats and charge 1500 rent monthly	( call SW.listValue ( call SW.filter ( call SW.filter ( call SW.getProperty ( call SW.singleton en.housing_unit ) ( string ! type ) ) ( string rent ) ( string = ) ( number 1500 en.dollar ) ) ( string allows_cats ) ) )
find housing units with posting date between january 2nd and february 3rd	( call SW.listValue ( call SW.filter ( call SW.getProperty ( call SW.singleton en.housing_unit ) ( string ! type ) ) ( call SW.ensureNumericProperty ( string posting_date ) ) ( string <= ) ( call SW.ensureNumericEntity ( call SW.concat ( date 2015 1 2 ) ( date 2015 2 3 ) ) ) ) )
which housing unit was posted before jan 2	( call SW.listValue ( call SW.filter ( call SW.getProperty ( call SW.singleton en.housing_unit ) ( string ! type ) ) ( call SW.ensureNumericProperty ( string posting_date ) ) ( string < ) ( call SW.ensureNumericEntity ( date 2015 1 2 ) ) ) )
find housing unit with posting date between january 2nd or february 3rd	( call SW.listValue ( call SW.filter ( call SW.getProperty ( call SW.singleton en.housing_unit ) ( string ! type ) ) ( call SW.ensureNumericProperty ( string posting_date ) ) ( string < ) ( call SW.ensureNumericEntity ( call SW.concat ( date 2015 1 2 ) ( date 2015 2 3 ) ) ) ) )
unit with rent between 15002000 dollars	( call SW.listValue ( call SW.filter ( call SW.getProperty ( call SW.singleton en.housing_unit ) ( string ! type ) ) ( string rent ) ( string = ) ( call SW.concat ( number 1500 en.dollar ) ( number 2000 en.dollar ) ) ) )
housing unit with a posting date bigger than the date of 123 sesame street	( call SW.listValue ( call SW.filter ( call SW.getProperty ( call SW.singleton en.housing_unit ) ( string ! type ) ) ( call SW.ensureNumericProperty ( string posting_date ) ) ( string > ) ( call SW.ensureNumericEntity ( call SW.getProperty en.housing_unit.123_sesame_street ( string posting_date ) ) ) ) )
private housing in midtown west	( call SW.listValue ( call SW.filter ( call SW.filter ( call SW.getProperty ( call SW.singleton en.housing_unit ) ( string ! type ) ) ( string has_private_room ) ) ( string neighborhood ) ( string = ) en.neighborhood.midtown_west ) )
find housing units with size greater than 800 square feet	( call SW.listValue ( call SW.filter ( call SW.getProperty ( call SW.singleton en.housing_unit ) ( string ! type ) ) ( call SW.ensureNumericProperty ( string size ) ) ( string > ) ( call SW.ensureNumericEntity ( number 800 en.square_feet ) ) ) )
find pet friendly housing units that charge 1500 dollars as rent	( call SW.listValue ( call SW.filter ( call SW.filter ( call SW.getProperty ( call SW.singleton en.housing_unit ) ( string ! type ) ) ( string rent ) ( string = ) ( number 1500 en.dollar ) ) ( string allows_dogs ) ) )
neighborhood where i can find housing with a private room	( call SW.listValue ( call SW.filter ( call SW.getProperty ( call SW.singleton en.neighborhood ) ( string ! type ) ) ( call SW.reverse ( string neighborhood ) ) ( string = ) ( call SW.filter ( call SW.getProperty ( call SW.singleton en.housing_unit ) ( string ! type ) ) ( string has_private_room ) ) ) )
which housing unit has apartment kind of houses with an area of 800 square feet	( call SW.listValue ( call SW.filter ( call SW.filter ( call SW.getProperty ( call SW.singleton en.housing_unit ) ( string ! type ) ) ( string housing_type ) ( string = ) en.housing.apartment ) ( string size ) ( string = ) ( number 800 en.square_feet ) ) )
what are the neighborhoods of 123 sesame street and 900 mission avenue	( call SW.listValue ( call SW.filter ( call SW.getProperty ( call SW.singleton en.neighborhood ) ( string ! type ) ) ( call SW.reverse ( string neighborhood ) ) ( string = ) ( call SW.concat en.housing_unit.123_sesame_street en.housing_unit.900_mission_ave ) ) )
housing posted before january 2 or february 3	( call SW.listValue ( call SW.filter ( call SW.getProperty ( call SW.singleton en.housing_unit ) ( string ! type ) ) ( call SW.ensureNumericProperty ( string posting_date ) ) ( string < ) ( call SW.ensureNumericEntity ( call SW.concat ( date 2015 1 2 ) ( date 2015 2 3 ) ) ) ) )
apartments with rent that is more expensive than 123 sesame street	( call SW.listValue ( call SW.filter ( call SW.getProperty ( call SW.singleton en.housing_unit ) ( string ! type ) ) ( call SW.ensureNumericProperty ( string rent ) ) ( string > ) ( call SW.ensureNumericEntity ( call SW.getProperty en.housing_unit.123_sesame_street ( string rent ) ) ) ) )
800 square foot dogfriendly apartment	( call SW.listValue ( call SW.filter ( call SW.filter ( call SW.getProperty ( call SW.singleton en.housing_unit ) ( string ! type ) ) ( string allows_dogs ) ) ( string size ) ( string = ) ( number 800 en.square_feet ) ) )
which housing unit permits cats and had a private bath in it	( call SW.listValue ( call SW.filter ( call SW.filter ( call SW.getProperty ( call SW.singleton en.housing_unit ) ( string ! type ) ) ( string allows_cats ) ) ( string has_private_bath ) ) )
apartments with private baths	( call SW.listValue ( call SW.filter ( call SW.filter ( call SW.getProperty ( call SW.singleton en.housing_unit ) ( string ! type ) ) ( string housing_type ) ( string = ) en.housing.apartment ) ( string has_private_bath ) ) )
housing posted before 123 sesame street	( call SW.listValue ( call SW.filter ( call SW.getProperty ( call SW.singleton en.housing_unit ) ( string ! type ) ) ( call SW.ensureNumericProperty ( string posting_date ) ) ( string < ) ( call SW.ensureNumericEntity ( call SW.getProperty en.housing_unit.123_sesame_street ( string posting_date ) ) ) ) )
show me housing that is the same type as at least two others	( call SW.listValue ( call SW.countComparative ( call SW.getProperty ( call SW.singleton en.housing ) ( string ! type ) ) ( call SW.reverse ( string housing_type ) ) ( string >= ) ( number 2 ) ( call SW.getProperty ( call SW.singleton en.housing_unit ) ( string ! type ) ) ) )
list all housing types that are not the same as those in 123 sesame street	( call SW.listValue ( call SW.filter ( call SW.getProperty ( call SW.singleton en.housing ) ( string ! type ) ) ( call SW.reverse ( string housing_type ) ) ( string ! = ) en.housing_unit.123_sesame_street ) )
find housing units that satisfies two housing types	( call SW.listValue ( call SW.countComparative ( call SW.getProperty ( call SW.singleton en.housing_unit ) ( string ! type ) ) ( string housing_type ) ( string <= ) ( number 2 ) ) )
what midtown west housing unit has a private bath	( call SW.listValue ( call SW.filter ( call SW.filter ( call SW.getProperty ( call SW.singleton en.housing_unit ) ( string ! type ) ) ( string neighborhood ) ( string = ) en.neighborhood.midtown_west ) ( string has_private_bath ) ) )
find housing units with size lesser than that of 123 sesame street	( call SW.listValue ( call SW.filter ( call SW.getProperty ( call SW.singleton en.housing_unit ) ( string ! type ) ) ( call SW.ensureNumericProperty ( string size ) ) ( string < ) ( call SW.ensureNumericEntity ( call SW.getProperty en.housing_unit.123_sesame_street ( string size ) ) ) ) )
what kind of housing is 123 sesame street or 900 mission ave	( call SW.listValue ( call SW.filter ( call SW.getProperty ( call SW.singleton en.housing ) ( string ! type ) ) ( call SW.reverse ( string housing_type ) ) ( string = ) ( call SW.concat en.housing_unit.123_sesame_street en.housing_unit.900_mission_ave ) ) )
what is the housing type of 123 sesame street	( call SW.listValue ( call SW.filter ( call SW.filter ( call SW.getProperty ( call SW.singleton en.housing ) ( string ! type ) ) ( call SW.reverse ( string housing_type ) ) ( string = ) en.housing_unit.123_sesame_street ) ( call SW.reverse ( string housing_type ) ) ( string = ) en.housing_unit.123_sesame_street ) )
housing units of either 800 square feet or 1000 square feet	( call SW.listValue ( call SW.concat ( number 800 en.square_feet ) ( number 1000 en.square_feet ) ) )
housing types in the midtown west	( call SW.listValue ( call SW.filter ( call SW.getProperty ( call SW.singleton en.housing ) ( string ! type ) ) ( call SW.reverse ( string housing_type ) ) ( string = ) ( call SW.filter ( call SW.getProperty ( call SW.singleton en.housing_unit ) ( string ! type ) ) ( string neighborhood ) ( string = ) en.neighborhood.midtown_west ) ) )
find housing units with private room near midtown west	( call SW.listValue ( call SW.filter ( call SW.filter ( call SW.getProperty ( call SW.singleton en.housing_unit ) ( string ! type ) ) ( string neighborhood ) ( string = ) en.neighborhood.midtown_west ) ( string has_private_room ) ) )
name housing types other than 123 sesame street type	( call SW.listValue ( call SW.filter ( call SW.getProperty ( call SW.singleton en.housing ) ( string ! type ) ) ( call SW.reverse ( string housing_type ) ) ( string ! = ) en.housing_unit.123_sesame_street ) )
aparartment or condo units	( call SW.listValue ( call SW.filter ( call SW.getProperty ( call SW.singleton en.housing_unit ) ( string ! type ) ) ( string housing_type ) ( string = ) ( call SW.concat en.housing.apartment en.housing.condo ) ) )
housing that is 1500month or less	( call SW.listValue ( call SW.filter ( call SW.getProperty ( call SW.singleton en.housing_unit ) ( string ! type ) ) ( call SW.ensureNumericProperty ( string rent ) ) ( string <= ) ( call SW.ensureNumericEntity ( number 1500 en.dollar ) ) ) )
which housing unit is available for the least rent	( call SW.listValue ( call SW.superlative ( call SW.getProperty ( call SW.singleton en.housing_unit ) ( string ! type ) ) ( string min ) ( call SW.ensureNumericProperty ( string rent ) ) ) )
name housing types that has more than one housing unit of that type	( call SW.listValue ( call SW.countComparative ( call SW.getProperty ( call SW.singleton en.housing ) ( string ! type ) ) ( call SW.reverse ( string housing_type ) ) ( string >= ) ( number 2 ) ( call SW.getProperty ( call SW.singleton en.housing_unit ) ( string ! type ) ) ) )
apartment type housing unit that has private bath	( call SW.listValue ( call SW.filter ( call SW.filter ( call SW.getProperty ( call SW.singleton en.housing_unit ) ( string ! type ) ) ( string has_private_bath ) ) ( string housing_type ) ( string = ) en.housing.apartment ) )
where are 800 square fee housing units that allow dogs	( call SW.listValue ( call SW.filter ( call SW.filter ( call SW.getProperty ( call SW.singleton en.housing_unit ) ( string ! type ) ) ( string size ) ( string = ) ( number 800 en.square_feet ) ) ( string allows_dogs ) ) )
which area has the most number of housing units	( call SW.listValue ( call SW.countSuperlative ( call SW.getProperty ( call SW.singleton en.housing_unit ) ( string ! type ) ) ( string max ) ( string neighborhood ) ) )
which is the housing unit that permits dogs inside it	( call SW.listValue ( call SW.filter ( call SW.filter ( call SW.getProperty ( call SW.singleton en.housing_unit ) ( string ! type ) ) ( string allows_dogs ) ) ( string allows_dogs ) ) )
find housing units with rental charges lesser than 2000 dollars	( call SW.listValue ( call SW.filter ( call SW.getProperty ( call SW.singleton en.housing_unit ) ( string ! type ) ) ( call SW.ensureNumericProperty ( string rent ) ) ( string < ) ( call SW.ensureNumericEntity ( call SW.concat ( number 1500 en.dollar ) ( number 2000 en.dollar ) ) ) ) )
find housing with a private room and bath	( call SW.listValue ( call SW.filter ( call SW.filter ( call SW.getProperty ( call SW.singleton en.housing_unit ) ( string ! type ) ) ( string has_private_room ) ) ( string has_private_bath ) ) )
catfriendly apartments in midtown west	( call SW.listValue ( call SW.filter ( call SW.filter ( call SW.getProperty ( call SW.singleton en.housing_unit ) ( string ! type ) ) ( string allows_cats ) ) ( string neighborhood ) ( string = ) en.neighborhood.midtown_west ) )
which housing unit has more than two kinds of houses	( call SW.listValue ( call SW.countComparative ( call SW.getProperty ( call SW.singleton en.housing ) ( string ! type ) ) ( call SW.reverse ( string housing_type ) ) ( string > ) ( number 2 ) ( call SW.getProperty ( call SW.singleton en.housing_unit ) ( string ! type ) ) ) )
what is the housing type of the two housing units	( call SW.listValue ( call SW.countComparative ( call SW.getProperty ( call SW.singleton en.housing ) ( string ! type ) ) ( call SW.reverse ( string housing_type ) ) ( string >= ) ( number 2 ) ( call SW.getProperty ( call SW.singleton en.housing_unit ) ( string ! type ) ) ) )
housing posted before january 2	( call SW.listValue ( call SW.filter ( call SW.getProperty ( call SW.singleton en.housing_unit ) ( string ! type ) ) ( call SW.ensureNumericProperty ( string posting_date ) ) ( string < ) ( call SW.ensureNumericEntity ( date 2015 1 2 ) ) ) )
apartments with the same rent as 123 sesame street	( call SW.listValue ( call SW.filter ( call SW.getProperty ( call SW.singleton en.housing_unit ) ( string ! type ) ) ( call SW.ensureNumericProperty ( string rent ) ) ( string >= ) ( call SW.ensureNumericEntity ( call SW.getProperty en.housing_unit.123_sesame_street ( string rent ) ) ) ) )
which housing unit allows dogs and cats	( call SW.listValue ( call SW.filter ( call SW.filter ( call SW.getProperty ( call SW.singleton en.housing_unit ) ( string ! type ) ) ( string allows_dogs ) ) ( string allows_cats ) ) )
find housing units in the same housing type of 123 sesame street	( call SW.listValue ( call SW.filter ( call SW.getProperty ( call SW.singleton en.housing_unit ) ( string ! type ) ) ( string housing_type ) ( string = ) ( call SW.getProperty en.housing_unit.123_sesame_street ( string housing_type ) ) ) )
which area has a minimum of two housing units	( call SW.listValue ( call SW.countComparative ( call SW.getProperty ( call SW.singleton en.neighborhood ) ( string ! type ) ) ( call SW.reverse ( string neighborhood ) ) ( string >= ) ( number 2 ) ( call SW.getProperty ( call SW.singleton en.housing_unit ) ( string ! type ) ) ) )
what housing has been posted lately	( call SW.listValue ( call SW.superlative ( call SW.getProperty ( call SW.singleton en.housing_unit ) ( string ! type ) ) ( string min ) ( call SW.ensureNumericProperty ( string posting_date ) ) ) )
which midtown west housing have 800 square feet	( call SW.listValue ( call SW.filter ( call SW.filter ( call SW.getProperty ( call SW.singleton en.housing_unit ) ( string ! type ) ) ( string size ) ( string = ) ( number 800 en.square_feet ) ) ( string neighborhood ) ( string = ) en.neighborhood.midtown_west ) )
what kind of housing is in midtown west	( call SW.listValue ( call SW.filter ( call SW.getProperty ( call SW.singleton en.housing ) ( string ! type ) ) ( call SW.reverse ( string housing_type ) ) ( string = ) ( call SW.filter ( call SW.getProperty ( call SW.singleton en.housing_unit ) ( string ! type ) ) ( string neighborhood ) ( string = ) en.neighborhood.midtown_west ) ) )
what housing is priced at 1500 or 2000 dollars	( call SW.listValue ( call SW.filter ( call SW.getProperty ( call SW.singleton en.housing_unit ) ( string ! type ) ) ( call SW.ensureNumericProperty ( string rent ) ) ( string <= ) ( call SW.ensureNumericEntity ( call SW.concat ( number 1500 en.dollar ) ( number 2000 en.dollar ) ) ) ) )
private bath with 800 square feet	( call SW.listValue ( call SW.filter ( call SW.filter ( call SW.getProperty ( call SW.singleton en.housing_unit ) ( string ! type ) ) ( string has_private_bath ) ) ( string size ) ( string = ) ( number 800 en.square_feet ) ) )
apartments similar in size to 123 sesame street	( call SW.listValue ( call SW.filter ( call SW.getProperty ( call SW.singleton en.housing_unit ) ( string ! type ) ) ( string size ) ( string = ) ( call SW.getProperty en.housing_unit.123_sesame_street ( string size ) ) ) )
either 800 or 1000 square feet	( call SW.listValue ( call SW.concat ( number 800 en.square_feet ) ( number 1000 en.square_feet ) ) )
apartments in midtown west with rent at 1500	( call SW.listValue ( call SW.filter ( call SW.filter ( call SW.getProperty ( call SW.singleton en.housing_unit ) ( string ! type ) ) ( string rent ) ( string = ) ( number 1500 en.dollar ) ) ( string neighborhood ) ( string = ) en.neighborhood.midtown_west ) )
catfriendly apartments with rent at 1500	( call SW.listValue ( call SW.filter ( call SW.filter ( call SW.getProperty ( call SW.singleton en.housing_unit ) ( string ! type ) ) ( string rent ) ( string = ) ( number 1500 en.dollar ) ) ( string allows_cats ) ) )
most expensive places to rent	( call SW.listValue ( call SW.superlative ( call SW.getProperty ( call SW.singleton en.housing_unit ) ( string ! type ) ) ( string max ) ( call SW.ensureNumericProperty ( string rent ) ) ) )
what is the average size of housing	( call SW.listValue ( call SW.aggregate ( string avg ) ( call SW.getProperty ( call SW.getProperty ( call SW.singleton en.housing_unit ) ( string ! type ) ) ( string size ) ) ) )
housing apartment with a private bath	( call SW.listValue ( call SW.filter ( call SW.filter ( call SW.getProperty ( call SW.singleton en.housing_unit ) ( string ! type ) ) ( string has_private_bath ) ) ( string housing_type ) ( string = ) en.housing.apartment ) )
800 foot apartment with a private room	( call SW.listValue ( call SW.filter ( call SW.filter ( call SW.getProperty ( call SW.singleton en.housing_unit ) ( string ! type ) ) ( string has_private_room ) ) ( string size ) ( string = ) ( number 800 en.square_feet ) ) )
what is the neighborhood of 123 sesame street	( call SW.listValue ( call SW.getProperty en.housing_unit.123_sesame_street ( string neighborhood ) ) )
find me a housing unti that chagres 1500 for rent and has a priiiiiiat bathroom	( call SW.listValue ( call SW.filter ( call SW.filter ( call SW.getProperty ( call SW.singleton en.housing_unit ) ( string ! type ) ) ( string rent ) ( string = ) ( number 1500 en.dollar ) ) ( string has_private_room ) ) )
in which area is 123 sesame street	( call SW.listValue ( call SW.filter ( call SW.getProperty ( call SW.singleton en.neighborhood ) ( string ! type ) ) ( call SW.reverse ( string neighborhood ) ) ( string = ) en.housing_unit.123_sesame_street ) )
quiet apartments	( call SW.listValue ( call SW.countComparative ( call SW.getProperty ( call SW.singleton en.housing_unit ) ( string ! type ) ) ( string neighborhood ) ( string < ) ( number 2 ) ) )
catfriendly housing with a private bath	( call SW.listValue ( call SW.filter ( call SW.filter ( call SW.getProperty ( call SW.singleton en.housing_unit ) ( string ! type ) ) ( string has_private_bath ) ) ( string allows_cats ) ) )
which housing unit around midtown west has a private bath	( call SW.listValue ( call SW.filter ( call SW.filter ( call SW.getProperty ( call SW.singleton en.housing_unit ) ( string ! type ) ) ( string has_private_bath ) ) ( string neighborhood ) ( string = ) en.neighborhood.midtown_west ) )
find housing units in the same size of 123 sesame street	( call SW.listValue ( call SW.filter ( call SW.getProperty ( call SW.singleton en.housing_unit ) ( string ! type ) ) ( string size ) ( string = ) ( call SW.getProperty en.housing_unit.123_sesame_street ( string size ) ) ) )
find housing larger than 123 sesame street	( call SW.listValue ( call SW.filter ( call SW.getProperty ( call SW.singleton en.housing_unit ) ( string ! type ) ) ( call SW.ensureNumericProperty ( string size ) ) ( string > ) ( call SW.ensureNumericEntity ( call SW.getProperty en.housing_unit.123_sesame_street ( string size ) ) ) ) )
building with two or less kinds of unis	( call SW.listValue ( call SW.countComparative ( call SW.getProperty ( call SW.singleton en.housing_unit ) ( string ! type ) ) ( string housing_type ) ( string <= ) ( number 2 ) ) )
housing units with a  orivate bath in the midtown west area	( call SW.listValue ( call SW.filter ( call SW.filter ( call SW.getProperty ( call SW.singleton en.housing_unit ) ( string ! type ) ) ( string neighborhood ) ( string = ) en.neighborhood.midtown_west ) ( string has_private_bath ) ) )
housing that does not have a higher rent then 123 sesame street	( call SW.listValue ( call SW.filter ( call SW.getProperty ( call SW.singleton en.housing_unit ) ( string ! type ) ) ( call SW.ensureNumericProperty ( string rent ) ) ( string <= ) ( call SW.ensureNumericEntity ( call SW.getProperty en.housing_unit.123_sesame_street ( string rent ) ) ) ) )
neighborhoods of housing units that allows cats	( call SW.listValue ( call SW.filter ( call SW.getProperty ( call SW.singleton en.neighborhood ) ( string ! type ) ) ( call SW.reverse ( string neighborhood ) ) ( string = ) ( call SW.filter ( call SW.getProperty ( call SW.singleton en.housing_unit ) ( string ! type ) ) ( string allows_cats ) ) ) )
housing unit which is an apartment that is dogs friendly	( call SW.listValue ( call SW.filter ( call SW.filter ( call SW.getProperty ( call SW.singleton en.housing_unit ) ( string ! type ) ) ( string allows_dogs ) ) ( string housing_type ) ( string = ) en.housing.apartment ) )
find apartments in the neighborhoods of midtown west	( call SW.listValue ( call SW.filter ( call SW.filter ( call SW.getProperty ( call SW.singleton en.housing_unit ) ( string ! type ) ) ( string neighborhood ) ( string = ) en.neighborhood.midtown_west ) ( string housing_type ) ( string = ) en.housing.apartment ) )
where is midtown west	( call SW.listValue ( call SW.filter ( call SW.getProperty ( call SW.singleton en.neighborhood ) ( string ! type ) ) ( call SW.reverse ( string neighborhood ) ) ( string = ) ( call SW.filter ( call SW.getProperty ( call SW.singleton en.housing_unit ) ( string ! type ) ) ( string neighborhood ) ( string = ) en.neighborhood.midtown_west ) ) )
which housing unit belongs to the apartment kind with the facility of a private troom	( call SW.listValue ( call SW.filter ( call SW.filter ( call SW.getProperty ( call SW.singleton en.housing_unit ) ( string ! type ) ) ( string has_private_room ) ) ( string housing_type ) ( string = ) en.housing.apartment ) )
housing unit with the smallest posting date	( call SW.listValue ( call SW.superlative ( call SW.getProperty ( call SW.singleton en.housing_unit ) ( string ! type ) ) ( string min ) ( call SW.ensureNumericProperty ( string posting_date ) ) ) )
housing that allows cats and is 1500 a month	( call SW.listValue ( call SW.filter ( call SW.filter ( call SW.getProperty ( call SW.singleton en.housing_unit ) ( string ! type ) ) ( string rent ) ( string = ) ( number 1500 en.dollar ) ) ( string allows_cats ) ) )
housing units with a small amount of housing	( call SW.listValue ( call SW.countSuperlative ( call SW.getProperty ( call SW.singleton en.housing_unit ) ( string ! type ) ) ( string min ) ( string housing_type ) ) )
neighborhood with more than two housing units	( call SW.listValue ( call SW.countComparative ( call SW.getProperty ( call SW.singleton en.neighborhood ) ( string ! type ) ) ( call SW.reverse ( string neighborhood ) ) ( string > ) ( number 2 ) ( call SW.getProperty ( call SW.singleton en.housing_unit ) ( string ! type ) ) ) )
housing unit that is not 800 square feet	( call SW.listValue ( call SW.filter ( call SW.getProperty ( call SW.singleton en.housing_unit ) ( string ! type ) ) ( string size ) ( string ! = ) ( number 800 en.square_feet ) ) )
housing that is smaller than 800 square feet or smaller than 1000 square feet	( call SW.listValue ( call SW.filter ( call SW.getProperty ( call SW.singleton en.housing_unit ) ( string ! type ) ) ( call SW.ensureNumericProperty ( string size ) ) ( string < ) ( call SW.ensureNumericEntity ( call SW.concat ( number 800 en.square_feet ) ( number 1000 en.square_feet ) ) ) ) )
neighborhoods that have 800 square foot housing	( call SW.listValue ( call SW.filter ( call SW.getProperty ( call SW.singleton en.neighborhood ) ( string ! type ) ) ( call SW.reverse ( string neighborhood ) ) ( string = ) ( call SW.filter ( call SW.getProperty ( call SW.singleton en.housing_unit ) ( string ! type ) ) ( string size ) ( string = ) ( number 800 en.square_feet ) ) ) )
show me housing which have a private bathroom and allow cats	( call SW.listValue ( call SW.filter ( call SW.filter ( call SW.getProperty ( call SW.singleton en.housing_unit ) ( string ! type ) ) ( string has_private_bath ) ) ( string allows_cats ) ) )
apartments with rent below 1500	( call SW.listValue ( call SW.filter ( call SW.getProperty ( call SW.singleton en.housing_unit ) ( string ! type ) ) ( call SW.ensureNumericProperty ( string rent ) ) ( string < ) ( call SW.ensureNumericEntity ( number 1500 en.dollar ) ) ) )
housing unit that allows cats with midtown west as neighborhood	( call SW.listValue ( call SW.filter ( call SW.filter ( call SW.getProperty ( call SW.singleton en.housing_unit ) ( string ! type ) ) ( string allows_cats ) ) ( string neighborhood ) ( string = ) en.neighborhood.midtown_west ) )
pet friendly housing near midtown west	( call SW.listValue ( call SW.filter ( call SW.filter ( call SW.getProperty ( call SW.singleton en.housing_unit ) ( string ! type ) ) ( string neighborhood ) ( string = ) en.neighborhood.midtown_west ) ( string allows_cats ) ) )
what are the housing units in the area around midtown west	( call SW.listValue ( call SW.filter ( call SW.getProperty ( call SW.singleton en.neighborhood ) ( string ! type ) ) ( call SW.reverse ( string neighborhood ) ) ( string = ) ( call SW.filter ( call SW.getProperty ( call SW.singleton en.housing_unit ) ( string ! type ) ) ( string neighborhood ) ( string = ) en.neighborhood.midtown_west ) ) )
apartments that have a private bath	( call SW.listValue ( call SW.filter ( call SW.filter ( call SW.getProperty ( call SW.singleton en.housing_unit ) ( string ! type ) ) ( string has_private_bath ) ) ( string has_private_bath ) ) )
units with larger rent than 123 sesame street	( call SW.listValue ( call SW.filter ( call SW.getProperty ( call SW.singleton en.housing_unit ) ( string ! type ) ) ( call SW.ensureNumericProperty ( string rent ) ) ( string > ) ( call SW.ensureNumericEntity ( call SW.getProperty en.housing_unit.123_sesame_street ( string rent ) ) ) ) )
what housing unit contains a private bath	( call SW.listValue ( call SW.filter ( call SW.getProperty ( call SW.singleton en.housing_unit ) ( string ! type ) ) ( string has_private_bath ) ) )
apartments that are catfriendly	( call SW.listValue ( call SW.filter ( call SW.filter ( call SW.getProperty ( call SW.singleton en.housing_unit ) ( string ! type ) ) ( string allows_cats ) ) ( string housing_type ) ( string = ) en.housing.apartment ) )
housing that is cheaper than 1500month	( call SW.listValue ( call SW.filter ( call SW.getProperty ( call SW.singleton en.housing_unit ) ( string ! type ) ) ( call SW.ensureNumericProperty ( string rent ) ) ( string < ) ( call SW.ensureNumericEntity ( number 1500 en.dollar ) ) ) )
count of different units	( call SW.listValue ( call .size ( call SW.getProperty ( call SW.singleton en.housing ) ( string ! type ) ) ) )
catfriendly housing	( call SW.listValue ( call SW.filter ( call SW.getProperty ( call SW.singleton en.housing_unit ) ( string ! type ) ) ( string allows_cats ) ) )
which housing unit is in the area of midtown west or chelsea	( call SW.listValue ( call SW.filter ( call SW.getProperty ( call SW.singleton en.housing_unit ) ( string ! type ) ) ( string neighborhood ) ( string = ) ( call SW.concat en.neighborhood.midtown_west en.neighborhood.chelsea ) ) )
find housing units with the most number of neighborhoods	( call SW.listValue ( call SW.countSuperlative ( call SW.getProperty ( call SW.singleton en.housing_unit ) ( string ! type ) ) ( string max ) ( string neighborhood ) ) )
find 800 square feet housing units in the neighborhoods of midtown west	( call SW.listValue ( call SW.filter ( call SW.filter ( call SW.getProperty ( call SW.singleton en.housing_unit ) ( string ! type ) ) ( string neighborhood ) ( string = ) en.neighborhood.midtown_west ) ( string size ) ( string = ) ( number 800 en.square_feet ) ) )
what is units monthly rental	( call SW.listValue ( call SW.aggregate ( string sum ) ( call SW.getProperty ( call SW.getProperty ( call SW.singleton en.housing_unit ) ( string ! type ) ) ( string rent ) ) ) )
pet friendly housing with 1500 dollars as rent	( call SW.listValue ( call SW.filter ( call SW.filter ( call SW.getProperty ( call SW.singleton en.housing_unit ) ( string ! type ) ) ( string allows_dogs ) ) ( string rent ) ( string = ) ( number 1500 en.dollar ) ) )
how much a month is the rent at 123 sesame street	( call SW.listValue ( call SW.getProperty en.housing_unit.123_sesame_street ( string rent ) ) )
housing that is 800 square feet with a private room	( call SW.listValue ( call SW.filter ( call SW.filter ( call SW.getProperty ( call SW.singleton en.housing_unit ) ( string ! type ) ) ( string has_private_room ) ) ( string size ) ( string = ) ( number 800 en.square_feet ) ) )
housing with the same rent as 123 sesame street	( call SW.listValue ( call SW.filter ( call SW.getProperty ( call SW.singleton en.housing_unit ) ( string ! type ) ) ( string rent ) ( string = ) ( call SW.getProperty en.housing_unit.123_sesame_street ( string rent ) ) ) )
midtown west unit with 1500 rent monthly	( call SW.listValue ( call SW.filter ( call SW.filter ( call SW.getProperty ( call SW.singleton en.housing_unit ) ( string ! type ) ) ( string rent ) ( string = ) ( number 1500 en.dollar ) ) ( string neighborhood ) ( string = ) en.neighborhood.midtown_west ) )
find housing units that are posted on the date same as 123 sesame street or later	( call SW.listValue ( call SW.filter ( call SW.getProperty ( call SW.singleton en.housing_unit ) ( string ! type ) ) ( call SW.ensureNumericProperty ( string posting_date ) ) ( string >= ) ( call SW.ensureNumericEntity ( call SW.getProperty en.housing_unit.123_sesame_street ( string posting_date ) ) ) ) )
find housing that allows dogs and cats	( call SW.listValue ( call SW.filter ( call SW.filter ( call SW.getProperty ( call SW.singleton en.housing_unit ) ( string ! type ) ) ( string allows_dogs ) ) ( string allows_cats ) ) )
find housing units with size lesser than 800 square feet	( call SW.listValue ( call SW.filter ( call SW.getProperty ( call SW.singleton en.housing_unit ) ( string ! type ) ) ( call SW.ensureNumericProperty ( string size ) ) ( string < ) ( call SW.ensureNumericEntity ( number 800 en.square_feet ) ) ) )
what is the type of housing that has a private room	( call SW.listValue ( call SW.filter ( call SW.getProperty ( call SW.singleton en.housing ) ( string ! type ) ) ( call SW.reverse ( string housing_type ) ) ( string = ) ( call SW.filter ( call SW.getProperty ( call SW.singleton en.housing_unit ) ( string ! type ) ) ( string has_private_room ) ) ) )
what kinds of housing has a private bath	( call SW.listValue ( call SW.filter ( call SW.getProperty ( call SW.singleton en.housing ) ( string ! type ) ) ( call SW.reverse ( string housing_type ) ) ( string = ) ( call SW.filter ( call SW.getProperty ( call SW.singleton en.housing_unit ) ( string ! type ) ) ( string has_private_bath ) ) ) )
which housing unit has an area of 800 square feet	( call SW.listValue ( call SW.filter ( call SW.filter ( call SW.getProperty ( call SW.singleton en.housing_unit ) ( string ! type ) ) ( string size ) ( string = ) ( number 800 en.square_feet ) ) ( string size ) ( string = ) ( number 800 en.square_feet ) ) )
800 square foot unit with rent of 1500 monthly	( call SW.listValue ( call SW.filter ( call SW.filter ( call SW.getProperty ( call SW.singleton en.housing_unit ) ( string ! type ) ) ( string rent ) ( string = ) ( number 1500 en.dollar ) ) ( string size ) ( string = ) ( number 800 en.square_feet ) ) )
housing found in the most neighborhoods	( call SW.listValue ( call SW.countSuperlative ( call SW.getProperty ( call SW.singleton en.housing_unit ) ( string ! type ) ) ( string max ) ( string neighborhood ) ) )
which 1500monthly rentals are 800 square feet	( call SW.listValue ( call SW.filter ( call SW.filter ( call SW.getProperty ( call SW.singleton en.housing_unit ) ( string ! type ) ) ( string rent ) ( string = ) ( number 1500 en.dollar ) ) ( string size ) ( string = ) ( number 800 en.square_feet ) ) )
apartments in the midtown west or chelsea neighborhoods	( call SW.listValue ( call SW.filter ( call SW.getProperty ( call SW.singleton en.housing_unit ) ( string ! type ) ) ( string neighborhood ) ( string = ) ( call SW.concat en.neighborhood.midtown_west en.neighborhood.chelsea ) ) )
housing that is 800 square feet and 1500month	( call SW.listValue ( call SW.filter ( call SW.filter ( call SW.getProperty ( call SW.singleton en.housing_unit ) ( string ! type ) ) ( string size ) ( string = ) ( number 800 en.square_feet ) ) ( string rent ) ( string = ) ( number 1500 en.dollar ) ) )
need a unit with a private room in the midtown west area	( call SW.listValue ( call SW.filter ( call SW.filter ( call SW.getProperty ( call SW.singleton en.housing_unit ) ( string ! type ) ) ( string has_private_room ) ) ( string neighborhood ) ( string = ) en.neighborhood.midtown_west ) )
which housing unit was not posted on jan 2	( call SW.listValue ( call SW.filter ( call SW.getProperty ( call SW.singleton en.housing_unit ) ( string ! type ) ) ( string posting_date ) ( string ! = ) ( date 2015 1 2 ) ) )
unit smaller than 123 sesame street	( call SW.listValue ( call SW.filter ( call SW.getProperty ( call SW.singleton en.housing_unit ) ( string ! type ) ) ( call SW.ensureNumericProperty ( string size ) ) ( string < ) ( call SW.ensureNumericEntity ( call SW.getProperty en.housing_unit.123_sesame_street ( string size ) ) ) ) )
housing that is 1500month or less or 2000month or less	( call SW.listValue ( call SW.filter ( call SW.getProperty ( call SW.singleton en.housing_unit ) ( string ! type ) ) ( call SW.ensureNumericProperty ( string rent ) ) ( string <= ) ( call SW.ensureNumericEntity ( call SW.concat ( number 1500 en.dollar ) ( number 2000 en.dollar ) ) ) ) )
show me housing in midtown west where dogs are welcome	( call SW.listValue ( call SW.filter ( call SW.filter ( call SW.getProperty ( call SW.singleton en.housing_unit ) ( string ! type ) ) ( string neighborhood ) ( string = ) en.neighborhood.midtown_west ) ( string allows_dogs ) ) )
apartment complexes with the most units	( call SW.listValue ( call SW.countSuperlative ( call SW.getProperty ( call SW.singleton en.housing_unit ) ( string ! type ) ) ( string max ) ( string housing_type ) ) )
catfriendly housing with a private room	( call SW.listValue ( call SW.filter ( call SW.filter ( call SW.getProperty ( call SW.singleton en.housing_unit ) ( string ! type ) ) ( string allows_cats ) ) ( string has_private_room ) ) )
what housing unit contains a private room and allows cats	( call SW.listValue ( call SW.filter ( call SW.filter ( call SW.getProperty ( call SW.singleton en.housing_unit ) ( string ! type ) ) ( string allows_cats ) ) ( string has_private_room ) ) )
find housing units with just one neighborhood	( call SW.listValue ( call SW.countComparative ( call SW.getProperty ( call SW.singleton en.housing_unit ) ( string ! type ) ) ( string neighborhood ) ( string < ) ( number 2 ) ) )
what is the average size of an apartment	( call SW.listValue ( call SW.aggregate ( string avg ) ( call SW.getProperty ( call SW.getProperty ( call SW.singleton en.housing_unit ) ( string ! type ) ) ( string size ) ) ) )
what housing unit is priced at 1500 dollars	( call SW.listValue ( call SW.filter ( call SW.getProperty ( call SW.singleton en.housing_unit ) ( string ! type ) ) ( call SW.ensureNumericProperty ( string rent ) ) ( string <= ) ( call SW.ensureNumericEntity ( number 1500 en.dollar ) ) ) )
housing unit in midtown west and allows dogs	( call SW.listValue ( call SW.filter ( call SW.filter ( call SW.getProperty ( call SW.singleton en.housing_unit ) ( string ! type ) ) ( string neighborhood ) ( string = ) en.neighborhood.midtown_west ) ( string allows_dogs ) ) )
what housing has a private room	( call SW.listValue ( call SW.filter ( call SW.getProperty ( call SW.singleton en.housing_unit ) ( string ! type ) ) ( string has_private_room ) ) )
apartments renting for 1500 a month	( call SW.listValue ( call SW.filter ( call SW.filter ( call SW.getProperty ( call SW.singleton en.housing_unit ) ( string ! type ) ) ( string rent ) ( string = ) ( number 1500 en.dollar ) ) ( string housing_type ) ( string = ) en.housing.apartment ) )
apartment similar to the apartment in midtown west	( call SW.listValue ( call SW.filter ( call SW.getProperty ( call SW.singleton en.housing ) ( string ! type ) ) ( call SW.reverse ( string housing_type ) ) ( string = ) ( call SW.filter ( call SW.getProperty ( call SW.singleton en.housing_unit ) ( string ! type ) ) ( string neighborhood ) ( string = ) en.neighborhood.midtown_west ) ) )
housing type on 123 sesame street	( call SW.listValue ( call SW.getProperty en.housing_unit.123_sesame_street ( string housing_type ) ) )
specify the housing type of the housing unit that has a private bath	( call SW.listValue ( call SW.filter ( call SW.getProperty ( call SW.singleton en.housing ) ( string ! type ) ) ( call SW.reverse ( string housing_type ) ) ( string = ) ( call SW.filter ( call SW.getProperty ( call SW.singleton en.housing_unit ) ( string ! type ) ) ( string has_private_bath ) ) ) )
what is the housing type that allows cats	( call SW.listValue ( call SW.filter ( call SW.getProperty ( call SW.singleton en.housing ) ( string ! type ) ) ( call SW.reverse ( string housing_type ) ) ( string = ) ( call SW.filter ( call SW.getProperty ( call SW.singleton en.housing_unit ) ( string ! type ) ) ( string allows_cats ) ) ) )
find housing similar to the house located at 123 sesame street	( call SW.listValue ( call SW.filter ( call SW.getProperty ( call SW.singleton en.housing_unit ) ( string ! type ) ) ( string housing_type ) ( string = ) ( call SW.filter ( call SW.getProperty ( call SW.singleton en.housing ) ( string ! type ) ) ( call SW.reverse ( string housing_type ) ) ( string = ) en.housing_unit.123_sesame_street ) ) )
how many housing units are there	( call SW.listValue ( call .size ( call SW.getProperty ( call SW.singleton en.housing_unit ) ( string ! type ) ) ) )
which housing has a monthly rent of 1500 dollars	( call SW.listValue ( call SW.filter ( call SW.filter ( call SW.getProperty ( call SW.singleton en.housing_unit ) ( string ! type ) ) ( string rent ) ( string = ) ( number 1500 en.dollar ) ) ( string rent ) ( string = ) ( number 1500 en.dollar ) ) )
area around 123sesame street	( call SW.listValue ( call SW.getProperty en.housing_unit.123_sesame_street ( string neighborhood ) ) )
neighborhoods with the least housing units	( call SW.listValue ( call SW.countSuperlative ( call SW.getProperty ( call SW.singleton en.neighborhood ) ( string ! type ) ) ( string min ) ( call SW.reverse ( string neighborhood ) ) ( call SW.getProperty ( call SW.singleton en.housing_unit ) ( string ! type ) ) ) )
what is the neighborhood of housing unit of the apartments	( call SW.listValue ( call SW.filter ( call SW.getProperty ( call SW.singleton en.neighborhood ) ( string ! type ) ) ( call SW.reverse ( string neighborhood ) ) ( string = ) ( call SW.filter ( call SW.getProperty ( call SW.singleton en.housing_unit ) ( string ! type ) ) ( string housing_type ) ( string = ) en.housing.apartment ) ) )
exclude apartments that are in the same neighborhood as 123 sesame street	( call SW.listValue ( call SW.filter ( call SW.getProperty ( call SW.singleton en.neighborhood ) ( string ! type ) ) ( call SW.reverse ( string neighborhood ) ) ( string ! = ) en.housing_unit.123_sesame_street ) )
housing that isnt in midtown west	( call SW.listValue ( call SW.filter ( call SW.getProperty ( call SW.singleton en.housing_unit ) ( string ! type ) ) ( string neighborhood ) ( string ! = ) en.neighborhood.midtown_west ) )
neighborhoods medtown west or chelsea	( call SW.listValue ( call SW.concat en.neighborhood.midtown_west en.neighborhood.chelsea ) )
find housing types other than 123 sesame street	( call SW.listValue ( call SW.filter ( call SW.getProperty ( call SW.singleton en.housing ) ( string ! type ) ) ( call SW.reverse ( string housing_type ) ) ( string ! = ) en.housing_unit.123_sesame_street ) )
seeking apartments between 1500 and 2000	( call SW.listValue ( call SW.concat ( number 1500 en.dollar ) ( number 2000 en.dollar ) ) )
what is that housing unit size	( call SW.listValue ( call SW.aggregate ( string sum ) ( call SW.getProperty ( call SW.getProperty ( call SW.singleton en.housing_unit ) ( string ! type ) ) ( string size ) ) ) )
apartments in midtown west with a private room	( call SW.listValue ( call SW.filter ( call SW.filter ( call SW.getProperty ( call SW.singleton en.housing_unit ) ( string ! type ) ) ( string has_private_room ) ) ( string neighborhood ) ( string = ) en.neighborhood.midtown_west ) )
which housing unit with a rent of 1500 dollars per month permits cats in it	( call SW.listValue ( call SW.filter ( call SW.filter ( call SW.getProperty ( call SW.singleton en.housing_unit ) ( string ! type ) ) ( string allows_cats ) ) ( string rent ) ( string = ) ( number 1500 en.dollar ) ) )
what housing has the cheapest rent	( call SW.listValue ( call SW.superlative ( call SW.getProperty ( call SW.singleton en.housing_unit ) ( string ! type ) ) ( string min ) ( call SW.ensureNumericProperty ( string rent ) ) ) )
how big is the housing unit	( call SW.listValue ( call SW.aggregate ( string sum ) ( call SW.getProperty ( call SW.getProperty ( call SW.singleton en.housing_unit ) ( string ! type ) ) ( string size ) ) ) )
what is the kind of housing available in 123 sesamre street	( call SW.listValue ( call SW.filter ( call SW.getProperty ( call SW.singleton en.housing ) ( string ! type ) ) ( call SW.reverse ( string housing_type ) ) ( string = ) en.housing_unit.123_sesame_street ) )
which housing unit does not belong to the apartment type with a monthly rent of 1500 dollars	( call SW.listValue ( call SW.filter ( call SW.filter ( call SW.getProperty ( call SW.singleton en.housing_unit ) ( string ! type ) ) ( string rent ) ( string = ) ( number 1500 en.dollar ) ) ( string housing_type ) ( string = ) en.housing.apartment ) )
which housing unit is bigger  in area by 800 square feet or 1000 square feet	( call SW.listValue ( call SW.filter ( call SW.getProperty ( call SW.singleton en.housing_unit ) ( string ! type ) ) ( call SW.ensureNumericProperty ( string size ) ) ( string > ) ( call SW.ensureNumericEntity ( call SW.concat ( number 800 en.square_feet ) ( number 1000 en.square_feet ) ) ) ) )
find cat friendly housing units that charge 1500 dollars as rent	( call SW.listValue ( call SW.filter ( call SW.filter ( call SW.getProperty ( call SW.singleton en.housing_unit ) ( string ! type ) ) ( string allows_cats ) ) ( string rent ) ( string = ) ( number 1500 en.dollar ) ) )
housing posted on or before january 2 or on or before february 3	( call SW.listValue ( call SW.filter ( call SW.getProperty ( call SW.singleton en.housing_unit ) ( string ! type ) ) ( call SW.ensureNumericProperty ( string posting_date ) ) ( string <= ) ( call SW.ensureNumericEntity ( call SW.concat ( date 2015 1 2 ) ( date 2015 2 3 ) ) ) ) )
find the largest housing unit	( call SW.listValue ( call SW.superlative ( call SW.getProperty ( call SW.singleton en.housing_unit ) ( string ! type ) ) ( string max ) ( call SW.ensureNumericProperty ( string size ) ) ) )
apartments in the midtown west neighborhood	( call SW.listValue ( call SW.filter ( call SW.filter ( call SW.getProperty ( call SW.singleton en.housing_unit ) ( string ! type ) ) ( string housing_type ) ( string = ) en.housing.apartment ) ( string neighborhood ) ( string = ) en.neighborhood.midtown_west ) )
rent less than 15002000 dollars	( call SW.listValue ( call SW.filter ( call SW.getProperty ( call SW.singleton en.housing_unit ) ( string ! type ) ) ( call SW.ensureNumericProperty ( string rent ) ) ( string < ) ( call SW.ensureNumericEntity ( call SW.concat ( number 1500 en.dollar ) ( number 2000 en.dollar ) ) ) ) )
which housing unit in the area permits cats	( call SW.listValue ( call SW.filter ( call SW.getProperty ( call SW.singleton en.neighborhood ) ( string ! type ) ) ( call SW.reverse ( string neighborhood ) ) ( string = ) ( call SW.filter ( call SW.getProperty ( call SW.singleton en.housing_unit ) ( string ! type ) ) ( string allows_cats ) ) ) )
housing in the neighborhood of 123 sesame street or 900 mission ave	( call SW.listValue ( call SW.filter ( call SW.getProperty ( call SW.singleton en.neighborhood ) ( string ! type ) ) ( call SW.reverse ( string neighborhood ) ) ( string = ) ( call SW.concat en.housing_unit.123_sesame_street en.housing_unit.900_mission_ave ) ) )
housing unit within at most 2 neighborhoods	( call SW.listValue ( call SW.countComparative ( call SW.getProperty ( call SW.singleton en.housing_unit ) ( string ! type ) ) ( string neighborhood ) ( string <= ) ( number 2 ) ) )
housing unit with a private bath and 1500 dollar rent	( call SW.listValue ( call SW.filter ( call SW.filter ( call SW.getProperty ( call SW.singleton en.housing_unit ) ( string ! type ) ) ( string has_private_bath ) ) ( string rent ) ( string = ) ( number 1500 en.dollar ) ) )
find housing units with a private room and is dog friendly	( call SW.listValue ( call SW.filter ( call SW.filter ( call SW.getProperty ( call SW.singleton en.housing_unit ) ( string ! type ) ) ( string allows_dogs ) ) ( string has_private_room ) ) )
800 square foot apartment in midtown west	( call SW.listValue ( call SW.filter ( call SW.filter ( call SW.getProperty ( call SW.singleton en.housing_unit ) ( string ! type ) ) ( string size ) ( string = ) ( number 800 en.square_feet ) ) ( string neighborhood ) ( string = ) en.neighborhood.midtown_west ) )
housing costing more than 1500 dollars per month	( call SW.listValue ( call SW.filter ( call SW.getProperty ( call SW.singleton en.housing_unit ) ( string ! type ) ) ( call SW.ensureNumericProperty ( string rent ) ) ( string > ) ( call SW.ensureNumericEntity ( number 1500 en.dollar ) ) ) )
apartments with a private bath	( call SW.listValue ( call SW.filter ( call SW.filter ( call SW.getProperty ( call SW.singleton en.housing_unit ) ( string ! type ) ) ( string housing_type ) ( string = ) en.housing.apartment ) ( string has_private_bath ) ) )
what is the square footage of 123 sesame street	( call SW.listValue ( call SW.getProperty en.housing_unit.123_sesame_street ( string size ) ) )
housing posted on or before january 2	( call SW.listValue ( call SW.filter ( call SW.getProperty ( call SW.singleton en.housing_unit ) ( string ! type ) ) ( call SW.ensureNumericProperty ( string posting_date ) ) ( string <= ) ( call SW.ensureNumericEntity ( date 2015 1 2 ) ) ) )
apartment with a private room that rents for 1500 a month	( call SW.listValue ( call SW.filter ( call SW.filter ( call SW.getProperty ( call SW.singleton en.housing_unit ) ( string ! type ) ) ( string rent ) ( string = ) ( number 1500 en.dollar ) ) ( string has_private_room ) ) )
housing in midtown west with a private room	( call SW.listValue ( call SW.filter ( call SW.filter ( call SW.getProperty ( call SW.singleton en.housing_unit ) ( string ! type ) ) ( string has_private_room ) ) ( string neighborhood ) ( string = ) en.neighborhood.midtown_west ) )
housing unit with a private bath and cost 1500 dollars rent	( call SW.listValue ( call SW.filter ( call SW.filter ( call SW.getProperty ( call SW.singleton en.housing_unit ) ( string ! type ) ) ( string has_private_bath ) ) ( string rent ) ( string = ) ( number 1500 en.dollar ) ) )
what is the rent of 123 sesame street	( call SW.listValue ( call SW.getProperty en.housing_unit.123_sesame_street ( string rent ) ) )
neighborhood with the most housing units	( call SW.listValue ( call SW.countSuperlative ( call SW.getProperty ( call SW.singleton en.neighborhood ) ( string ! type ) ) ( string max ) ( call SW.reverse ( string neighborhood ) ) ( call SW.getProperty ( call SW.singleton en.housing_unit ) ( string ! type ) ) ) )
apartment with a master bedroom and private bath	( call SW.listValue ( call SW.filter ( call SW.filter ( call SW.getProperty ( call SW.singleton en.housing_unit ) ( string ! type ) ) ( string has_private_room ) ) ( string has_private_bath ) ) )
show me housing in midtown west or chelsea	( call SW.listValue ( call SW.filter ( call SW.getProperty ( call SW.singleton en.housing_unit ) ( string ! type ) ) ( string neighborhood ) ( string = ) ( call SW.concat en.neighborhood.midtown_west en.neighborhood.chelsea ) ) )
which housing unit has apartment kind of house with an area of 800 square feet	( call SW.listValue ( call SW.filter ( call SW.filter ( call SW.getProperty ( call SW.singleton en.housing_unit ) ( string ! type ) ) ( string size ) ( string = ) ( number 800 en.square_feet ) ) ( string housing_type ) ( string = ) en.housing.apartment ) )
find 800 square feet housing units that are cat friendly	( call SW.listValue ( call SW.filter ( call SW.filter ( call SW.getProperty ( call SW.singleton en.housing_unit ) ( string ! type ) ) ( string allows_cats ) ) ( string size ) ( string = ) ( number 800 en.square_feet ) ) )
what is the housing type number	( call SW.listValue ( call .size ( call SW.getProperty ( call SW.singleton en.housing ) ( string ! type ) ) ) )
housing that is either an apartment or townhouse	( call SW.listValue ( call SW.countComparative ( call SW.getProperty ( call SW.singleton en.housing ) ( string ! type ) ) ( call SW.reverse ( string housing_type ) ) ( string > ) ( number 2 ) ( call SW.getProperty ( call SW.singleton en.housing_unit ) ( string ! type ) ) ) )
show me housing where dogs are allowed	( call SW.listValue ( call SW.filter ( call SW.filter ( call SW.getProperty ( call SW.singleton en.housing_unit ) ( string ! type ) ) ( string allows_dogs ) ) ( string allows_dogs ) ) )
apartments 800 square feet and above	( call SW.listValue ( call SW.filter ( call SW.getProperty ( call SW.singleton en.housing_unit ) ( string ! type ) ) ( call SW.ensureNumericProperty ( string size ) ) ( string >= ) ( call SW.ensureNumericEntity ( number 800 en.square_feet ) ) ) )
which housing with a private room rents for 1500 dollar monthly	( call SW.listValue ( call SW.filter ( call SW.filter ( call SW.getProperty ( call SW.singleton en.housing_unit ) ( string ! type ) ) ( string has_private_room ) ) ( string rent ) ( string = ) ( number 1500 en.dollar ) ) )
housing with a private room that is 800 square feet total	( call SW.listValue ( call SW.filter ( call SW.filter ( call SW.getProperty ( call SW.singleton en.housing_unit ) ( string ! type ) ) ( string size ) ( string = ) ( number 800 en.square_feet ) ) ( string has_private_room ) ) )
exclude apartments from midtown west	( call SW.listValue ( call SW.filter ( call SW.getProperty ( call SW.singleton en.housing_unit ) ( string ! type ) ) ( string neighborhood ) ( string ! = ) en.neighborhood.midtown_west ) )
what type of housing is 123 sesame street	( call SW.listValue ( call SW.filter ( call SW.getProperty ( call SW.singleton en.housing ) ( string ! type ) ) ( call SW.reverse ( string housing_type ) ) ( string = ) en.housing_unit.123_sesame_street ) )
find housing units with rental charges between 1500 to 2000 dollars	( call SW.listValue ( call SW.filter ( call SW.getProperty ( call SW.singleton en.housing_unit ) ( string ! type ) ) ( call SW.ensureNumericProperty ( string rent ) ) ( string >= ) ( call SW.ensureNumericEntity ( call SW.concat ( number 1500 en.dollar ) ( number 2000 en.dollar ) ) ) ) )
which housing unit has the least variety of houses	( call SW.listValue ( call SW.countSuperlative ( call SW.getProperty ( call SW.singleton en.housing_unit ) ( string ! type ) ) ( string min ) ( string housing_type ) ) )
housing that is 800 square feet or less or 1000 square feet or less	( call SW.listValue ( call SW.filter ( call SW.getProperty ( call SW.singleton en.housing_unit ) ( string ! type ) ) ( call SW.ensureNumericProperty ( string size ) ) ( string <= ) ( call SW.ensureNumericEntity ( call SW.concat ( number 800 en.square_feet ) ( number 1000 en.square_feet ) ) ) ) )
800 square foot apartment that allows cats	( call SW.listValue ( call SW.filter ( call SW.filter ( call SW.getProperty ( call SW.singleton en.housing_unit ) ( string ! type ) ) ( string size ) ( string = ) ( number 800 en.square_feet ) ) ( string allows_cats ) ) )
find housing units with less than or equal to the rent of 123 sesame street	( call SW.listValue ( call SW.filter ( call SW.getProperty ( call SW.singleton en.housing_unit ) ( string ! type ) ) ( call SW.ensureNumericProperty ( string rent ) ) ( string <= ) ( call SW.ensureNumericEntity ( call SW.getProperty en.housing_unit.123_sesame_street ( string rent ) ) ) ) )
which housing unit permits dogs and has the facility of a private bath	( call SW.listValue ( call SW.filter ( call SW.filter ( call SW.getProperty ( call SW.singleton en.housing_unit ) ( string ! type ) ) ( string allows_dogs ) ) ( string has_private_bath ) ) )
which 1500monthly rentals are dogfriendly	( call SW.listValue ( call SW.filter ( call SW.filter ( call SW.getProperty ( call SW.singleton en.housing_unit ) ( string ! type ) ) ( string allows_dogs ) ) ( string rent ) ( string = ) ( number 1500 en.dollar ) ) )
housing unit near midtown west	( call SW.listValue ( call SW.filter ( call SW.getProperty ( call SW.singleton en.housing_unit ) ( string ! type ) ) ( string neighborhood ) ( string = ) en.neighborhood.midtown_west ) )
when was 123 sesame street posted	( call SW.listValue ( call SW.getProperty en.housing_unit.123_sesame_street ( string posting_date ) ) )
housing the same size as 123 sesame street	( call SW.listValue ( call SW.filter ( call SW.getProperty ( call SW.singleton en.housing_unit ) ( string ! type ) ) ( call SW.ensureNumericProperty ( string size ) ) ( string <= ) ( call SW.ensureNumericEntity ( call SW.getProperty en.housing_unit.123_sesame_street ( string size ) ) ) ) )
housing that is 1500month and 800 square feet	( call SW.listValue ( call SW.filter ( call SW.filter ( call SW.getProperty ( call SW.singleton en.housing_unit ) ( string ! type ) ) ( string rent ) ( string = ) ( number 1500 en.dollar ) ) ( string size ) ( string = ) ( number 800 en.square_feet ) ) )
find housing units posted before january 2nd	( call SW.listValue ( call SW.filter ( call SW.getProperty ( call SW.singleton en.housing_unit ) ( string ! type ) ) ( call SW.ensureNumericProperty ( string posting_date ) ) ( string <= ) ( call SW.ensureNumericEntity ( date 2015 1 2 ) ) ) )
how large is the housing unit	( call SW.listValue ( call SW.aggregate ( string sum ) ( call SW.getProperty ( call SW.getProperty ( call SW.singleton en.housing_unit ) ( string ! type ) ) ( string size ) ) ) )
housing units with a private bath	( call SW.listValue ( call SW.filter ( call SW.getProperty ( call SW.singleton en.housing_unit ) ( string ! type ) ) ( string has_private_bath ) ) )
find housing units with monthly not equal to 1500 dollars	( call SW.listValue ( call SW.filter ( call SW.getProperty ( call SW.singleton en.housing_unit ) ( string ! type ) ) ( string rent ) ( string ! = ) ( number 1500 en.dollar ) ) )
which housing in midtown west has a private bath	( call SW.listValue ( call SW.filter ( call SW.filter ( call SW.getProperty ( call SW.singleton en.housing_unit ) ( string ! type ) ) ( string has_private_bath ) ) ( string neighborhood ) ( string = ) en.neighborhood.midtown_west ) )
what kind of housing is available for 1500month	( call SW.listValue ( call SW.filter ( call SW.getProperty ( call SW.singleton en.housing ) ( string ! type ) ) ( call SW.reverse ( string housing_type ) ) ( string = ) ( call SW.filter ( call SW.getProperty ( call SW.singleton en.housing_unit ) ( string ! type ) ) ( string rent ) ( string = ) ( number 1500 en.dollar ) ) ) )
what is the date of the 123 sesame street posting	( call SW.listValue ( call SW.getProperty en.housing_unit.123_sesame_street ( string posting_date ) ) )
looking for housing that is either an apartment or condo	( call SW.listValue ( call SW.filter ( call SW.getProperty ( call SW.singleton en.housing_unit ) ( string ! type ) ) ( string housing_type ) ( string = ) ( call SW.concat en.housing.apartment en.housing.condo ) ) )
housing units that are apartments	( call SW.listValue ( call SW.filter ( call SW.getProperty ( call SW.singleton en.housing_unit ) ( string ! type ) ) ( string housing_type ) ( string = ) en.housing.apartment ) )
which housing unit has an apartment kind of house	( call SW.listValue ( call SW.filter ( call SW.getProperty ( call SW.singleton en.housing ) ( string ! type ) ) ( call SW.reverse ( string housing_type ) ) ( string = ) ( call SW.filter ( call SW.getProperty ( call SW.singleton en.housing_unit ) ( string ! type ) ) ( string housing_type ) ( string = ) en.housing.apartment ) ) )
housing unit which is an apartment housing type with a private room	( call SW.listValue ( call SW.filter ( call SW.filter ( call SW.getProperty ( call SW.singleton en.housing_unit ) ( string ! type ) ) ( string housing_type ) ( string = ) en.housing.apartment ) ( string has_private_room ) ) )
what housing has the latest posting date	( call SW.listValue ( call SW.superlative ( call SW.getProperty ( call SW.singleton en.housing_unit ) ( string ! type ) ) ( string max ) ( call SW.ensureNumericProperty ( string posting_date ) ) ) )
apartment with a private bath that also accepts cats	( call SW.listValue ( call SW.filter ( call SW.filter ( call SW.getProperty ( call SW.singleton en.housing_unit ) ( string ! type ) ) ( string allows_cats ) ) ( string has_private_bath ) ) )
housing that is at least 800 square feet or at least 1000 square feet	( call SW.listValue ( call SW.filter ( call SW.getProperty ( call SW.singleton en.housing_unit ) ( string ! type ) ) ( call SW.ensureNumericProperty ( string size ) ) ( string >= ) ( call SW.ensureNumericEntity ( call SW.concat ( number 800 en.square_feet ) ( number 1000 en.square_feet ) ) ) ) )
neighborhoods with housing that has a private bath	( call SW.listValue ( call SW.filter ( call SW.getProperty ( call SW.singleton en.neighborhood ) ( string ! type ) ) ( call SW.reverse ( string neighborhood ) ) ( string = ) ( call SW.filter ( call SW.getProperty ( call SW.singleton en.housing_unit ) ( string ! type ) ) ( string has_private_bath ) ) ) )
what is the neighborhood  of the housing unit with the monthly rent 1500 dollars	( call SW.listValue ( call SW.filter ( call SW.getProperty ( call SW.singleton en.neighborhood ) ( string ! type ) ) ( call SW.reverse ( string neighborhood ) ) ( string = ) ( call SW.filter ( call SW.getProperty ( call SW.singleton en.housing_unit ) ( string ! type ) ) ( string rent ) ( string = ) ( number 1500 en.dollar ) ) ) )
which housing unit with an area of 800 square feet has a private room	( call SW.listValue ( call SW.filter ( call SW.filter ( call SW.getProperty ( call SW.singleton en.housing_unit ) ( string ! type ) ) ( string has_private_room ) ) ( string size ) ( string = ) ( number 800 en.square_feet ) ) )
apartment with a private bathroom	( call SW.listValue ( call SW.filter ( call SW.filter ( call SW.getProperty ( call SW.singleton en.housing_unit ) ( string ! type ) ) ( string housing_type ) ( string = ) en.housing.apartment ) ( string has_private_bath ) ) )
cats allowed in midtown west	( call SW.listValue ( call SW.filter ( call SW.filter ( call SW.getProperty ( call SW.singleton en.housing_unit ) ( string ! type ) ) ( string neighborhood ) ( string = ) en.neighborhood.midtown_west ) ( string allows_cats ) ) )
800 square foot apartment with a private bath	( call SW.listValue ( call SW.filter ( call SW.filter ( call SW.getProperty ( call SW.singleton en.housing_unit ) ( string ! type ) ) ( string has_private_bath ) ) ( string size ) ( string = ) ( number 800 en.square_feet ) ) )
housing unit with a private room	( call SW.listValue ( call SW.filter ( call SW.getProperty ( call SW.singleton en.housing_unit ) ( string ! type ) ) ( string has_private_room ) ) )
find 800 square feet sized housing in the neighborhoods of midtown west	( call SW.listValue ( call SW.filter ( call SW.filter ( call SW.getProperty ( call SW.singleton en.housing_unit ) ( string ! type ) ) ( string size ) ( string = ) ( number 800 en.square_feet ) ) ( string neighborhood ) ( string = ) en.neighborhood.midtown_west ) )
apartments with a private bathroom that allow cats	( call SW.listValue ( call SW.filter ( call SW.filter ( call SW.getProperty ( call SW.singleton en.housing_unit ) ( string ! type ) ) ( string has_private_room ) ) ( string allows_cats ) ) )
which kind of housing permits cats inside it	( call SW.listValue ( call SW.filter ( call SW.getProperty ( call SW.singleton en.housing ) ( string ! type ) ) ( call SW.reverse ( string housing_type ) ) ( string = ) ( call SW.filter ( call SW.getProperty ( call SW.singleton en.housing_unit ) ( string ! type ) ) ( string allows_cats ) ) ) )
how many neighborhoods are in the city	( call SW.listValue ( call .size ( call SW.getProperty ( call SW.singleton en.neighborhood ) ( string ! type ) ) ) )
where are the most number of housing units found	( call SW.listValue ( call SW.countSuperlative ( call SW.getProperty ( call SW.singleton en.neighborhood ) ( string ! type ) ) ( string max ) ( call SW.reverse ( string neighborhood ) ) ( call SW.getProperty ( call SW.singleton en.housing_unit ) ( string ! type ) ) ) )
building with the least number of housing types	( call SW.listValue ( call SW.countSuperlative ( call SW.getProperty ( call SW.singleton en.housing_unit ) ( string ! type ) ) ( string min ) ( string housing_type ) ) )
compare 123 sesame street and 900 mission avenue	( call SW.listValue ( call SW.concat en.housing_unit.123_sesame_street en.housing_unit.900_mission_ave ) )
housing unit that allows cats and has a private bath	( call SW.listValue ( call SW.filter ( call SW.filter ( call SW.getProperty ( call SW.singleton en.housing_unit ) ( string ! type ) ) ( string allows_cats ) ) ( string has_private_bath ) ) )
apartments with a private bath that allow dogs	( call SW.listValue ( call SW.filter ( call SW.filter ( call SW.getProperty ( call SW.singleton en.housing_unit ) ( string ! type ) ) ( string allows_dogs ) ) ( string has_private_bath ) ) )
show me housing units that arent apartments	( call SW.listValue ( call SW.filter ( call SW.getProperty ( call SW.singleton en.housing_unit ) ( string ! type ) ) ( string housing_type ) ( string ! = ) en.housing.apartment ) )
find housing with rental charges between 1500 and 2000 dollars	( call SW.listValue ( call SW.filter ( call SW.getProperty ( call SW.singleton en.housing_unit ) ( string ! type ) ) ( string rent ) ( string = ) ( call SW.concat ( number 1500 en.dollar ) ( number 2000 en.dollar ) ) ) )
find housing units with a private room and has 1500 dollars as monthly rent	( call SW.listValue ( call SW.filter ( call SW.filter ( call SW.getProperty ( call SW.singleton en.housing_unit ) ( string ! type ) ) ( string has_private_room ) ) ( string rent ) ( string = ) ( number 1500 en.dollar ) ) )
housing that costs the same as 123 sesame street	( call SW.listValue ( call SW.filter ( call SW.getProperty ( call SW.singleton en.housing_unit ) ( string ! type ) ) ( string rent ) ( string = ) ( call SW.getProperty en.housing_unit.123_sesame_street ( string rent ) ) ) )
list all apartments in midtown west	( call SW.listValue ( call SW.filter ( call SW.filter ( call SW.getProperty ( call SW.singleton en.housing_unit ) ( string ! type ) ) ( string housing_type ) ( string = ) en.housing.apartment ) ( string neighborhood ) ( string = ) en.neighborhood.midtown_west ) )
which housing unit with an area of 800 square permits dogs	( call SW.listValue ( call SW.filter ( call SW.filter ( call SW.getProperty ( call SW.singleton en.housing_unit ) ( string ! type ) ) ( string size ) ( string = ) ( number 800 en.square_feet ) ) ( string allows_dogs ) ) )
which area has less than two housing units	( call SW.listValue ( call SW.countComparative ( call SW.getProperty ( call SW.singleton en.housing_unit ) ( string ! type ) ) ( string neighborhood ) ( string < ) ( number 2 ) ) )
housing unit that costs 1500 dollars rent and allows dogs	( call SW.listValue ( call SW.filter ( call SW.filter ( call SW.getProperty ( call SW.singleton en.housing_unit ) ( string ! type ) ) ( string rent ) ( string = ) ( number 1500 en.dollar ) ) ( string allows_dogs ) ) )
800 square foot apartment with a private room	( call SW.listValue ( call SW.filter ( call SW.filter ( call SW.getProperty ( call SW.singleton en.housing_unit ) ( string ! type ) ) ( string size ) ( string = ) ( number 800 en.square_feet ) ) ( string has_private_room ) ) )
which types of housing have a private bathroom	( call SW.listValue ( call SW.filter ( call SW.getProperty ( call SW.singleton en.housing ) ( string ! type ) ) ( call SW.reverse ( string housing_type ) ) ( string = ) ( call SW.filter ( call SW.getProperty ( call SW.singleton en.housing_unit ) ( string ! type ) ) ( string has_private_bath ) ) ) )
find housing units in the neighborhoods of midtown west	( call SW.listValue ( call SW.filter ( call SW.filter ( call SW.getProperty ( call SW.singleton en.housing_unit ) ( string ! type ) ) ( string neighborhood ) ( string = ) en.neighborhood.midtown_west ) ( string neighborhood ) ( string = ) en.neighborhood.midtown_west ) )
what day did 123 sesame street become available	( call SW.listValue ( call SW.getProperty en.housing_unit.123_sesame_street ( string posting_date ) ) )
800 square feet in midtown west	( call SW.listValue ( call SW.filter ( call SW.filter ( call SW.getProperty ( call SW.singleton en.housing_unit ) ( string ! type ) ) ( string size ) ( string = ) ( number 800 en.square_feet ) ) ( string neighborhood ) ( string = ) en.neighborhood.midtown_west ) )
apartments with a private bathroom	( call SW.listValue ( call SW.filter ( call SW.getProperty ( call SW.singleton en.housing ) ( string ! type ) ) ( call SW.reverse ( string housing_type ) ) ( string = ) ( call SW.filter ( call SW.getProperty ( call SW.singleton en.housing_unit ) ( string ! type ) ) ( string has_private_bath ) ) ) )
what is the most numerous housing type	( call SW.listValue ( call SW.countSuperlative ( call SW.getProperty ( call SW.singleton en.housing_unit ) ( string ! type ) ) ( string max ) ( string housing_type ) ) )
apartment or condo	( call SW.listValue ( call SW.filter ( call SW.getProperty ( call SW.singleton en.housing_unit ) ( string ! type ) ) ( string housing_type ) ( string = ) ( call SW.concat en.housing.apartment en.housing.condo ) ) )
find housing units far from midtown west	( call SW.listValue ( call SW.filter ( call SW.getProperty ( call SW.singleton en.housing_unit ) ( string ! type ) ) ( string neighborhood ) ( string ! = ) en.neighborhood.midtown_west ) )
housing unit with the largest posting date	( call SW.listValue ( call SW.superlative ( call SW.getProperty ( call SW.singleton en.housing_unit ) ( string ! type ) ) ( string max ) ( call SW.ensureNumericProperty ( string posting_date ) ) ) )
smallest housing units	( call SW.listValue ( call SW.superlative ( call SW.getProperty ( call SW.singleton en.housing_unit ) ( string ! type ) ) ( string min ) ( call SW.ensureNumericProperty ( string size ) ) ) )
housing units that allow cats in midtown west	( call SW.listValue ( call SW.filter ( call SW.filter ( call SW.getProperty ( call SW.singleton en.housing_unit ) ( string ! type ) ) ( string neighborhood ) ( string = ) en.neighborhood.midtown_west ) ( string allows_cats ) ) )
which housing unit has a maximum of two housing types	( call SW.listValue ( call SW.countComparative ( call SW.getProperty ( call SW.singleton en.housing_unit ) ( string ! type ) ) ( string housing_type ) ( string <= ) ( number 2 ) ) )
which kind of housing is available for a rent of 1500 dollars per month	( call SW.listValue ( call SW.filter ( call SW.getProperty ( call SW.singleton en.housing ) ( string ! type ) ) ( call SW.reverse ( string housing_type ) ) ( string = ) ( call SW.filter ( call SW.getProperty ( call SW.singleton en.housing_unit ) ( string ! type ) ) ( string rent ) ( string = ) ( number 1500 en.dollar ) ) ) )
housing units in midtown west that allow dogs	( call SW.listValue ( call SW.filter ( call SW.filter ( call SW.getProperty ( call SW.singleton en.housing_unit ) ( string ! type ) ) ( string neighborhood ) ( string = ) en.neighborhood.midtown_west ) ( string allows_dogs ) ) )
what is the average find 800 square feet housing units that allow cats	( call SW.listValue ( call SW.aggregate ( string avg ) ( call SW.getProperty ( call SW.getProperty ( call SW.singleton en.housing_unit ) ( string ! type ) ) ( string size ) ) ) )
housing unit that both have a private room and allow dogs	( call SW.listValue ( call SW.filter ( call SW.filter ( call SW.getProperty ( call SW.singleton en.housing_unit ) ( string ! type ) ) ( string has_private_room ) ) ( string allows_dogs ) ) )
which housing unit is posted lately	( call SW.listValue ( call SW.superlative ( call SW.getProperty ( call SW.singleton en.housing_unit ) ( string ! type ) ) ( string min ) ( call SW.ensureNumericProperty ( string posting_date ) ) ) )
which neighborhood is 123 sesame street in	( call SW.listValue ( call SW.filter ( call SW.getProperty ( call SW.singleton en.neighborhood ) ( string ! type ) ) ( call SW.reverse ( string neighborhood ) ) ( string = ) en.housing_unit.123_sesame_street ) )
what apartment costs 1500 dollars	( call SW.listValue ( call SW.filter ( call SW.filter ( call SW.getProperty ( call SW.singleton en.housing_unit ) ( string ! type ) ) ( string housing_type ) ( string = ) en.housing.apartment ) ( string rent ) ( string = ) ( number 1500 en.dollar ) ) )
condomonium or flat	( call SW.listValue ( call SW.concat en.housing.apartment en.housing.condo ) )
