restaurant that is good for kids and that takes credit cards	restaurant that is good for kids and that takes credit cards
cuisine in at least 2 restaurants	cuisine that is cuisine of more than two restaurant
what restaurants serve groups and accept credit cards	restaurant that takes credit cards and that is good for groups
what is the price rating of thai cafe	price rating of thai cafe
what is a meal that the thai cafe does not serve	meal that thai cafe not serves
thai or italian restaurants	restaurant whose cuisine is thai or italian
which resturants have takeout and a price rating of 2 dollar signs	restaurant whose price rating is 2 dollar signs and that has take
restaurant that has waiter service and that has delivery	restaurant that has waiter service and that has delivery
what midtown west restaurant can i get takeout from	restaurant that has take
restaurant that is cheaper than thai cafe	restaurant whose price rating is smaller than price rating of thai cafe
restaurants with 3 to 5 star ratings	restaurant whose star rating is at least 3 stars or 5 stars
what neighborhood has the least amount of restaurants	neighborhood that is neighborhood of the least number of restaurant
which restaurants have waiters and a price rating of two dollar signs	restaurant that has waiter service and whose price rating is 2 dollar signs
thai restaurants that are inexpensive	restaurant whose price rating is 2 dollar signs and whose cuisine is thai
restaurants found in less than two neighborhoods	restaurant that has less than two neighborhood
neighborhood that is neighborhood of restaurant whose cuisine is thai	neighborhood that is neighborhood of restaurant whose cuisine is thai
a thai restaurant that takes credit cards	restaurant whose cuisine is thai and that takes credit cards
what neighborhoods have restaurants that accept reservations	neighborhood that is neighborhood of restaurant that takes reservations
which restaurants take credit cards	restaurant that takes credit cards and that takes credit cards
what is the average price rating of a restaurant	average price rating of restaurant
hotel which has a price rating of more than 2dollar or 3 dollar signs	restaurant whose price rating is larger than 2 dollar signs or 3 dollar signs
which restaurant is not located in midtown west	restaurant whose neighborhood is not midtown west
which kid friendly restaurants accept credit cards	restaurant that takes credit cards and that is good for kids
what thai restaurant has a 3 star rating	restaurant whose star rating is 3 stars and whose cuisine is thai
what 3star restaurants also have waiters	restaurant whose star rating is 3 stars and that has waiter service
what restaurants offer lunch	restaurant that serves lunch and that serves lunch
hotel that does not have a	restaurant whose price rating is not 2 dollar signs
restaurants with a 2 dollar sign rating that take credit cards	restaurant that takes credit cards and whose price rating is 2 dollar signs
what restaurant offers delivery and takes credit card	restaurant that takes credit cards and that has delivery
what neighborhood with the most restaurants	neighborhood that is neighborhood of the most number of restaurant
restaurants rated 3 stars or higher	restaurant whose star rating is at least 3 stars
which restaurants have the same star rating as thai cafe	restaurant whose star rating is star rating of thai cafe
what neighborhood has no more than two restaurants	neighborhood that is neighborhood of at most two restaurant
restaurant that has takeout and that has outdoor seating	restaurant that has take
list restaurants that are at or less than 2 or 3 dollar signs	restaurant whose price rating is at most 2 dollar signs or 3 dollar signs
restaurant that serves lunch and whose price rating is 2 dollar signs	restaurant that serves lunch and whose price rating is 2 dollar signs
restaurant with waiter service and reservations	restaurant that takes reservations and that has waiter service
restaurants that take reservations and have waiters	restaurant that takes reservations and that has waiter service
list all restaurants that have at least 3 star or 5 star ratings	restaurant whose star rating is 3 stars or 5 stars
restaurants that take credit and deliver	restaurant that has delivery and that takes credit cards
restaurants in the midtown west neighborhood that have a 2 dollar sign price rating	restaurant whose neighborhood is midtown west and whose price rating is 2 dollar signs
which neighborhood restaurant is good for a group of people	neighborhood that is neighborhood of restaurant that is good for groups
what restaurant has more than two cuisines	restaurant that has at least two cuisine
what cuisines are offered by restaurants that have outdoor seating	cuisine that is cuisine of restaurant that has outdoor seating
what restaurants have takeout and are kidfriendly	restaurant that has take
what meal is good for groups	meal that restaurant that is good for groups serves
what is the eighborhood  of the takeout restaurant	neighborhood that is neighborhood of restaurant that has take
what is the average star rating of all restaurants	average star rating of restaurant
restaurants in midtown west that have takeout	restaurant whose neighborhood is midtown west and that has take
cuisine like that of thai cafe	cuisine that is cuisine of thai cafe
what neighborhoods have restaurants that deliver	neighborhood that is neighborhood of restaurant that has delivery
meal that the least number of restaurant serves	meal that the least number of restaurant serves
a restaurant rated at least 3 stars that delivers	restaurant whose star rating is 3 stars and that has delivery
which restaurant takes reservations and is suitable for groups	restaurant that takes reservations and that is good for groups
restaurant that has takeout and whose cuisine is thai	restaurant that has take
which restaurant is located in midtown west	restaurant whose neighborhood is midtown west
what restaurants offer lunch and is good for groups	restaurant that serves lunch and that is good for groups
what restaurant offers lunch and takes reservations	restaurant that takes reservations and that serves lunch
restaurants with more than two meals	restaurant that serves more than two meal
restaurant whose cuisine is thai and that has takeout	restaurant whose cuisine is thai and that has take
what kind of meals do restaurants with waiter service serve	meal that restaurant that has waiter service serves
restaurants with multiple cuisines	restaurant that has the most number of cuisine
what 2 dollar signs restaurant has outdoor seating	restaurant whose price rating is 2 dollar signs and that has outdoor seating
restaurant that takes reservations and that has outdoor seating	restaurant that takes reservations and that has outdoor seating
neighborhood that is neighborhood of restaurant whose price rating is 2 dollar signs	neighborhood that is neighborhood of restaurant whose price rating is 2 dollar signs
restaurants with dollar ratings less than 2	restaurant whose price rating is smaller than 2 dollar signs
thai restaurants that deliver	restaurant whose cuisine is thai and that has delivery
what restaurant is kid friendly and takes credit cards	restaurant that is good for kids and that takes credit cards
highest star rated restaurants	restaurant that has the largest star rating
what thai restaurant takes reservations	restaurant that takes reservations and whose cuisine is thai
restaurants rated with 3 to 5 stars	3 stars or 5 stars
what is the cuisine of most restaurants	cuisine that is cuisine of the most number of restaurant
what restaurant offers an outdoot and takeout	restaurant that has outdoor seating and that has take
restaurants that take reservations and are good for children	restaurant that takes reservations and that is good for kids
restaurants with outdoor dining area	restaurant that has outdoor seating
thai cuisine restaurant with 3 star rating	restaurant whose cuisine is thai and whose star rating is 3 stars
what restaurants serve at least two meals	restaurant that serves at least two meal
restaurant whose price rating is 2 dollar signs and whose star rating is 3 stars	restaurant whose price rating is 2 dollar signs and whose star rating is 3 stars
restaurants with similar food to thai cafe or pizzeria juno	cuisine that is cuisine of thai cafe or pizzeria juno
which restaurants have star ratings lower than the thai cafe	restaurant whose star rating is smaller than star rating of thai cafe
what restaurant is good for groups and takes credit card	restaurant that is good for groups and that takes credit cards
what cuisine has the least amount of restaurants	cuisine that is cuisine of the least number of restaurant
what meal does the 3 star restaurant serve	meal that restaurant whose star rating is 3 stars serves
midtown west neighborhood that also deliveries	restaurant whose neighborhood is midtown west and that has delivery
restaurants in the midtown west neighborhood with outdoor seating	restaurant whose neighborhood is midtown west and that has outdoor seating
restaurant that has outdoor seating and whose price rating is 2 dollar signs	restaurant that has outdoor seating and whose price rating is 2 dollar signs
restaurant that has delivery and that is good for groups	restaurant that has delivery and that is good for groups
restaurant that has delivery and that serves lunch	restaurant that has delivery and that serves lunch
list all restaurants with 3 or 5 star ratings	restaurant whose star rating is at least 3 stars or 5 stars
what restaurant in midtown west has a rating of two dollar signs	restaurant whose neighborhood is midtown west and whose price rating is 2 dollar signs
what restaurants offer outdoor seating and takes reservations	restaurant that takes reservations and that has outdoor seating
what midtown west restaurant takes credit cards	restaurant whose neighborhood is midtown west and that takes credit cards
restaurants for groups with delivery	restaurant that is good for groups and that has delivery
what kind of restaurant serves the same food as thai cafe	restaurant that serves meal that thai cafe serves
thai restaurants that kids enjoy	restaurant that is good for kids and whose cuisine is thai
restaurant which offer lunch and has a three star rating	restaurant whose star rating is 3 stars and that serves lunch
restaurants that have waiters and take credit cards	restaurant that has waiter service and that takes credit cards
meal that the most number of restaurant serves	meal that the most number of restaurant serves
list all restaurants in midtown west	restaurant whose neighborhood is midtown west and whose neighborhood is midtown west
find the type of food of all restaurants that take reservations	cuisine that is cuisine of restaurant that takes reservations
a kid friendly restaurant with outdoor seating	restaurant that is good for kids and that has outdoor seating
restaurants that take credit cards	restaurant that takes credit cards
what is a meal from a restaurant that is good for kids	meal that restaurant that is good for kids serves
restaurants rated more highly than thai cafe	restaurant whose star rating is larger than star rating of thai cafe
restaurants with 3stars that take reservations	restaurant that takes reservations and whose star rating is 3 stars
which restaurants have a price rating of 2 to3 dollar signs	restaurant whose price rating is at least 2 dollar signs or 3 dollar signs
neighborhood that is neighborhood of at least two restaurant	neighborhood that is neighborhood of at least two restaurant
hotel that can be booked in advance and which has a price rating of 2 dollar signs	restaurant whose price rating is 2 dollar signs and that takes reservations
find a good group restaurant with takeout	restaurant that is good for groups and that has take
what is the cuisine of restaurants that have waiters	cuisine that is cuisine of restaurant that has waiter service
group friendly restaurants rated 3 stars	restaurant that is good for groups and whose star rating is 3 stars
what restaurant offers takeout and has reservations	restaurant that takes reservations and that has take
neighborhood that is neighborhood of restaurant that serves lunch	neighborhood that is neighborhood of restaurant that serves lunch
restaurants that serve lunch and takeout	restaurant that serves lunch and that has take
what restaurant can be found in only two neighborhoods	restaurant that has at most two neighborhood
how many neighborhoods are there	number of neighborhood
which restaurants are group friendly and have waiters	restaurant that has waiter service and that is good for groups
which resturants serve lunch and have delivery	restaurant that has delivery and that serves lunch
what kind of meals are served by restaurants that take reservations	meal that restaurant that takes reservations serves
what resturant has a price rating smaller than two dollar signs	restaurant whose price rating is smaller than 2 dollar signs
what is a meal served by a restaurant that accepts reservations	meal that restaurant that takes reservations serves
what restaurants offer waiter service	restaurant that has waiter service
restaurant that has waiter service and whose price rating is 2 dollar signs	restaurant that has waiter service and whose price rating is 2 dollar signs
what restaurant has waiter service and a 2 dollar sign rating	restaurant that has waiter service and whose price rating is 2 dollar signs
restaurant that serves lunch and takes reservations	restaurant that serves lunch and that takes reservations
3 star rated restaurant that accepts reservations	restaurant whose star rating is 3 stars and that takes reservations
restaurants at least with a 2 dollar price rating	restaurant whose price rating is at least 2 dollar signs
restaurants serving fewer than two meals	restaurant that serves less than two meal
what meal does the thai restaurant serve	meal that restaurant whose cuisine is thai serves
restaurant whose price rating is 2 dollar signs and also accept credit cards	restaurant that takes credit cards and whose price rating is 2 dollar signs
3 star rated restaurants for kids	restaurant whose star rating is 3 stars and that is good for kids
has a 2 or 3 dollar sign rating	2 dollar signs or 3 dollar signs
restaurants with price ratings less than 2 dollar signs	restaurant whose price rating is smaller than 2 dollar signs or 3 dollar signs
what neighborhoods have restaurants that are good for large parties	neighborhood that is neighborhood of restaurant that is good for groups
the restaurant that is midtown serves thai food	restaurant whose cuisine is thai and whose neighborhood is midtown west
which restaurants are kid friendly	restaurant that is good for kids and that is good for kids
restaurant whose neighborhood is midtown west and that has takeout	restaurant whose neighborhood is midtown west and that has take
what kind of meals do 2 dollar signs rated restaurants serve	meal that restaurant whose price rating is 2 dollar signs serves
restaurant whose price rating is larger than 2 dollar signs or 3 dollar signs	restaurant whose price rating is larger than 2 dollar signs or 3 dollar signs
what restaurant serves the most meals	restaurant that serves the most number of meal
restaurant that serves lunch or dinner	restaurant that serves lunch or dinner
what is the star rating of thai cafe	star rating of thai cafe
restaurants with price rating above 3 dollar signs	restaurant whose price rating is larger than 2 dollar signs or 3 dollar signs
what restaurant a price rating greater than or equal to the thai cafe	restaurant whose price rating is at least price rating of thai cafe
what neighborhood has restaurants that serve lunch	neighborhood that is neighborhood of restaurant that serves lunch
what restaurants take credit cards and offers waiter service	restaurant that has waiter service and that takes credit cards
what are some 3 star rated restaurants in midtown west	restaurant whose neighborhood is midtown west and whose star rating is 3 stars
restaurant that has takeout with credit cards	restaurant that has take
restaurant whose price rating is at least 2 dollar signs or 3 dollar signs	restaurant whose price rating is at least 2 dollar signs or 3 dollar signs
restaurants with delivery for lunch	restaurant that has delivery and that serves lunch
what meal is good to be served for groups	meal that restaurant that is good for groups serves
kidfriendly restaurants that accept reservations	restaurant that takes reservations and that is good for kids
a kid friendly restaurant for lunch	restaurant that is good for kids and that serves lunch
what restaurants have a rating better than 3 or 5 stars	restaurant whose star rating is larger than 3 stars or 5 stars
restaurant that is around mid town west that offers lunch	restaurant whose neighborhood is midtown west and that serves lunch
which resturants serve lunch	restaurant that serves lunch and that serves lunch
restaurants for lunch for kids	restaurant that is good for kids and that serves lunch
what is the average restaurant star rating	average star rating of restaurant
what neighborhood contains restaurants that accept credit cards	neighborhood that is neighborhood of restaurant that takes credit cards
cuisine that is like thai cafe or pizzeria juno	cuisine that is cuisine of thai cafe or pizzeria juno
restaurants that have takeout and take reservations	restaurant that has take
a restaurant as good as thai cafe	restaurant whose star rating is star rating of thai cafe
hotel that has more than a three star rating	restaurant whose star rating is larger than 3 stars
what restaurant is good for groups and has waiter service	restaurant that has waiter service and that is good for groups
restaurants with 2 or 3 price rating	restaurant whose price rating is 2 dollar signs or 3 dollar signs
which restaurants accept reservations	restaurant that takes reservations and that takes reservations
restaurants with 2 and lower price rating	restaurant whose price rating is at most 2 dollar signs
restaurant that is good for groups and whose star rating is 3 stars	restaurant that is good for groups and whose star rating is 3 stars
thai restaurant which has a 3 star rating	restaurant whose star rating is 3 stars and whose cuisine is thai
restaurants with the most locations in the area	restaurant that has the most number of neighborhood
restaurants with a price rating higher than 3 dollar signs	restaurant whose price rating is larger than 2 dollar signs or 3 dollar signs
what is the cuisine of the restaurant with waiter service	cuisine that is cuisine of restaurant that has waiter service
what 3 star restaurant has waiter service	restaurant that has waiter service and whose star rating is 3 stars
thai restaurants with takeout	restaurant whose cuisine is thai and that has take
name some thai restaurants meant for group dining	restaurant that is good for groups and whose cuisine is thai
restaurant that has takeout and that takes reservations	restaurant that has take
restaurants with takeout and waiter service	restaurant that has take
find a thai restaurant with outdoor seating	restaurant that has outdoor seating and whose cuisine is thai
what restaurant has a price rating of 2 dollar signs	restaurant whose price rating is 2 dollar signs and whose price rating is 2 dollar signs
restaurants that are good for groups and offer takeout	restaurant that has take
restaurants with waiter service and outdoor seating	restaurant that has waiter service and that has outdoor seating
what restaurant offers reservations and is good for kids	restaurant that is good for kids and that takes reservations
restaurants with outdoor seating that takes reservations	restaurant that takes reservations and that has outdoor seating
restaurants that are good for group dining and that can be booked in advance	restaurant that is good for groups and that takes reservations
what 3 star restaurant is good for kids	restaurant whose star rating is 3 stars and that is good for kids
what thai restaurant has a star rating of 3 star	restaurant whose cuisine is thai and whose star rating is 3 stars
what thai restaurant offers takeout	restaurant whose cuisine is thai and that has take
restaurant with a price rating equal to thai cafe	restaurant whose price rating is price rating of thai cafe
restaurant that has delivery and whose cuisine is thai	restaurant that has delivery and whose cuisine is thai
what restaurant does not offer lunch	restaurant that not serves lunch
restaurant which serves lunch and accepts credit cards	restaurant that serves lunch and that takes credit cards
what restaurants have at least 2 meals on the menu	restaurant that serves two meal
which neighborhood is not where that cafe is located	neighborhood that is not neighborhood of thai cafe
thai restaurants that are kid friendly	restaurant that is good for kids and whose cuisine is thai
which restaurant not only serves lunch but has delivery	restaurant that serves lunch and that has delivery
which thai restaurants take reservations	restaurant that takes reservations and whose cuisine is thai
which neighborhoods have the fewest restaurants	restaurant that has the least number of neighborhood
restaurants that serve lunch and accept credit cards	restaurant that serves lunch and that takes credit cards
restaurants in midtown west that deliver	restaurant that has delivery and whose neighborhood is midtown west
what types of cuisine are there at resturants with outdoor seating	cuisine that is cuisine of restaurant that has outdoor seating
restaurants with a 2 dollar sign price rating	restaurant whose price rating is 2 dollar signs
what is a meal served by a restaurant that has takeout service	meal that restaurant that has take
restaurant whose star rating is larger than 3 stars or 5 stars	restaurant whose star rating is larger than 3 stars or 5 stars
which restaurant accepts kids and offers takeout	restaurant that is good for kids and that has take
restaurant in the midtown west area	restaurant whose neighborhood is midtown west
restaurant that delivers and offers outside seating	restaurant that has delivery and that has outdoor seating
what cuisine does a 2 dollar sign price rating restaurant have	cuisine that is cuisine of restaurant whose price rating is 2 dollar signs
what restaurant offers lunch and takes credit cards	restaurant that takes credit cards and that serves lunch
what is the cuisine of the most restaurants	cuisine that is cuisine of the most number of restaurant
a delivery restaurant with medium pricing	restaurant whose price rating is 2 dollar signs and that has delivery
meals at restaurants that have waiters	meal that restaurant that has waiter service serves
what thai restaurants are kid friendly	restaurant whose cuisine is thai and that is good for kids
what good group restaurant takes reservations	restaurant that is good for groups and that takes reservations
midtown west neighborhood restaurant with 3 star ratings	restaurant whose neighborhood is midtown west and whose star rating is 3 stars
restaurant that has the least number of neighborhood	restaurant that has the least number of neighborhood
what meal is served in the most restaurants	meal that the most number of restaurant serves
what restaurants serve the same cuisine as thai cafe	restaurant whose cuisine is cuisine that is cuisine of thai cafe
restaurants that can be booked in advance and that offers delivery services	restaurant that has delivery and that takes reservations
a restaurant that has the highest star rating	restaurant that has the largest star rating
restaurant that takes reservations	restaurant that takes reservations and that takes reservations
which restaurant chain is found in the most neighborhoods	restaurant that has the most number of neighborhood
list all restaurants that have lower stars than 3 star or 5 star	restaurant whose star rating is at most 3 stars or 5 stars
a thai restaurant	restaurant whose cuisine is thai
restaurants price rated 2 dollar signs or less	restaurant whose price rating is at most 2 dollar signs
restaurant that is near to thai cafe	restaurant whose neighborhood is neighborhood of thai cafe
which restaurant chain is found in the fewest neighborhoods	restaurant that has the least number of neighborhood
thai cafe in the neighborhood	neighborhood of thai cafe
what are some kidfriendly restaurants that accept credit cards	restaurant that is good for kids and that takes credit cards
restaurants with delivery in midtown west	restaurant whose neighborhood is midtown west and that has delivery
thai restaurant that is good for group dining	restaurant whose cuisine is thai and that is good for groups
which hotel has the least price rating	restaurant that has the smallest price rating
restaurants that have waiters and are good for kids	restaurant that has waiter service and that is good for kids
restaurant that not serves lunch	restaurant that not serves lunch
what restaurant offers lunch	restaurant that serves lunch
the three star restaurant has takeout food	restaurant that has take
find a thai restaurant in the midtown west area	restaurant whose neighborhood is midtown west and whose cuisine is thai
restaurant that serves lunch and that has takeout	restaurant that serves lunch and that has take
restaurant whose cuisine is cuisine that is cuisine of thai cafe	restaurant whose cuisine is cuisine that is cuisine of thai cafe
restaurant that serves at most two meal	restaurant that serves at most two meal
restaurants that are in the neighborhood of midtown west	neighborhood that is neighborhood of restaurant whose neighborhood is midtown west
what good kids restaurant has outdoor seating	restaurant that has outdoor seating and that is good for kids
restaurants with takeout and delivery	restaurant that has take
restaurant that has waiter service and that is good for kids	restaurant that has waiter service and that is good for kids
which resturants serve the least number of meals	restaurant that serves the least number of meal
restaurants that offer credit cards and takeout	restaurant that takes credit cards and that has take
restaurant whose cuisine is thai and that is good for groups	restaurant whose cuisine is thai and that is good for groups
what restaurant has takeout and a lunch menu	restaurant that serves lunch and that has take
restaurants rated higher than thai cafe	restaurant whose star rating is larger than star rating of thai cafe
what restaurant has the lowest star rating	restaurant that has the smallest star rating
restaurants in midtown west with an outdoor dining area	restaurant whose neighborhood is midtown west and that has outdoor seating
what restaurants take credit cards and have outdoor settings	restaurant that has outdoor seating and that takes credit cards
restaurant whose neighborhood is midtown west and that has delivery	restaurant whose neighborhood is midtown west and that has delivery
hotel that offers lunch and has outdoor seating facilities	restaurant that has outdoor seating and that serves lunch
family friendly thai restaurants	restaurant whose cuisine is thai and that is good for kids
restaurant with at least a 2 dollar price rating	restaurant whose price rating is at least 2 dollar signs
what neighborhood only has one or two restaurants	neighborhood that is neighborhood of at most two restaurant
restaurants with 2 dollar sign rating in midtown west	restaurant whose price rating is 2 dollar signs and whose neighborhood is midtown west
restaurant for lunch rated 2 dollar signs	restaurant that serves lunch and whose price rating is 2 dollar signs
list all restaurants that have ratings above 2	restaurant whose price rating is not 2 dollar signs
what good group restaurant has delivery	restaurant that is good for groups and that has delivery
which restaurants have a 2 dollar sign price rating and outdoor seating	restaurant that has outdoor seating and whose price rating is 2 dollar signs
what is a meal that a restaurant with delivery service has	meal that restaurant that has delivery serves
the thai restaurant has delivery	restaurant whose cuisine is thai and that has delivery
what is the neighborhood with the most restaurants that are good for kids	neighborhood that is neighborhood of restaurant that is good for kids
which is the thai restaurant in this neighbourhood	neighborhood that is neighborhood of restaurant whose cuisine is thai
restaurants that are good for children	restaurant that is good for kids and that is good for kids
thai restaurant that offers waiter services	restaurant that has waiter service and whose cuisine is thai
what 3 star restaurants have a price rating of 2 dollar signs	restaurant whose price rating is 2 dollar signs and whose star rating is 3 stars
what are some restaurants rated at most 3 dollar signs	restaurant whose price rating is smaller than 2 dollar signs or 3 dollar signs
restaurants with a smaller star rating than thai cafe	restaurant whose star rating is smaller than star rating of thai cafe
a thai restaurant for kids	restaurant whose cuisine is thai and that is good for kids
what kind of restaurant offers outdoor seating	cuisine that is cuisine of restaurant that has outdoor seating
the restaurant takes credit cards and serves lunch	restaurant that serves lunch and that takes credit cards
what is a meal served in a thai restaurant	meal that restaurant whose cuisine is thai serves
a reservation thai restaurant	restaurant whose cuisine is thai and that takes reservations
which resturants have at most two cuisines	restaurant that has at most two cuisine
what cuisine options are there among the kidfriendly restaurants	cuisine that is cuisine of restaurant that is good for kids
what restaurants serves more than just one meal	restaurant that serves more than two meal
thai restaurants rated 3 stars	restaurant whose star rating is 3 stars and whose cuisine is thai
restaurants that deliver and accept credit cards	restaurant that takes credit cards and that has delivery
what restaurant in midtown west is good for groups	restaurant whose neighborhood is midtown west and that is good for groups
thai cuisine restaurant which serves lunch	restaurant whose cuisine is thai and that serves lunch
cuisine that is cuisine of restaurant whose star rating is 3 stars	cuisine that is cuisine of restaurant whose star rating is 3 stars
what restaurant takes resverations	restaurant that takes reservations and that takes reservations
list all thai restaurants in midtown west	restaurant whose cuisine is thai and whose neighborhood is midtown west
restaurant that has outdoor seating and that has waiter service	restaurant that has outdoor seating and that has waiter service
what kind of meals does thai cafe serve	meal that thai cafe serves
what meal does the restaurant with a 2 dollar price rating serve	meal that restaurant whose price rating is 2 dollar signs serves
restaurants in midtown west with waiter service	restaurant whose neighborhood is midtown west and that has waiter service
which restaurants have takeout and accept credit cards	restaurant that has take
neighborhood that is neighborhood of restaurant that has waiter service	neighborhood that is neighborhood of restaurant that has waiter service
hotels that can be booked in advance and offers lunch	restaurant that takes reservations and that serves lunch
restaurant that is good for groups and whose price rating is 2 dollar signs	restaurant that is good for groups and whose price rating is 2 dollar signs
which restaurant offers the fewest types of cuisine	restaurant that has the least number of cuisine
what retaurant in midtown west have waiter services	restaurant that has waiter service and whose neighborhood is midtown west
what restaurant offers takeout and is good for kids	restaurant that is good for kids and that has take
restaurant with outdoor dining area that serves lunch	restaurant that serves lunch and that has outdoor seating
what 3 star restaurant offers lunch	restaurant whose star rating is 3 stars and that serves lunch
what restaurant can i make reservations at that takes credit cards	restaurant that takes credit cards and that takes reservations
restaurant that takes credit cards and that takes reservations	restaurant that takes credit cards and that takes reservations
which restaurants have waiters and accept reservations	restaurant that has waiter service and that takes reservations
restaurants serving lunch that accept reservations	restaurant that takes reservations and that serves lunch
what is the restaurants number	number of restaurant
restaurant that has the most number of neighborhood	restaurant that has the most number of neighborhood
what neighborhood contains restaurants that offer delivery	neighborhood that is neighborhood of restaurant that has delivery
restaurants that serve less than one meal	meal that less than two restaurant serves
restaurants that accept credit cards and serve outdoors	restaurant that takes credit cards and that has outdoor seating
restaurants that take credit cards and serve lunch	restaurant that takes credit cards and that serves lunch
thai restaurants in the midtown west neighborhood	restaurant whose cuisine is thai and whose neighborhood is midtown west
restaurant whose neighborhood is neighborhood that is neighborhood of thai cafe	restaurant whose neighborhood is neighborhood that is neighborhood of thai cafe
what is a 3 star restaurant that is kid friendly	restaurant that has waiter service and whose star rating is 3 stars
find a thai restaurant with a 2 dollar price rating	restaurant whose cuisine is thai and whose price rating is 2 dollar signs
what kind fo meals do thai cafe and pizzeria juno serve	meal that thai cafe or pizzeria juno serves
what are some restaurants rated 3 dollar signs or less	restaurant whose star rating is at most 3 stars
restaurant that takes reservations and that has waiter service	restaurant that takes reservations and that has waiter service
restaurant that serves thai meal	meal that restaurant whose cuisine is thai serves
hotel that suits the taste of kids and offers delivery services	restaurant that is good for kids and that has delivery
restaurant whose star rating is at least 3 stars or 5 stars	restaurant whose star rating is at least 3 stars or 5 stars
a restaurant in west midtown or chelsea	restaurant whose neighborhood is midtown west or chelsea
neighborhood that is neighborhood of thai cafe and that is neighborhood of thai cafe	neighborhood that is neighborhood of thai cafe and that is neighborhood of thai cafe
which neighborhoods have restaurants that serve lunch	neighborhood that is neighborhood of restaurant that serves lunch
what is the nature of the cuisine of thai cafe	cuisine of thai cafe
what restaurants received 3 stars and serve lunch	restaurant that serves lunch and whose star rating is 3 stars
restaurants with outdoor seating	restaurant that has outdoor seating and that has outdoor seating
restaurant whose star rating is 3 stars and whose star rating is 3 stars	restaurant whose star rating is 3 stars and whose star rating is 3 stars
thai restaurants with 3star ratings	restaurant whose cuisine is thai and whose star rating is 3 stars
restaurants with two neighborhood locations	restaurant that has two neighborhood
restaurant with outdoor seating that accepts credit cards	restaurant that has outdoor seating and that takes credit cards
restaurant with takeout in midtown west	restaurant that has take
what is meal served in at least two restaurants	meal that at least two restaurant serves
a group friendly thai restaurant	restaurant that is good for groups and whose cuisine is thai
what cuisine does the thai cafe not have	cuisine that is not cuisine of thai cafe
which restaurants serve less than two meals	restaurant that serves less than two meal
restaurant that is good for groups and that serves lunch	restaurant that is good for groups and that serves lunch
hotel that has the minimum star rating	restaurant that has the smallest star rating
what is a meal served at a threestar rated restaurant	meal that restaurant whose star rating is 3 stars serves
the thai cafe is in which neighborhood	neighborhood of thai cafe
what are the cuisines of all the midtown west restaurants	cuisine that is cuisine of restaurant whose neighborhood is midtown west
an outdoor setting restaurant that takes credit cards	restaurant that has outdoor seating and that takes credit cards
restaurant with takeout service that accepts credit cards	restaurant that takes credit cards and that has take
neighborhood of thai cafe	neighborhood of thai cafe
restaurants that take credit cards and reservations	restaurant that takes credit cards and that takes reservations
three star restaurants that serve lunch	restaurant that serves lunch and whose star rating is 3 stars
what restaurant can you eat lunch outside at	restaurant that has outdoor seating and that serves lunch
restaurants that have waiters and outdoor dining areas	restaurant that has outdoor seating and that has waiter service
what restaurant offers outdoor seating and takes reservations	restaurant that has outdoor seating and that takes reservations
what is the star rating of the thai cafe	star rating of thai cafe
what meal can you get at the thai cafe	meal that thai cafe serves
hotel that has outdoor seating  facilities and accepts credit cards	restaurant that takes credit cards and that has outdoor seating
which thai restaurants have outdoor seating	restaurant that has outdoor seating and whose cuisine is thai
what restaurants accommodate groups	restaurant that is good for groups
list all 2 dollar signs restaurants	restaurant whose price rating is 2 dollar signs
what midtown west restaurant offers reservations	restaurant that takes reservations and whose neighborhood is midtown west
what restaurant offers reservations and serves lunch	restaurant that serves lunch and that takes reservations
restaurant that is good for groups and whose cuisine is thai	restaurant that is good for groups and whose cuisine is thai
which restaurants with outdoor dining areas accept reservations	restaurant that has outdoor seating and that takes reservations
what kind of meals does takeout restaurants serve	meal that restaurant that has take
what restaurant has a 2 dollar price rating and outdoor seating	restaurant whose price rating is 2 dollar signs and that has outdoor seating
which neighborhood has restaurants that offer outdoor seating	neighborhood that is neighborhood of restaurant that has outdoor seating
what thai restaurant takes credit cards	restaurant that takes credit cards and whose cuisine is thai
restaurants that accept reservations and offer takeout	restaurant that has take
which hotel has the highest star rating	restaurant that has the largest star rating
what are some thai restaurants in midtown west	restaurant whose neighborhood is midtown west and whose cuisine is thai
area that has the minimum number of restaurants	neighborhood that is neighborhood of the least number of restaurant
what 3 star restaurant has outdoor seating	restaurant whose star rating is 3 stars and that has outdoor seating
what meals do credit card taking restaurants serve	meal that restaurant that takes credit cards serves
which hotel offers delivery services	restaurant that has delivery and that has delivery
what restaurants are good for kids and serve lunch	restaurant that is good for kids and that serves lunch
what midtown west restaurants have a price rating of 2 dollar signs	restaurant whose neighborhood is midtown west and whose price rating is 2 dollar signs
restaurants location	restaurant that has more than two neighborhood
which resturants have a price less than or equal to thai cafe	restaurant whose price rating is at most price rating of thai cafe
restaurants with price ratings between 2 and 3	restaurant whose price rating is at least 2 dollar signs or 3 dollar signs
which restaurant has the lowest star rating	restaurant that has the smallest star rating
what 2 dollar signs restaurant offers delivery	restaurant that has delivery and whose price rating is 2 dollar signs
what thai restaurant has a good star rating	restaurant whose star rating is star rating of thai cafe
restaurant whose neighborhood is midtown west and whose cuisine is thai	restaurant whose neighborhood is midtown west and whose cuisine is thai
restaurant not in the midtown west area	restaurant whose neighborhood is not midtown west
restaurant whose cuisine is cuisine of thai cafe	restaurant whose cuisine is cuisine of thai cafe
what kind of restaurant is good for groups	cuisine that is cuisine of restaurant that is good for groups
restaurants rated 3 stars	restaurant whose star rating is 3 stars
what 2 dollar sign restaurant takes credit card	restaurant whose price rating is 2 dollar signs and that takes credit cards
restaurants with 2 price rating that is groupfriendly	restaurant that is good for groups and whose price rating is 2 dollar signs
restaurant that takes credit cards and that is good for kids	restaurant that takes credit cards and that is good for kids
restaurant that takes reservations and that has takeout	restaurant that takes reservations and that has take
restaurants that take credit cards and are childfriendly	restaurant that takes credit cards and that is good for kids
restaurants that deliver and serve lunch	restaurant that has delivery and that serves lunch
restaurants that serve good meals for kids	meal that restaurant that is good for kids serves
restaurants with 3 stars and 2 price rating	restaurant whose price rating is 2 dollar signs and whose star rating is 3 stars
what restaurant has at least a 2 or 3 dollar sign rating	restaurant whose price rating is larger than 2 dollar signs or 3 dollar signs
what neighborhood has fewer than two restaurants	neighborhood that is neighborhood of less than two restaurant
thai restaurants with outdoor seating	restaurant that has outdoor seating and whose cuisine is thai
restaurant that is rated 3 to 5 stars	restaurant whose star rating is at least 3 stars or 5 stars
restaurant that is kidfriendly and has an outdoor dining area	restaurant that is good for kids and that has outdoor seating
which neighborhoods have restaurants that offer takeout	neighborhood that is neighborhood of restaurant that has take
what cuisines are offered by more than one restaurant	cuisine that is cuisine of at least two restaurant
what restaurant is group friendly and takes a credit card	restaurant that is good for groups and that takes credit cards
what cuisine does the midtown west restaurant have	cuisine that is cuisine of restaurant whose neighborhood is midtown west
restaurants serving the same cuisine as thai cafe	restaurant whose cuisine is cuisine of thai cafe
restaurants that serve lunch and have waiter service	restaurant that has waiter service and that serves lunch
restaurant that has the least number of cuisine	restaurant that has the least number of cuisine
thai restaurants that have outdoor dining areas	restaurant whose cuisine is thai and that has outdoor seating
what meals does thai cafe serve	meal that thai cafe serves and that thai cafe serves
which thai restaurant has delivery	restaurant that has delivery and whose cuisine is thai
hotel that suits the tastes of kids and which is best for group dining	restaurant that is good for kids and that is good for groups
restaurant that has delivery and that has outdoor seating	restaurant that has delivery and that has outdoor seating
find a good group restaurant with waiter service	restaurant that is good for groups and that has waiter service
find a restaurant that takes credit cards	restaurant that takes credit cards
restaurant serving lunch that can deliver	restaurant that has delivery and that serves lunch
a restaurant rated 2 dollar signs for lunch	restaurant whose price rating is 2 dollar signs and that serves lunch
restaurants that have takeout and deliver	restaurant that has delivery and that has take
thai restaurant with waiters	restaurant whose cuisine is thai and that has waiter service
restaurants in the midtown west neighborhood that have waiters	restaurant that has waiter service and whose neighborhood is midtown west
restaurant that serves lunch and that takes reservations	restaurant that serves lunch and that takes reservations
restaurant that has at most two cuisine	restaurant that has at most two cuisine
what restaurants has more than two meals on the menu	restaurant that serves at least two meal
which restaurants are rated under 3 stars	restaurant whose star rating is at most 3 stars or 5 stars
restaurant whose star rating is at least star rating of thai cafe	restaurant whose star rating is at least star rating of thai cafe
what is the total star rating of all restaurants	total star rating of restaurant
thai restaurants with optional outdoor seating	restaurant whose cuisine is thai and that has outdoor seating
restaurants that take reservations and are good for groups	restaurant that is good for groups and that takes reservations
restaurants that are group friendly	restaurant that is good for groups
hotel in midtown west that can be booked in advance	restaurant that takes reservations and whose neighborhood is midtown west
what restaurant takes reservations and has takeout	restaurant that takes reservations and that has take
restaurant that delivers and is good for groups	restaurant that is good for groups and that has delivery
a restaurant with a 2 dollar sign rating for kids	restaurant whose price rating is 2 dollar signs and that is good for kids
which restaurant offers fewer than two types of cuisine	restaurant that has less than two cuisine
what neighborhood has the least restaurants	neighborhood that is neighborhood of the least number of restaurant
neighborhood that is neighborhood of restaurant that is good for groups	neighborhood that is neighborhood of restaurant that is good for groups
what restaurants accept credit cards	restaurant that takes credit cards
what 2 dollar signs restaurants are in the neighbor of midtown west	restaurant whose price rating is 2 dollar signs and whose neighborhood is midtown west
restaurants with no more than two cuisines	restaurant that has at most two cuisine
find a restaurant with less stars than the thai cafe	restaurant whose star rating is smaller than star rating of thai cafe
a restaurant that offers lunch and delivery services	restaurant that serves lunch and that has delivery
what restaurants have less than a 3 star rating	restaurant whose star rating is not 3 stars
what is the number of this meal	number of meal
a delivering restaurant with waiters	restaurant that has delivery and that has waiter service
find a 3 or fewer star restaurant	restaurant whose star rating is at most 3 stars
what are some restaurants that doesnt serve thai	restaurant whose cuisine is not thai
what neighborhood contains at least two restaurants	neighborhood that is neighborhood of at least two restaurant
restaurants open for at least two meals per day	restaurant that serves at least two meal
what restaurants offer waiter serivce	cuisine that is cuisine of restaurant that has waiter service
restaurants that are good for children and have waiters	restaurant that has waiter service and that is good for kids
what 3 star restaurant has delivery	restaurant that has delivery and whose star rating is 3 stars
what meal is served in at least 2 restaurants	meal that at least two restaurant serves
restaurant whose star rating is 3 stars and that is good for kids	restaurant whose star rating is 3 stars and that is good for kids
what is the cuisine of the restaurant that has group dining	cuisine that is cuisine of restaurant that is good for groups
what restaurant has takeout and waiter service	restaurant that has waiter service and that has take
which restaurants with a 2 dollar price rating offer takeout	restaurant that has take
what is the neighborhood of the restaurant that has a price rating of 2 dollar signs	neighborhood that is neighborhood of restaurant whose price rating is 2 dollar signs
what are the hotels found in midtown west or chelsea	restaurant whose neighborhood is midtown west or chelsea
restaurant that has the largest price rating	restaurant that has the largest price rating
restaurant in the neighbourhood that has takeout facilities	neighborhood that is neighborhood of restaurant that has take
what neighborhood has the largest number of restaurants	neighborhood that is neighborhood of the most number of restaurant
what restaurant offers lunch and takeout	restaurant that has take
what restaurant offers a waiter service and is good for groups	restaurant that is good for groups and that has waiter service
what is a meal that a restaurant that is open for lunch serves	meal that restaurant that serves lunch serves
restaurants that take credit cards and have waiter service	restaurant that takes credit cards and that has waiter service
a restaurant that is group friendly	restaurant that is good for groups and that is good for groups
list all restaurants that are cheaper than 2 dollar signs or 3 star dollar signs	restaurant whose price rating is smaller than 2 dollar signs or 3 dollar signs
what restaurant is kid friendly and takes reservations	restaurant that is good for kids and that takes reservations
what meals do lunch serving restaurants serve	meal that restaurant that serves lunch serves
restaurants rated 3 stars in midtown west	restaurant whose neighborhood is midtown west and whose star rating is 3 stars
which neighborhood has two restaurants	neighborhood that is neighborhood of two restaurant
which threestar rated restaurants are amenable to kids	restaurant that is good for kids and whose star rating is 3 stars
what is a meal served by a restaurant that accepts credit cards	meal that restaurant that takes credit cards serves
restaurant that is good for group dining and accepts credit cards	restaurant that is good for groups and that takes credit cards
list all restaurants that are not similar to thai cafe	cuisine that is not cuisine of thai cafe
what restaurant is good for kids and offers outdoor seating	restaurant that has outdoor seating and that is good for kids
neighborhood that is neighborhood of thai cafe	neighborhood that is neighborhood of thai cafe
restaurants good for kids and has waiters	restaurant that is good for kids and that has waiter service
what cuisine is present at more than two restaurants	cuisine that is cuisine of more than two restaurant
list all restaurants that are at least 2 dollar signs	restaurant whose price rating is at least 2 dollar signs
total price rating of restaurant	total price rating of restaurant
what restaurant has delivery and is good for kids	restaurant that is good for kids and that has delivery
what kind of cuisine is found at the restaurants that serve lunch	cuisine that is cuisine of restaurant that serves lunch
list all thai or italian restaurants	restaurant whose cuisine is thai or italian
what restauarants are kid friendly and have takeout	restaurant that has take
which restaurants take credit and can accommodate a group	restaurant that takes credit cards and that is good for groups
restaurants with at least 30 or 40 reviews	30 reviews or 40 reviews
3 star restraunts and under	restaurant whose star rating is at most 3 stars
name athai restaurant or cafe	restaurant whose cuisine is cuisine of thai cafe
what restaurant offers lunch and delivery	restaurant that serves lunch and that has delivery
which threestar rated restaurant has outdoor seating	restaurant that has outdoor seating and whose star rating is 3 stars
restaurants that have waiters and have 2 dollar sign price rating	restaurant whose price rating is 2 dollar signs and that has waiter service
what is the average price rating of all restaurants	average price rating of restaurant
what restaurants offer waiter service and takeout	restaurant that has take
restaurant that has waiter service and whose neighborhood is midtown west	restaurant that has waiter service and whose neighborhood is midtown west
what restaurant is in the least number of neighborhoods	restaurant that has the least number of neighborhood
which restaurant welcomes children and has outdoor seats	restaurant that has outdoor seating and that is good for kids
kid friendly restaurant with a price equal to 2 dollar signs	restaurant that is good for kids and whose price rating is 2 dollar signs
family friendly restaurants where you can sit outside	restaurant that is good for kids and that has outdoor seating
restaurants with lunch and takes reservations	restaurant that serves lunch and that takes reservations
what restaurant is in two neighborhoods	restaurant that has two neighborhood
restaurants that are better for takeout	restaurant that serves the least number of meal
which restaurants have price ratings higher than two or three dollar signs	restaurant whose price rating is larger than 2 dollar signs or 3 dollar signs
cheapest restaurants	restaurant that has the smallest price rating
cuisine like thai cafe pizzeria juno	cuisine that is cuisine of thai cafe or pizzeria juno
neighborhood that is neighborhood of the most number of restaurant	neighborhood that is neighborhood of the most number of restaurant
what meals dont the thai cafe serve	meal that thai cafe not serves
hotel which has a price rating of 2 dollar signs and offers delivery services	restaurant whose price rating is 2 dollar signs and that has delivery
find a restaurant with waiter service	restaurant that has waiter service
what neighborhood has restaurants that accept credit cards	neighborhood that is neighborhood of restaurant that takes credit cards
what cuisine is served by the fewest restaurants	cuisine that is cuisine of the least number of restaurant
whats the star rating of thai cafe	star rating of thai cafe
what restaurant offers takeout and delivery	restaurant that has delivery and that has take
restaurants which have delivery and take credit cards	restaurant that has delivery and that takes credit cards
what restaurant is good for groups and offers outdoor seating	restaurant that has outdoor seating and that is good for groups
a restaurant with thai cuisine	restaurant whose cuisine is thai and whose cuisine is thai
thai cuisine restaurant	cuisine that is cuisine of restaurant whose cuisine is thai
what restaurant is open at lunch and is good for kids	restaurant that serves lunch and that is good for kids
what midtown west restaurant offers lunch	restaurant that serves lunch and whose neighborhood is midtown west
restaurant whose star rating is 3 stars and that is good for groups	restaurant whose star rating is 3 stars and that is good for groups
which restaurants are good for groups and accept credit cards	restaurant that is good for groups and that takes credit cards
what restaurant serves meals and accepts credit cards	meal that restaurant that takes credit cards serves
what restaurant takes reservations and offers takeout	restaurant that has take
restaurant that is good for groups and that has takeout	restaurant that is good for groups and that has take
what restaurants are both good for groups and kids	restaurant that is good for kids and that is good for groups
restaurant whose cuisine is thai and whose star rating is 3 stars	restaurant whose cuisine is thai and whose star rating is 3 stars
thai restaurants that have takeout	restaurant whose cuisine is thai and that has take
what restaurant offers delivery and has waiter service	restaurant that has waiter service and that has delivery
which restaurant is rated the most expensive	restaurant that has the largest price rating
what good kids restaurant has delivery	restaurant that has delivery and that is good for kids
restaurant whose neighborhood is midtown west and that serves lunch	restaurant whose neighborhood is midtown west and that serves lunch
30 reviews or 40 reviews	30 reviews or 40 reviews
what restaurants deliver that serve food good for kids	restaurant that is good for kids and that has delivery
list all restaurants offering takeout	restaurant that has take
what neighborhoods have the most 3 star rated restaurants	neighborhood that is neighborhood of restaurant whose star rating is 3 stars
what restaurant offers delivery and an outdoor seating	restaurant that has outdoor seating and that has delivery
neighborhood that is neighborhood of restaurant that has takeout	neighborhood that is neighborhood of restaurant that has take
what restaurant has the smallest number of cuisines	restaurant that has the least number of cuisine
a restaurant in a kid friendly neighborhood	neighborhood that is neighborhood of restaurant that is good for kids
what restaurants in midtown west serve lunch	restaurant that serves lunch and whose neighborhood is midtown west
which restaurants have a price rating of two dollar signs	restaurant whose price rating is 2 dollar signs and whose price rating is 2 dollar signs
which restaurant has waiter service and takes reservations	restaurant that has waiter service and that takes reservations
what restaurant has the largest menu	restaurant that serves the most number of meal
restaurant whose neighborhood is midtown west and that takes credit cards	restaurant whose neighborhood is midtown west and that takes credit cards
name a restaurant serving more than two types of cuisine	restaurant that has more than two cuisine
what is a meal served by two different restaurants	meal that two restaurant serves
what restaurant has outdoor seating and has a price rating of the 2 dollar sign	restaurant that has outdoor seating and whose price rating is 2 dollar signs
restaurant that serves unique meals	meal that less than two restaurant serves
take out restaurant in midtown west	restaurant that has take
which restaurants have outdoor seating	restaurant that has outdoor seating
restaurant that is good for groups and that is good for kids	restaurant that is good for groups and that is good for kids
three star restaurants in midtown west	restaurant whose star rating is 3 stars and whose neighborhood is midtown west
what restaurant is good for groups and offers takeout	restaurant that has take
average star rating of restaurant	average star rating of restaurant
restaurants that have delivery and take credit cards	restaurant that has delivery and that takes credit cards
3 star restaurants which have waiters	restaurant whose star rating is 3 stars and that has waiter service
what restaurant has the more cuisine then any other	restaurant that has the most number of cuisine
midtown west restaurant for many people	restaurant whose neighborhood is midtown west and that is good for groups
which restaurant has a price rating no higher than thai cafe	restaurant whose price rating is at most price rating of thai cafe
name a restaurant in mid town that accepts credit cards	restaurant whose neighborhood is midtown west and that takes credit cards
what neighborhoods have at least two restaurants	neighborhood that is neighborhood of at least two restaurant
restaurants with 3 and higher price rating	restaurant whose price rating is larger than 2 dollar signs
a reservation restaurant with meduim	restaurant whose price rating is 2 dollar signs and that takes reservations
restaurant that is good for kids and that takes reservations	restaurant that is good for kids and that takes reservations
find a takeout restaurant	restaurant that has take
which restaurant offers the most variety of cuisine	restaurant that has the most number of cuisine
which resturants with waiter service have delivery	restaurant that has waiter service and that has delivery
groupfriendly restaurants in midtown west	restaurant that is good for groups and whose neighborhood is midtown west
what 3 star rated restaurant offers waiter service	restaurant whose star rating is 3 stars and that has waiter service
what restaurant has takeout and serves lunch	restaurant that has take
restaurant whose price rating is smaller than 2 dollar signs	restaurant whose price rating is smaller than 2 dollar signs
what kind of meal does thai cafe not serve	meal that thai cafe not serves
restaurant whose price rating is 2 dollar signs or 3 dollar signs	restaurant whose price rating is 2 dollar signs or 3 dollar signs
which restaurants have price ratings above or below two dollar signs	restaurant whose price rating is not 2 dollar signs
what cuisine does the restaurant with reservations have	cuisine that is cuisine of restaurant that takes reservations
restaurants that serve the same type of food as thai cafe	restaurant whose cuisine is cuisine that is cuisine of thai cafe
what restaurant has a 3 star rating	cuisine that is cuisine of restaurant whose star rating is 3 stars
what thai restaurant offers lunch	restaurant that serves lunch and whose cuisine is thai
in which neighborhood is thai cafe	neighborhood that is neighborhood of thai cafe and that is neighborhood of thai cafe
restaurants that accepts reservations	meal that restaurant that takes reservations serves
which restaurant offers lunch	restaurant that serves lunch
what restaurant can i get reservations and get delivery from	restaurant that has delivery and that takes reservations
which restaurants are good for groups and also deliver	restaurant that has delivery and that is good for groups
which neighborhoods have restaurants with a 2 dollar sign price rating	neighborhood that is neighborhood of restaurant whose price rating is 2 dollar signs
3 star restaurants that take groups	restaurant that is good for groups and whose star rating is 3 stars
restaurants with reservations and serves lunch	restaurant that takes reservations and that serves lunch
restaurants whose ratings are 3 stars and that take reservations	restaurant whose star rating is 3 stars and that takes reservations
restaurants situated between neighborhoods	restaurant that has two neighborhood
cuisine that is cuisine of restaurant whose price rating is 2 dollar signs	cuisine that is cuisine of restaurant whose price rating is 2 dollar signs
restaurant that serves lunch and that has delivery	restaurant that serves lunch and that has delivery
restaurants that accept credit cards and have waiters	restaurant that has waiter service and that takes credit cards
which neighboorhodd has the least number of resturants	neighborhood that is neighborhood of the least number of restaurant
restaurant in the area of midtown west that is good for group dining	restaurant whose neighborhood is midtown west and that is good for groups
what are some 3 star thai restaurants	restaurant whose cuisine is thai and whose star rating is 3 stars
restaurant that serves lunch and whose star rating is 3 stars	restaurant that serves lunch and whose star rating is 3 stars
what resturant has outdoor seating and is good for kids	restaurant that has outdoor seating and that is good for kids
restaurant that has takeout and that has delivery	restaurant that has take
which restaurant is good for group dining	cuisine that is cuisine of restaurant that is good for groups
what is the price range for the thai restaurant	restaurant whose price rating is price rating of thai cafe
how many restaurants are there total	number of restaurant
whats a resturant thats good for groups and has waiter service	restaurant that is good for groups and that has waiter service
what cuisine does the thai cafe have	cuisine that is cuisine of thai cafe
cuisine that is cuisine of restaurant that takes reservations	cuisine that is cuisine of restaurant that takes reservations
restaurant that has waiter service and that takes reservations	restaurant that has waiter service and that takes reservations
what neighborhood is the thai cafe in	neighborhood that is neighborhood of thai cafe
what neighborhoods have restaurants that serve outdoors	neighborhood that is neighborhood of restaurant that has outdoor seating
which resturants serve lunch and have waiter service	restaurant that serves lunch and that has waiter service
what meals do 2 restaurants serve	meal that at least two restaurant serves
restaurant whose cuisine is thai and whose cuisine is thai	restaurant whose cuisine is thai and whose cuisine is thai
what midtown west restaurant takes reservations	restaurant whose neighborhood is midtown west and that takes reservations
restaurant that has takeout and that has waiter service	restaurant that has take
what restaurant has 3 stars and has a 2 menu	restaurant whose star rating is 3 stars and whose price rating is 2 dollar signs
what thai restaurant has lunch	restaurant that serves lunch and whose cuisine is thai
restaurants that are in the neighborhood of midtown west and have outdoor seating	restaurant whose neighborhood is midtown west and that has outdoor seating
what thai restaurant has delivery	restaurant whose cuisine is thai and that has delivery
restaurants with 3 or lower price rating	restaurant whose price rating is at most 2 dollar signs or 3 dollar signs
which restaurant has a three star rating and also takes reservations	restaurant that takes reservations and whose star rating is 3 stars
list all restaurants that is cheaper than 2 dollar signs	restaurant whose price rating is at most 2 dollar signs
which restaurant has outdoor seats as well as delivery	restaurant that has outdoor seating and that has delivery
which restaurants accept credit cards and are good places to go with kids	restaurant that is good for kids and that takes credit cards
restaurant whose star rating is 3 stars and that has delivery	restaurant whose star rating is 3 stars and that has delivery
what is the price rating of the thai cafe	price rating of thai cafe
what restaurants serve at least two cuisines	restaurant that has at least two cuisine
restaurants that serves lunch and is large	restaurant that serves lunch and that is good for groups
restaurants open for lunch that take credit cards	restaurant that takes credit cards and that serves lunch
find a thai or italian restaurant	restaurant whose cuisine is thai or italian
restaurants that offer takeout and are price rated 2 dollar signs	restaurant whose price rating is 2 dollar signs and that has take
what is a good meal served by a restaurant that accommodates children	meal that restaurant that is good for kids serves
a midtown west resturant that takes reservations	restaurant that takes reservations and whose neighborhood is midtown west
which restaurants are rated the same or better than thai cafe	restaurant whose star rating is at least star rating of thai cafe
restaurant that has less than two cuisine	restaurant that has less than two cuisine
which restaurants serve lunch or dinner	restaurant that serves lunch or dinner
what good kids restaurant has a 2 dollar price rating	restaurant that is good for kids and whose price rating is 2 dollar signs
2 dollar signed rated restaurants for kids	restaurant that is good for kids and whose price rating is 2 dollar signs
what 2 dollar signs restaurant offers lunch	restaurant that serves lunch and whose price rating is 2 dollar signs
what is a type of cuisine of two restaurants	cuisine that is cuisine of two restaurant
which resturants are good for groups	restaurant that is good for groups
what neighborhood has a thai cafe or pizzeria juno	neighborhood that is neighborhood of thai cafe or pizzeria juno
3 star restaurants that accept credit cards	restaurant whose star rating is 3 stars and that takes credit cards
restaurants with 2 price rating that serve lunch	restaurant whose price rating is 2 dollar signs and that serves lunch
the 3 star restaurant is good for groups	restaurant that is good for groups and whose star rating is 3 stars
restaurant whose star rating is larger than star rating of thai cafe	restaurant whose star rating is larger than star rating of thai cafe
list all restaurants that have the same or better price rating than thai cafe	restaurant whose price rating is at least price rating of thai cafe
what restaurant serves two different types of cuisines	restaurant that has two cuisine
thai restaurant that delievers	restaurant that has delivery and whose cuisine is thai
restaurant in the  area around midtown west that offers delivery services	restaurant that has delivery and whose neighborhood is midtown west
neighborhood that is neighborhood of thai cafe or pizzeria juno	neighborhood that is neighborhood of thai cafe or pizzeria juno
restaurant that serves group meals	meal that restaurant that is good for groups serves
restaurant that has the  take out facility and has outdoor seating	restaurant that has outdoor seating and that has take
find a 2 dollar price rating restaurant with delivery	restaurant that has delivery and whose price rating is 2 dollar signs
restaurants rated 3 stars with a 2 dollar sign price rating	restaurant whose star rating is 3 stars and whose price rating is 2 dollar signs
what restaurants are good for groups and kids	restaurant that is good for kids and that is good for groups
which resturant has a smaller star rating than thia cafe	restaurant whose star rating is smaller than star rating of thai cafe
list all restaurants in midtown west or chelsea	restaurant whose neighborhood is midtown west or chelsea
neighborhood with the least number of restaurants	neighborhood that is neighborhood of the least number of restaurant
what 3 star restaurants deliver	restaurant whose star rating is 3 stars and that has delivery
restaurant that has outdoor seating and whose neighborhood is midtown west	restaurant that has outdoor seating and whose neighborhood is midtown west
what thai restaurants takes reservations	restaurant whose cuisine is thai and that takes reservations
restaurants in the 2 or 3 dollar sign price range	restaurant whose price rating is 2 dollar signs or 3 dollar signs
restaurants with takeout that are group friendly	restaurant that has take
which restaurant s cuisine has 3 star rating	cuisine that is cuisine of restaurant whose star rating is 3 stars
restaurant whose price rating is 2 dollar signs	restaurant whose price rating is 2 dollar signs
restaurant that has less than two neighborhood	restaurant that has less than two neighborhood
restaurants that have at least two cuisines	restaurant that has more than two cuisine
which resturant takes reservations and has waiter service	restaurant that takes reservations and that has waiter service
restaurant that is open for two meals	restaurant that serves at most two meal
restaurant whose neighborhood is midtown west and whose star rating is 3 stars	restaurant whose neighborhood is midtown west and whose star rating is 3 stars
restaurant whose star rating is 3 stars and that has takeout	restaurant whose star rating is 3 stars and that has take
find 3 star or 5 star restaurant	3 stars or 5 stars
what cuisines are offered by restaurants accepting reservations	cuisine that is cuisine of restaurant that takes reservations
restaurant in mid town west that deliver	restaurant whose neighborhood is midtown west and that has delivery
what restaurant serves at least two cuisines	restaurant that has at least two cuisine
what 2 dollar signs offers lunch	restaurant whose price rating is 2 dollar signs and that serves lunch
what restaurant offers takeout	restaurant that has take
restaurant with a 2 or 3 dollar price rating	restaurant whose price rating is 2 dollar signs or 3 dollar signs
which resturants have a price rating of at most two or three dollar signs	restaurant whose price rating is at most 2 dollar signs or 3 dollar signs
what restaurant has 3 stars and serves lunch	restaurant whose star rating is 3 stars and that serves lunch
what meal does the midtown west restaurant serve	meal that restaurant whose neighborhood is midtown west serves
name a restaurant with a lower price rating than the thai cafe	restaurant whose price rating is smaller than price rating of thai cafe
find a restaurant good for groups that has a 2 dollar price rating	restaurant whose price rating is 2 dollar signs and that is good for groups
delivery is avaiable	restaurant that has delivery
which restaurants serve lunch and have a 2 dollar sign price rating	restaurant that serves lunch and whose price rating is 2 dollar signs
restaurants with similar food to thai cafe	cuisine of thai cafe
which restaurant has a 2dollarsigns price rating and takeout service	restaurant whose price rating is 2 dollar signs and that has take
cuisine that is cuisine of restaurant whose cuisine is thai	cuisine that is cuisine of restaurant whose cuisine is thai
what neighborhood has less than two restaurants	neighborhood that is neighborhood of less than two restaurant
thai restaurants rated 2 dollar signs	restaurant whose price rating is 2 dollar signs and whose cuisine is thai
what are the cuisines of all the 3 star rating restaurants	cuisine that is cuisine of restaurant whose star rating is 3 stars
restaurants with food not like thai cafe	cuisine that is not cuisine of thai cafe
what resturant takes credit cards and is good for groups	restaurant that takes credit cards and that is good for groups
restaurants with star ratings of 3 or 5	restaurant whose star rating is 3 stars or 5 stars
what restaurant is good for kids and takes credit cards	restaurant that is good for kids and that takes credit cards
what cuisine has the most restaurants	cuisine that is cuisine of the most number of restaurant
kidfriendly restaurants that are rated 3 stars	restaurant whose star rating is 3 stars and that is good for kids
three star restaurants that deliver	restaurant whose star rating is 3 stars and that has delivery
restaurants for groups and is in midtown west	restaurant that is good for groups and whose neighborhood is midtown west
which hotel appeals to kids and accepts credit cards	restaurant that is good for kids and that takes credit cards
what is the priuce rating of thai cafe	price rating of thai cafe
three star restaurants that accept credit cards	restaurant whose star rating is 3 stars and that takes credit cards
what are some 3 star restaurants that accept credit cards	restaurant that takes credit cards and whose star rating is 3 stars
find all thai restaurants	cuisine that is cuisine of restaurant whose cuisine is thai
restaurant whose star rating is star rating of thai cafe	restaurant whose star rating is star rating of thai cafe
meals that few restaurants serve	meal that the least number of restaurant serves
restaurants rated less than 3 stars	restaurant whose star rating is smaller than 3 stars
restaurant that serves two meal	meal that two restaurant serves
cuisine that is cuisine of the least number of restaurant	cuisine that is cuisine of the least number of restaurant
which restaurant has a price rating of two dollar signs and has waiters	restaurant whose price rating is 2 dollar signs and that has waiter service
list all restaurants that are more expensive than 2 dollar signs	restaurant whose price rating is larger than 2 dollar signs
restaurants for two	restaurant that serves two meal
which restaurant is friendly towards children and takes reservations	restaurant that is good for kids and that takes reservations
which hotel offers waiter service and outdoor seating facilities	restaurant that has waiter service and that has outdoor seating
restaurants that have waiters and are good for groups	restaurant that has waiter service and that is good for groups
what restaurant is available in less than two neighborhoods	restaurant that has less than two neighborhood
groupfriendly thai restaurants	restaurant that is good for groups and whose cuisine is thai
what neighborhood has more than two restaurants	neighborhood that is neighborhood of more than two restaurant
what restaurant has the highest price rating	restaurant that has the largest price rating
restaurants in the same neighborhood as thai cafe	neighborhood that is neighborhood of thai cafe or pizzeria juno
what restaurant offers reservations and takes credit cards	restaurant that takes reservations and that takes credit cards
which restaurants serve two meals	restaurant that serves two meal
restaurant whose cuisine is thai and that is good for kids	restaurant whose cuisine is thai and that is good for kids
a thai or italian restaurant	restaurant whose cuisine is thai or italian
restaurant that has outdoor seating and that has outdoor seating	restaurant that has outdoor seating and that has outdoor seating
what neighborhood has the most restaurants that are good for groups	neighborhood that is neighborhood of restaurant that is good for groups
accepts reservations	restaurant that takes reservations and that takes reservations
what restaurant serves more than two meals	restaurant that serves more than two meal
what meal can you get at either the thai cafe or at pizzeria juno	meal that thai cafe or pizzeria juno serves
total star rating of restaurant	total star rating of restaurant
what restaurant takes credit card and is open for lunch	restaurant that serves lunch and that takes credit cards
restaurant whose star rating is 3 stars and that takes reservations	restaurant whose star rating is 3 stars and that takes reservations
list 3 star restaurants by neighborhood	neighborhood that is neighborhood of restaurant whose star rating is 3 stars
which thai restaurants offer takeout	restaurant that has take
what meal does the restaurant serve for lunch	meal that restaurant that serves lunch serves
what thai restaurant has outdoor seating	restaurant whose cuisine is thai and that has outdoor seating
restaurant whose star rating is at most 3 stars or 5 stars	restaurant whose star rating is at most 3 stars or 5 stars
which restaurants in midtown west accept credit cards	restaurant that takes credit cards and whose neighborhood is midtown west
restaurants that have outdoor seating and serve lunch	restaurant that has outdoor seating and that serves lunch
restaurant that is good for groups and that has delivery	restaurant that is good for groups and that has delivery
a restaurant with alot of meals	restaurant that serves the most number of meal
neighborhood that is neighborhood of restaurant that takes reservations	neighborhood that is neighborhood of restaurant that takes reservations
what restaurants take reservations and offer takeout	restaurant that takes reservations and that has take
restaurant that has delivery and that has takeout	restaurant that has delivery and that has take
restaurants with between 30 and 40 reviews	30 reviews or 40 reviews
restaurant that is at least 3 stars and kid friendly	restaurant that is good for kids and whose star rating is 3 stars
what restaurant can i eat lunch outdoors at	restaurant that serves lunch and that has outdoor seating
what thai restaurant offers delivery	restaurant that has delivery and whose cuisine is thai
what cuisines are offered by 3 star restaurants	cuisine that is cuisine of restaurant whose star rating is 3 stars
what restaurant serves cuisine and takes credit cards	cuisine that is cuisine of restaurant that takes credit cards
restaurants where you can sit outside	restaurant that has outdoor seating
hotel which has a price rating of less than 2 dollar signs or 3 dollar signs	restaurant whose price rating is smaller than 2 dollar signs or 3 dollar signs
restaurant whose price rating is 2 dollar signs and that has takeout	restaurant whose price rating is 2 dollar signs and that has take
which restaurant has takeout service	restaurant that has take
what restaurants offer reservations and also have carryout	restaurant that takes reservations and that has take
restaurant that takes credit cards and that has takeout	restaurant that takes credit cards and that has take
restaurants with a 2 or 3 dollar sign price rating	2 dollar signs or 3 dollar signs
find a good kids restaurant that serves lunch	restaurant that serves lunch and that is good for kids
what neighborhoods have kidfriendly restaurants	neighborhood that is neighborhood of restaurant that is good for kids
what are some restaurants serving any cuisine except thai	restaurant whose cuisine is not thai
which restaurants have outdoor seating and offer takeout	restaurant that has outdoor seating and that has take
a restaurant around alot of neighborhoods	restaurant that has the most number of neighborhood
what restaurant offers outdoor seating and takeout	restaurant that has take
what meal is served by fewer than two restaurants	meal that less than two restaurant serves
what thai restaurants take reservations	restaurant whose cuisine is thai and that takes reservations
what cuisine is served at no more than two restaurants	cuisine that is cuisine of at most two restaurant
what meal can you get for take out at the restaurant	meal that restaurant that has take
restaurant with two cuisines	restaurant that has two cuisine
what restaurants are in midtown west	restaurant whose neighborhood is midtown west and whose neighborhood is midtown west
restaurant that delivers and has an outdoor seating area	restaurant that has delivery and that has outdoor seating
what thai restaurants offer a waiter service	restaurant that has waiter service and whose cuisine is thai
what resturant is good for kids and has delivery	restaurant that has delivery and that is good for kids
a restaurant that has a 4 star or higher rating	restaurant whose star rating is larger than 3 stars
hotels that have a minimum  price rating of 2 dollar signs	restaurant whose price rating is at least 2 dollar signs or 3 dollar signs
what restaurant doesnt have a 2 dollar sign	restaurant whose price rating is not 2 dollar signs
which restaurant has fewer than 3 or 5 stars	restaurant whose star rating is smaller than 3 stars or 5 stars
restaurants in midtown west that serve thai food	restaurant whose neighborhood is midtown west and whose cuisine is thai
restaurant that offers reservation facility and serves lunch	restaurant that takes reservations and that serves lunch
what are the neighborhoods of restaurants that take reservations	neighborhood that is neighborhood of restaurant that takes reservations
what restaurant has over two cuisines	restaurant that has more than two cuisine
thai restaurant in mid town west	restaurant whose neighborhood is midtown west and whose cuisine is thai
what kind of cuisine is thai cafe	cuisine of thai cafe
what are the types of cuisine available in the midtown west neighborhood	cuisine that is cuisine of restaurant whose neighborhood is midtown west
a restaurant for kids in midtown west	restaurant whose neighborhood is midtown west and that is good for kids
restaurants that have outdoor seating and that deliver	restaurant that has outdoor seating and that has delivery
restaurants that serves meal	meal that at most two restaurant serves
what are some restaurants who are 4 stars or better	restaurant whose star rating is larger than 3 stars
restaurant that serves lunch	restaurant that serves lunch
restaurant with no more than two cuisines	restaurant that has at most two cuisine
what is a meal that the thai cafe or pizzeria juno serves	meal that thai cafe or pizzeria juno serves
what kind of cuisine has at least two restaurants	cuisine that is cuisine of two restaurant
this restaurant has the most amount of cuisines	restaurant that has the most number of cuisine
restaurant whose star rating is at most star rating of thai cafe	restaurant whose star rating is at most star rating of thai cafe
what neighborhood contain the most restaurants that have waiter service	neighborhood that is neighborhood of restaurant that has waiter service
hotel that serves the minimum number of meals	restaurant that serves the least number of meal
what restaurant is open for lunch and contains outdoor seating	restaurant that has outdoor seating and that serves lunch
hotel with a thai or italian restaurant	restaurant whose cuisine is thai or italian
what cuisine is served by fewer than two restaurants	cuisine that is cuisine of less than two restaurant
restaurant that serves lunch and whose cuisine is thai	restaurant that serves lunch and whose cuisine is thai
which restaurants that have waiters take credit cards	restaurant that has waiter service and that takes credit cards
what midtown west restaurant has a 3 star rating	restaurant whose star rating is 3 stars and whose neighborhood is midtown west
what restaurant delivers and is good for kids	restaurant that has delivery and that is good for kids
what restaurant is good for groups	restaurant that is good for groups and that is good for groups
what neighborhood has at least two restaurants	neighborhood that is neighborhood of two restaurant
what is the price rating of the hotel	total price rating of restaurant
restaurants that are not open for lunch	restaurant that not serves lunch
the restaurant serves lunch as well as thai food	restaurant whose cuisine is thai and that serves lunch
restaurants who have a price rating lower than 2 dollar signs	restaurant whose price rating is not 2 dollar signs
name a restaurant in the neighbourhood of thai cafe	restaurant whose neighborhood is neighborhood that is neighborhood of thai cafe
what restaurants have at least a 3 star rating	restaurant whose star rating is 3 stars
what 2 dollar signs restaurant takes reservations	restaurant that takes reservations and whose price rating is 2 dollar signs
what is the restaurant that does not serve lunch	restaurant that not serves lunch
restaurant with lunch menu	meal that restaurant that serves lunch serves
this restaurant had the largest rating in price	restaurant that has the largest price rating
family friendly restaurants in midtown west	restaurant that is good for kids and whose neighborhood is midtown west
which restaurants are good for groups and have outdoor seating	restaurant that is good for groups and that has outdoor seating
restaurants located in midtown west	restaurant whose neighborhood is midtown west
find a good kids restaurant with waiter service	restaurant that is good for kids and that has waiter service
what is a restaurant that is kidfriendly and has waiters	restaurant that is good for kids and that has waiter service
what meal does the restaurant deliver	meal that restaurant that has delivery serves
what restaurants offer waiter service and takes credit cards	restaurant that takes credit cards and that has waiter service
restaurants that are kid friendly and inexpensive	restaurant whose price rating is 2 dollar signs and that is good for kids
restaurant in midtown west that is good for groups	restaurant that is good for groups and whose neighborhood is midtown west
what restaurant can i eat lunch and pay with a credit card	restaurant that takes credit cards and that serves lunch
what group restaurant takes credit cards	restaurant that takes credit cards and that is good for groups
a 3 star restaurant that is good for kids	restaurant whose star rating is 3 stars and that is good for kids
what restaurant offers only one cuisine	restaurant that has less than two cuisine
find a 3 star restaurant	restaurant whose star rating is 3 stars
restaurant that has delivery and that has delivery	restaurant that has delivery and that has delivery
3 star restaurants that have outdoor seating	restaurant that has outdoor seating and whose star rating is 3 stars
which restaurants have takeout and serve lunch	restaurant that has take
restaurant that has at least 3 star rating	restaurant whose star rating is at least 3 stars
which neighborhoods is thai cafe not in	neighborhood that is not neighborhood of thai cafe
restaurant that has delivery and whose price rating is 2 dollar signs	restaurant that has delivery and whose price rating is 2 dollar signs
what restaurant is good for groups and takes reservations	restaurant that takes reservations and that is good for groups
what restaurant has 2 or greater dollar signs as its price rating	restaurant whose price rating is at least 2 dollar signs
family friendly restaurants with takeout	restaurant that is good for kids and that has take
name a meal served in a restaurant with a price rating of two dollar signs	meal that restaurant whose price rating is 2 dollar signs serves
list by type of cuisine the restaurants that serve lunch	cuisine that is cuisine of restaurant that serves lunch
restaurant that is good for kids and whose cuisine is thai	restaurant that is good for kids and whose cuisine is thai
what midtown west restaurant has lunch	restaurant that serves lunch and whose neighborhood is midtown west
which restaurants in midtown west deliver	restaurant whose neighborhood is midtown west and that has delivery
restaurants in midtown west rated 3 stars	restaurant whose star rating is 3 stars and whose neighborhood is midtown west
what thai restaurant has the highest star rating	restaurant whose star rating is at most star rating of thai cafe
restaurant that takes reservations and that takes credit cards	restaurant that takes reservations and that takes credit cards
what restaurant serves a meal similar to that found at the thai cafe	restaurant that serves meal that thai cafe serves
restaurants with a 2 dollar price rating	restaurant whose price rating is 2 dollar signs
what restaurant serves the least amount of meals	meal that the least number of restaurant serves
what cuisines are offered by restaurants that offer takeout	cuisine that is cuisine of restaurant that has take
find a restaurant in the same neighborhood as the thai cafe	restaurant whose neighborhood is neighborhood that is neighborhood of thai cafe
what good kids restaurant is in the midtown west area	restaurant that is good for kids and whose neighborhood is midtown west
find a 3 star restaurant with waiter service	restaurant that has waiter service and whose star rating is 3 stars
a restaurant with delivery for a large group	restaurant that has delivery and that is good for groups
restaurants that are in two neighborhoods at least	restaurant that has at least two neighborhood
what neighborhood contains two restaurants	neighborhood that is neighborhood of two restaurant
restaurant whose cuisine is thai and that has outdoor seating	restaurant whose cuisine is thai and that has outdoor seating
what restaurant is kid friendly and has takeout	restaurant that is good for kids and that has take
restaurants with a common meal	meal that less than two restaurant serves
which resturants have a price rating the same as the thai cafe	restaurant whose price rating is price rating of thai cafe
what restaurant is good with groups and serves lunch	restaurant that is good for groups and that serves lunch
restaurants with outdoor seating and is good for groups	restaurant that has outdoor seating and that is good for groups
what restaurant has outdoor seating and a 2 dollar price rating	restaurant whose price rating is 2 dollar signs and that has outdoor seating
which restaurants are in the price rating level of two dollar signs	restaurant whose price rating is 2 dollar signs
which restaurant has a cuisine that offers delivery services	cuisine that is cuisine of restaurant that has delivery
what restaurants serve lunch and offer takeout	restaurant that has take
what restaurant has a lower price rating than the thai cafe	restaurant whose price rating is smaller than price rating of thai cafe
restaurants open for lunch	restaurant that serves lunch
a group friendly restaurant with outdoor seating	restaurant that has outdoor seating and that is good for groups
restaurant that can deliver and is open for lunch	restaurant that serves lunch and that has delivery
a restaurant that does not serve thai	restaurant whose cuisine is not thai
thai cafe or pizzeria juno	thai cafe or pizzeria juno
restaurants that have between 30 and 40 reviews	30 reviews or 40 reviews
find a thai restaurant that serves lunch	restaurant whose cuisine is thai and that serves lunch
restaurants with 2 price rating that accept credit cards	restaurant whose price rating is 2 dollar signs and that takes credit cards
restaurants with takeout that have waiters	restaurant that has take
restaurants that can be booked in advance	cuisine that is cuisine of restaurant that takes reservations
restaurants with the same or higher star rating as thai cafe	restaurant whose star rating is at least star rating of thai cafe
what restaurant serves lunch to groups	restaurant that serves lunch and that is good for groups
thai cuisine restaurant that has a  price rating	restaurant whose cuisine is thai and whose price rating is 2 dollar signs
restaurants that take credit cards with a price rating of 2	restaurant that takes credit cards and whose price rating is 2 dollar signs
restaurant that has waiter service and that has waiter service	restaurant that has waiter service and that has waiter service
what midtown west restaurant offers outdoor seating	restaurant whose neighborhood is midtown west and that has outdoor seating
restaurants has rating below 3 stars	restaurant whose star rating is at most 3 stars or 5 stars
what is the neighborhood of the thai restaurant	neighborhood that is neighborhood of restaurant whose cuisine is thai
what is the average price ratings of restaurants	average price rating of restaurant
which restaurant has waiters and a star rating of three stars	restaurant that has waiter service and whose star rating is 3 stars
which restaurants serve the least number of meals	restaurant that serves the least number of meal
a thai restaurant in the midtown neighborhood	restaurant whose cuisine is thai and whose neighborhood is midtown west
5 stars or 3 stars	3 stars or 5 stars
restaurant that has delivery services	meal that restaurant that has delivery serves
cuisine that is cuisine of restaurant that takes credit cards	cuisine that is cuisine of restaurant that takes credit cards
which restaurants in midtown west have a price rating of 2 dollar signs	restaurant whose neighborhood is midtown west and whose price rating is 2 dollar signs
find a thai restaurant that is good for groups	restaurant that is good for groups and whose cuisine is thai
groupfriendly restaurants	restaurant that is good for groups
restaurants with 2 stars or less	restaurant whose star rating is smaller than 3 stars
which restaurants have outdoor seating and accept credit cards	restaurant that has outdoor seating and that takes credit cards
restaurants with waiters that offer takeout	restaurant that has waiter service and that has take
which resturants have a star rating smaller than 3 stars	restaurant whose star rating is smaller than 3 stars
restaurant with delivery that has a 2 dollar sign rating	restaurant that has delivery and whose price rating is 2 dollar signs
which restaurants accept credit cards for payment and also have takeout service	restaurant that takes credit cards and that has take
what are some restaurants rated 2 dollar signs or more	restaurant whose price rating is at least 2 dollar signs
what cuisine is served in two restaurants	cuisine that is cuisine of two restaurant
which restaurant has waiter and takeout service	restaurant that has take
restaurants that serve same meals as thai cafe	restaurant that serves meal that thai cafe serves
what restaurant contains the most number of cuisines	restaurant that has the most number of cuisine
restaurant that takes reservations and that serves lunch	restaurant that takes reservations and that serves lunch
what restaurant has outdoor seating and offers waiter service service	restaurant that has outdoor seating and that has waiter service
restaurants in the 2 dollar sign price category that accept credit cards	restaurant whose price rating is 2 dollar signs and that takes credit cards
which restaurant is good for a group and also has waiters	restaurant that is good for groups and that has waiter service
which thai restaurant has a 2dollarsign rating	restaurant whose price rating is 2 dollar signs and whose cuisine is thai
what cuisine type is most common	meal that the most number of restaurant serves
restaurant that delivers and accepts credit cards	restaurant that has delivery and that takes credit cards
what restaurants offer more than two cuisines	cuisine that is cuisine of more than two restaurant
restaurants that are in midtown west	meal that restaurant whose neighborhood is midtown west serves
restaurant with takeout	meal that restaurant that has take
restaurants with waiters that have a price rating of 2	restaurant whose price rating is 2 dollar signs and that has waiter service
restaurant that has delivery	restaurant that has delivery
what cuisine offers takeout	cuisine that is cuisine of restaurant that has take
what is a meal served at the thai cafe	meal that thai cafe serves and that thai cafe serves
what restaurants have the same price rating or better than thai cafe	restaurant whose price rating is at least price rating of thai cafe
what neighborhood has two or less restaurants	neighborhood that is neighborhood of at most two restaurant
restaurant whose star rating is 3 stars and whose price rating is 2 dollar signs	restaurant whose star rating is 3 stars and whose price rating is 2 dollar signs
meal not served by thai cafe	meal that thai cafe not serves
restaurants with takeout that are good for large parties	restaurant that is good for groups and that has take
which resturants take reservations	restaurant that takes reservations
midtown west restaurants with 2 dollar signs price rating	restaurant whose neighborhood is midtown west and whose price rating is 2 dollar signs
which resturant serves lunch and is good for kids	restaurant that serves lunch and that is good for kids
restaurants that are good for children and offer takeout	restaurant that has take
a reservation restaurant that is kid friendly	restaurant that takes reservations and that is good for kids
what restaurant offers lunch and is good for groups	restaurant that is good for groups and that serves lunch
hotel which has a minimum of 3 star rating	restaurant whose star rating is at least 3 stars
what restaurant serves the same food as the thai cafe	restaurant that serves meal that thai cafe serves
which restaurant that welcomes kids offers lunch	restaurant that serves lunch and that is good for kids
what restaurants have at least 30 or 40 reviews	30 reviews or 40 reviews
restaurant that takes credit cards and whose price rating is 2 dollar signs	restaurant that takes credit cards and whose price rating is 2 dollar signs
thai cafe thats erves pizzeria	meal that thai cafe or pizzeria juno serves
restaurants that deliver	restaurant that has delivery and that has delivery
what restaurants have outdoor seating that take credit cards	restaurant that takes credit cards and that has outdoor seating
what neighborhood has the most thai restaurants	neighborhood that is neighborhood of restaurant whose cuisine is thai
cuisine that is cuisine of thai cafe and that is cuisine of thai cafe	cuisine that is cuisine of thai cafe and that is cuisine of thai cafe
what is the neighborhood of thai cafe or pizzeria juno	neighborhood that is neighborhood of thai cafe or pizzeria juno
which resturants serve lunch and are good for groups	restaurant that serves lunch and that is good for groups
retaurant with less number of neighbourhood	restaurant that has the least number of neighborhood
three star rated restaurants that deliver	restaurant that has delivery and whose star rating is 3 stars
restaurants that serve the same cuisine	cuisine that is cuisine of less than two restaurant
which restaurants are rated between 3 and 5 stars	restaurant whose star rating is at least 3 stars or 5 stars
name a hotel which has a three star rating and good for group dining	restaurant whose star rating is 3 stars and that is good for groups
what restaurants are located in midtown west	neighborhood that is neighborhood of restaurant whose neighborhood is midtown west
what neighborhood contains restaurants that offer lunch	neighborhood that is neighborhood of restaurant that serves lunch
restaurants that are near two neighborhoods	neighborhood that is neighborhood of at most two restaurant
hotel that offers lunch and best for group dining	restaurant that is good for groups and that serves lunch
what are some 3 star restaurants that serve lunch	restaurant whose star rating is 3 stars and that serves lunch
which neighborhoods have 3 star restaurants	neighborhood that is neighborhood of restaurant whose star rating is 3 stars
neighbourhood restaurant that offers outdoor seating facilities	neighborhood that is neighborhood of restaurant that has outdoor seating
which resturants have a price rating of at least two or three dollar signs	restaurant whose price rating is at least 2 dollar signs or 3 dollar signs
how many neighboords are there that have restaurants	number of neighborhood
which restaurants take reservations and accept credit cards	restaurant that takes reservations and that takes credit cards
how many different kind of cuisines are there	number of cuisine
what restaurant has two meals	restaurant that serves two meal
what is a 3 star restaurant that serves lunch	restaurant that serves lunch and whose star rating is 3 stars
what restaurants with 2 price rating also have waiter service	restaurant whose price rating is 2 dollar signs and that has waiter service
which restaurant has a price rating of two dollar signs and has outdoor seating	restaurant whose price rating is 2 dollar signs and that has outdoor seating
restaurants with outdoor seating and takeout	restaurant that has outdoor seating and that has take
what is the best restaurant for big groups in midtown west	restaurant whose neighborhood is midtown west and that is good for groups
restaurants that accept credit cards and offer takeout	restaurant that has take
which restaurants serve lunch and accept reservations	restaurant that serves lunch and that takes reservations
groupfriendly restaurants that accept reservations	restaurant that takes reservations and that is good for groups
restaurant whose price rating is 2 dollar signs and that has waiter service	restaurant whose price rating is 2 dollar signs and that has waiter service
restaurant that has delivery and whose star rating is 3 stars	restaurant that has delivery and whose star rating is 3 stars
what restaurants are good for groups that have waiter service	restaurant that is good for groups and that has waiter service
restaurants with takeout for groups	restaurant that is good for groups and that has take
which restaurants are rated 3 or 5 stars	restaurant whose star rating is 3 stars or 5 stars
which thai restaurants take credit cards	restaurant whose cuisine is thai and that takes credit cards
restaurants that serves more than two cuisines	restaurant that has at least two cuisine
which restaurants have outdoor seating and are group friendly	restaurant that is good for groups and that has outdoor seating
find a 3 star restaurant that is good for groups	restaurant that is good for groups and whose star rating is 3 stars
restaurant who shares a neighborhood with the thai cafe	restaurant whose neighborhood is neighborhood of thai cafe
which 3star restaurant has takeout service	restaurant whose star rating is 3 stars and that has take
what restaurant has reservations and takeout	restaurant that has take
3 stars restaurant which offers takeout	restaurant that has take
thai cafe with least price rating	restaurant whose price rating is at least price rating of thai cafe
what restaurant takes group reservations	restaurant that is good for groups and that takes reservations
restaurants that is in the least numbers of neighborhoods	restaurant that has the least number of neighborhood
restaurants that are more expensive than thai cafe	restaurant whose price rating is larger than price rating of thai cafe
what restaurants have outdoor dining	restaurant that has outdoor seating
find a restaurant that has delivery as well as waiter service	restaurant that has waiter service and that has delivery
what restaurants offer delivery and serves lunch	restaurant that has delivery and that serves lunch
restaurant that has outdoor seating	meal that restaurant that has outdoor seating serves
what restaurant has 3 or 2 menu items	restaurant whose price rating is at most 2 dollar signs or 3 dollar signs
restaurants in midtown west with outdoor dining areas	restaurant that has outdoor seating and whose neighborhood is midtown west
hotel in the midtown west area which has outdoor seating facilities	restaurant that has outdoor seating and whose neighborhood is midtown west
neighborhood with restaurants that serve lunch	neighborhood that is neighborhood of restaurant that serves lunch
what restaurants have outdoor seating and accept credit cards	restaurant that has outdoor seating and that takes credit cards
chelsea or midtown west	midtown west or chelsea
a take out restaurant	restaurant that has take
what is the cuisine of restaurants that have delivery	cuisine that is cuisine of restaurant that has delivery
what restaurants have lower ratings that thai cafe	restaurant whose star rating is smaller than star rating of thai cafe
what is a kid friendly restaurant that serves lunch	restaurant that serves lunch and that is good for kids
the 3 star restaurant is good for kids	restaurant that is good for kids and whose star rating is 3 stars
restaurant whose neighborhood is midtown west and that has outdoor seating	restaurant whose neighborhood is midtown west and that has outdoor seating
restaurant whose price rating is 2 dollar signs and that is good for kids	restaurant whose price rating is 2 dollar signs and that is good for kids
what is a meal from a restaurant with outdoor seating	meal that restaurant that has outdoor seating serves
which restaurants have a 3 star rating and 2 dollar price rating	restaurant whose star rating is 3 stars and whose price rating is 2 dollar signs
which resturant in midtown west has waiter service	restaurant that has waiter service and whose neighborhood is midtown west
what is the most expensive restaurant	restaurant that has the largest price rating
restaurant that has two cuisines	restaurant that has more than two cuisine
restaurant in midtown west for kids	restaurant that is good for kids and whose neighborhood is midtown west
what is the total price rating of all the restaurants	total price rating of restaurant
what restaurant only serves two or less meals	restaurant that serves at most two meal
hotel which has a higher star rating than thai cafe	restaurant whose star rating is larger than star rating of thai cafe
what restaurants serve good food for groups and have takeout	restaurant that is good for groups and that has take
what restaurant takes credit cards in midtown west area	restaurant that takes credit cards and whose neighborhood is midtown west
hotel that has waiter service  and take out facilities	restaurant that has waiter service and that has take
restaurant that takes reservations and that has delivery	restaurant that takes reservations and that has delivery
what restaurant takes credit cards and is kid friendly	restaurant that takes credit cards and that is good for kids
list all 3 star rated thai restaurants	restaurant whose star rating is 3 stars and whose cuisine is thai
what restaurant has delivery	restaurant that has delivery and that has delivery
restaurant that serves food for kids	meal that restaurant that is good for kids serves
list all thai restaurants that offer takeout	restaurant that has take
3 star restaurants that offer takeout	restaurant that has take
restaurants with delivery rated 2 dollar signs	restaurant whose price rating is 2 dollar signs and that has delivery
which restaurant has waiters and also offers takeout	restaurant that has waiter service and that has take
which 3 star restaurants have outdoor seating	restaurant that has outdoor seating and whose star rating is 3 stars
what is the average star rating	average star rating of restaurant
which 3 star restaurants have waiters	restaurant whose star rating is 3 stars and that has waiter service
restaurants that has more than one cuisine	restaurant that has two cuisine
number of restaurant	number of restaurant
what same meals do all the other restaurants serve	meal that the most number of restaurant serves
what restaurants are not in midtown west	restaurant whose neighborhood is not midtown west
thai restaurants that take credit cards	restaurant that takes credit cards and whose cuisine is thai
affordable restaurant with outdoor seating	restaurant whose price rating is 2 dollar signs and that has outdoor seating
what is the cuisine of restaurants that serve lunch	cuisine that is cuisine of restaurant that serves lunch
restaurant whose neighborhood is midtown west and that takes reservations	restaurant whose neighborhood is midtown west and that takes reservations
list all restaurants that have takeout and delivery	restaurant that has take
what is a meal served by a restaurant that accommodates groups	meal that restaurant that is good for groups serves
restaurants with a 3 or 5 star rating	restaurant whose star rating is 3 stars or 5 stars
a thai cafe in the neighborhood	neighborhood that is neighborhood of thai cafe and that is neighborhood of thai cafe
restaurants rated with 3 stars and have outdoor seating	restaurant whose star rating is 3 stars and that has outdoor seating
restaurants with takeout that are kidfriendly	restaurant that has take
list all restaurants that have a price rating of 2 dollar signs or 3 dollar signs	restaurant whose price rating is 2 dollar signs or 3 dollar signs
restaurant whose star rating is smaller than 3 stars	restaurant whose star rating is smaller than 3 stars
cuisine that is cuisine of restaurant whose neighborhood is midtown west	cuisine that is cuisine of restaurant whose neighborhood is midtown west
which neighborhoods have more than two restaurants	neighborhood that is neighborhood of more than two restaurant
restaurants that are deliver and are good for large parties	restaurant that is good for groups and that has delivery
thai restaurant that takes reservations	restaurant whose cuisine is thai and that takes reservations
hotel that can be booked in advance which has a price rating of 2 dollar signs	restaurant that takes reservations and whose price rating is 2 dollar signs
restaurants in midtown west that offer takeout	restaurant whose neighborhood is midtown west and that has take
which neighborhoods have restaurants that deliver	neighborhood that is neighborhood of restaurant that has delivery
restaurant that has the most number of cuisine	restaurant that has the most number of cuisine
which restaurants serve at least two meals	restaurant that serves at least two meal
which hotel is entertaining for kids	restaurant that is good for kids
a fairly inexpensive thai cuisine can be purchased at this restaurant	restaurant whose cuisine is thai and whose price rating is 2 dollar signs
what2 dollar sign restaurant has outdoor seating	restaurant that has outdoor seating and whose price rating is 2 dollar signs
hotel in the area of midtown west which serves lunch	restaurant that serves lunch and whose neighborhood is midtown west
restaurants good for groups and kids	restaurant that is good for groups and that is good for kids
restaurants that cheaper than thai cafe	restaurant whose price rating is smaller than price rating of thai cafe
restaurant in the area that has a 2 dollar sign price rating	neighborhood that is neighborhood of restaurant whose price rating is 2 dollar signs
hotel  that that has the star rating of thai cafe	restaurant whose star rating is at most star rating of thai cafe
what restaurant is good for groups and takes credit cards	restaurant that takes credit cards and that is good for groups
which hotel has outdoor seating facilities and offers delivery services	restaurant that has delivery and that has outdoor seating
what kind of meal do 3 star restaurants serve	meal that restaurant whose star rating is 3 stars serves
find a thai restaurant	restaurant whose cuisine is thai
what 2 dollar signs restaurant is good for groups	restaurant that is good for groups and whose price rating is 2 dollar signs
cuisine that is cuisine of restaurant that is good for groups	cuisine that is cuisine of restaurant that is good for groups
what cuisine is at at least two restaurants	cuisine that is cuisine of at least two restaurant
